,time_diff,close,volume,match_hr,match_min,match_sec,match_ms,time_in_ms
179,0,1792200,309,8,45,0,84,31500084
180,16,1792200,1,8,45,0,100,31500100
181,0,1792200,57,8,45,0,100,31500100
182,4,1792200,10,8,45,0,104,31500104
183,2,1792200,1,8,45,0,106,31500106
184,1,1792200,1,8,45,0,107,31500107
185,111,1792200,6,8,45,0,218,31500218
186,37,1792200,2,8,45,0,255,31500255
187,2,1792200,2,8,45,0,257,31500257
188,3,1792200,2,8,45,0,260,31500260
189,36,1792200,1,8,45,0,296,31500296
190,6,1792200,1,8,45,0,302,31500302
191,20,1792200,1,8,45,0,322,31500322
192,3,1792200,1,8,45,0,325,31500325
193,3,1792200,1,8,45,0,328,31500328
194,10,1792200,1,8,45,0,338,31500338
195,17,1792200,1,8,45,0,355,31500355
196,2,1792200,2,8,45,0,357,31500357
197,6,1792300,2,8,45,0,363,31500363
198,13,1792300,6,8,45,0,376,31500376
199,1,1792200,1,8,45,0,377,31500377
200,6,1792300,1,8,45,0,383,31500383
201,0,1792300,1,8,45,0,383,31500383
202,0,1792300,1,8,45,0,383,31500383
203,0,1792300,1,8,45,0,383,31500383
204,1,1792300,3,8,45,0,384,31500384
205,1,1792300,2,8,45,0,385,31500385
207,0,1792400,1,8,45,0,385,31500385
208,0,1792400,1,8,45,0,385,31500385
209,5,1792300,1,8,45,0,390,31500390
211,20,1792200,2,8,45,0,410,31500410
212,4,1792200,1,8,45,0,414,31500414
213,8,1792200,4,8,45,0,422,31500422
214,2,1792200,2,8,45,0,424,31500424
215,8,1792200,2,8,45,0,432,31500432
216,7,1792500,2,8,45,0,439,31500439
217,15,1792200,2,8,45,0,454,31500454
218,0,1792200,2,8,45,0,454,31500454
219,3,1792500,1,8,45,0,457,31500457
220,36,1792200,2,8,45,0,493,31500493
221,0,1792500,1,8,45,0,493,31500493
222,3,1792200,1,8,45,0,496,31500496
223,1,1792200,2,8,45,0,497,31500497
224,7,1792200,1,8,45,0,504,31500504
225,5,1792500,1,8,45,0,509,31500509
226,5,1792300,1,8,45,0,514,31500514
227,3,1792300,2,8,45,0,517,31500517
228,4,1792300,1,8,45,0,521,31500521
229,5,1792200,2,8,45,0,526,31500526
230,0,1792200,8,8,45,0,526,31500526
231,15,1792300,1,8,45,0,541,31500541
233,0,1792500,1,8,45,0,541,31500541
234,0,1792500,1,8,45,0,541,31500541
235,1,1792500,1,8,45,0,542,31500542
236,25,1792500,1,8,45,0,567,31500567
237,0,1792500,1,8,45,0,567,31500567
238,21,1792500,2,8,45,0,588,31500588
239,2,1792300,2,8,45,0,590,31500590
240,5,1792300,1,8,45,0,595,31500595
242,8,1792200,3,8,45,0,603,31500603
243,17,1792500,1,8,45,0,620,31500620
244,2,1792500,1,8,45,0,622,31500622
246,22,1792300,1,8,45,0,644,31500644
247,1,1792300,1,8,45,0,645,31500645
248,0,1792200,1,8,45,0,645,31500645
249,4,1792200,8,8,45,0,649,31500649
250,0,1792200,8,8,45,0,649,31500649
251,3,1792200,2,8,45,0,652,31500652
252,6,1792300,1,8,45,0,658,31500658
253,17,1792200,1,8,45,0,675,31500675
254,2,1792200,1,8,45,0,677,31500677
255,0,1792200,1,8,45,0,677,31500677
256,39,1792200,1,8,45,0,716,31500716
257,1,1792300,1,8,45,0,717,31500717
258,0,1792200,1,8,45,0,717,31500717
259,4,1792300,1,8,45,0,721,31500721
260,0,1792200,1,8,45,0,721,31500721
261,6,1792200,1,8,45,0,727,31500727
262,8,1792400,2,8,45,0,735,31500735
263,23,1792200,3,8,45,0,758,31500758
264,0,1792200,1,8,45,0,758,31500758
265,0,1792200,2,8,45,0,758,31500758
266,3,1792400,1,8,45,0,761,31500761
267,3,1792200,1,8,45,0,764,31500764
268,6,1792200,2,8,45,0,770,31500770
269,4,1792200,4,8,45,0,774,31500774
270,1,1792200,1,8,45,0,775,31500775
271,0,1792200,1,8,45,0,775,31500775
272,0,1792200,1,8,45,0,775,31500775
273,0,1792200,1,8,45,0,775,31500775
274,2,1792400,1,8,45,0,777,31500777
275,9,1792200,2,8,45,0,786,31500786
276,4,1792200,3,8,45,0,790,31500790
277,3,1792200,2,8,45,0,793,31500793
278,1,1792200,2,8,45,0,794,31500794
279,3,1792200,4,8,45,0,797,31500797
280,11,1792200,1,8,45,0,808,31500808
281,5,1792200,1,8,45,0,813,31500813
282,0,1792200,1,8,45,0,813,31500813
283,18,1792200,2,8,45,0,831,31500831
284,7,1792200,1,8,45,0,838,31500838
285,18,1792200,1,8,45,0,856,31500856
286,0,1792200,1,8,45,0,856,31500856
287,18,1792200,2,8,45,0,874,31500874
288,10,1792200,1,8,45,0,884,31500884
289,9,1792200,3,8,45,0,893,31500893
291,8,1792000,1,8,45,0,901,31500901
292,0,1792000,1,8,45,0,901,31500901
293,0,1792000,1,8,45,0,901,31500901
294,1,1792000,1,8,45,0,902,31500902
295,1,1792000,1,8,45,0,903,31500903
296,1,1792000,1,8,45,0,904,31500904
297,7,1792300,5,8,45,0,911,31500911
298,4,1792000,4,8,45,0,915,31500915
299,0,1792300,2,8,45,0,915,31500915
301,1,1792500,1,8,45,0,916,31500916
302,7,1792500,1,8,45,0,923,31500923
303,7,1792500,4,8,45,0,930,31500930
304,46,1792200,1,8,45,0,976,31500976
306,26,1792000,2,8,45,1,2,31501002
307,9,1792000,2,8,45,1,11,31501011
308,6,1792000,1,8,45,1,17,31501017
310,7,1792000,1,8,45,1,24,31501024
311,2,1792100,1,8,45,1,26,31501026
312,0,1792100,1,8,45,1,26,31501026
313,0,1792100,1,8,45,1,26,31501026
315,21,1792000,3,8,45,1,47,31501047
316,2,1792200,1,8,45,1,49,31501049
317,11,1792100,1,8,45,1,60,31501060
318,75,1792100,1,8,45,1,135,31501135
319,15,1792100,4,8,45,1,150,31501150
321,4,1792300,6,8,45,1,154,31501154
322,1,1792300,1,8,45,1,155,31501155
323,0,1792300,1,8,45,1,155,31501155
324,0,1792300,1,8,45,1,155,31501155
325,8,1792300,1,8,45,1,163,31501163
326,0,1792300,1,8,45,1,163,31501163
328,110,1792100,1,8,45,1,273,31501273
329,13,1792300,1,8,45,1,286,31501286
330,57,1792000,1,8,45,1,343,31501343
331,1,1792000,1,8,45,1,344,31501344
332,0,1791900,1,8,45,1,344,31501344
333,1,1791900,1,8,45,1,345,31501345
334,2,1791900,1,8,45,1,347,31501347
335,21,1791900,1,8,45,1,368,31501368
336,6,1791800,1,8,45,1,374,31501374
337,20,1791800,1,8,45,1,394,31501394
338,35,1791900,1,8,45,1,429,31501429
339,61,1792000,1,8,45,1,490,31501490
340,27,1792000,1,8,45,1,517,31501517
341,1,1792000,3,8,45,1,518,31501518
342,13,1791800,1,8,45,1,531,31501531
343,2,1792000,3,8,45,1,533,31501533
344,14,1792000,1,8,45,1,547,31501547
345,26,1792000,1,8,45,1,573,31501573
346,11,1792100,1,8,45,1,584,31501584
347,33,1791800,5,8,45,1,617,31501617
349,5,1791700,3,8,45,1,622,31501622
350,13,1791700,3,8,45,1,635,31501635
351,0,1791700,2,8,45,1,635,31501635
353,30,1791700,1,8,45,1,665,31501665
354,9,1791900,2,8,45,1,674,31501674
355,0,1791900,2,8,45,1,674,31501674
357,24,1791900,1,8,45,1,698,31501698
358,15,1792100,3,8,45,1,713,31501713
359,0,1792100,1,8,45,1,713,31501713
360,0,1792100,1,8,45,1,713,31501713
361,0,1792100,1,8,45,1,713,31501713
362,44,1792300,1,8,45,1,757,31501757
363,37,1791900,2,8,45,1,794,31501794
364,46,1792000,1,8,45,1,840,31501840
365,10,1791900,3,8,45,1,850,31501850
367,34,1792100,4,8,45,1,884,31501884
368,34,1792000,1,8,45,1,918,31501918
370,10,1791900,3,8,45,1,928,31501928
372,9,1791900,1,8,45,1,937,31501937
373,3,1792100,1,8,45,1,940,31501940
374,10,1791900,1,8,45,1,950,31501950
375,45,1791900,1,8,45,1,995,31501995
376,27,1792000,2,8,45,2,22,31502022
378,0,1792100,1,8,45,2,22,31502022
379,1,1792100,5,8,45,2,23,31502023
380,0,1792100,1,8,45,2,23,31502023
381,1,1791800,1,8,45,2,24,31502024
382,34,1791900,1,8,45,2,58,31502058
383,77,1792000,1,8,45,2,135,31502135
384,12,1791800,1,8,45,2,147,31502147
385,29,1791800,1,8,45,2,176,31502176
386,60,1791900,1,8,45,2,236,31502236
387,36,1792100,1,8,45,2,272,31502272
388,23,1792200,1,8,45,2,295,31502295
389,92,1791800,2,8,45,2,387,31502387
391,4,1791800,1,8,45,2,391,31502391
392,19,1791900,1,8,45,2,410,31502410
393,12,1792000,1,8,45,2,422,31502422
394,220,1791900,1,8,45,2,642,31502642
395,36,1792000,1,8,45,2,678,31502678
396,15,1791700,1,8,45,2,693,31502693
397,33,1792000,1,8,45,2,726,31502726
398,14,1792000,1,8,45,2,740,31502740
399,40,1791800,1,8,45,2,780,31502780
400,40,1792100,1,8,45,2,820,31502820
401,113,1792000,1,8,45,2,933,31502933
402,57,1792000,1,8,45,2,990,31502990
403,1,1792000,1,8,45,2,991,31502991
404,27,1791900,1,8,45,3,18,31503018
405,71,1792100,2,8,45,3,89,31503089
406,66,1792000,1,8,45,3,155,31503155
407,54,1791900,1,8,45,3,209,31503209
408,10,1791900,1,8,45,3,219,31503219
409,14,1792000,2,8,45,3,233,31503233
410,39,1792200,1,8,45,3,272,31503272
411,2,1792000,3,8,45,3,274,31503274
412,0,1792000,3,8,45,3,274,31503274
413,0,1792000,3,8,45,3,274,31503274
415,1,1792100,1,8,45,3,275,31503275
416,0,1791900,1,8,45,3,275,31503275
417,7,1792000,1,8,45,3,282,31503282
418,26,1792000,3,8,45,3,308,31503308
419,16,1792100,1,8,45,3,324,31503324
420,50,1791900,1,8,45,3,374,31503374
421,20,1792100,1,8,45,3,394,31503394
422,0,1792200,1,8,45,3,394,31503394
423,55,1792000,1,8,45,3,449,31503449
424,161,1792100,1,8,45,3,610,31503610
425,0,1792100,1,8,45,3,610,31503610
426,22,1792100,3,8,45,3,632,31503632
427,16,1792000,1,8,45,3,648,31503648
428,69,1792000,2,8,45,3,717,31503717
429,10,1791900,2,8,45,3,727,31503727
431,1,1792200,2,8,45,3,728,31503728
432,37,1791900,3,8,45,3,765,31503765
433,32,1791900,1,8,45,3,797,31503797
434,65,1791900,1,8,45,3,862,31503862
436,17,1791800,1,8,45,3,879,31503879
437,40,1791900,1,8,45,3,919,31503919
438,31,1792000,3,8,45,3,950,31503950
439,13,1791900,1,8,45,3,963,31503963
440,4,1791800,1,8,45,3,967,31503967
441,61,1791800,2,8,45,4,28,31504028
442,0,1791800,3,8,45,4,28,31504028
443,20,1791800,1,8,45,4,48,31504048
445,20,1791600,3,8,45,4,68,31504068
446,13,1791600,1,8,45,4,81,31504081
447,70,1791600,1,8,45,4,151,31504151
448,24,1791600,3,8,45,4,175,31504175
449,10,1791800,3,8,45,4,185,31504185
450,2,1791600,1,8,45,4,187,31504187
451,69,1791500,1,8,45,4,256,31504256
452,37,1791500,1,8,45,4,293,31504293
453,5,1791500,1,8,45,4,298,31504298
454,21,1791500,1,8,45,4,319,31504319
455,27,1791500,1,8,45,4,346,31504346
456,57,1791500,2,8,45,4,403,31504403
457,5,1791700,1,8,45,4,408,31504408
458,28,1791500,1,8,45,4,436,31504436
459,20,1791500,3,8,45,4,456,31504456
460,30,1791500,2,8,45,4,486,31504486
461,6,1791500,2,8,45,4,492,31504492
462,40,1791500,1,8,45,4,532,31504532
463,13,1791500,1,8,45,4,545,31504545
464,11,1791500,3,8,45,4,556,31504556
465,15,1791500,1,8,45,4,571,31504571
466,0,1791500,2,8,45,4,571,31504571
467,1,1791500,1,8,45,4,572,31504572
468,1,1791600,2,8,45,4,573,31504573
469,3,1791500,1,8,45,4,576,31504576
470,8,1791500,1,8,45,4,584,31504584
471,51,1791400,1,8,45,4,635,31504635
472,5,1791600,1,8,45,4,640,31504640
473,36,1791400,1,8,45,4,676,31504676
474,15,1791400,1,8,45,4,691,31504691
475,149,1791400,1,8,45,4,840,31504840
476,6,1791600,2,8,45,4,846,31504846
477,17,1791400,2,8,45,4,863,31504863
478,10,1791400,1,8,45,4,873,31504873
479,11,1791300,1,8,45,4,884,31504884
480,15,1791300,1,8,45,4,899,31504899
481,25,1791300,1,8,45,4,924,31504924
482,10,1791300,3,8,45,4,934,31504934
483,10,1791300,1,8,45,4,944,31504944
484,7,1791300,1,8,45,4,951,31504951
485,39,1791300,1,8,45,4,990,31504990
486,81,1791300,2,8,45,5,71,31505071
488,10,1791200,2,8,45,5,81,31505081
489,37,1791200,2,8,45,5,118,31505118
490,2,1791200,2,8,45,5,120,31505120
491,37,1791200,1,8,45,5,157,31505157
492,41,1791200,2,8,45,5,198,31505198
493,10,1791100,3,8,45,5,208,31505208
494,10,1791100,1,8,45,5,218,31505218
495,76,1791100,3,8,45,5,294,31505294
496,10,1791100,1,8,45,5,304,31505304
497,0,1791100,2,8,45,5,304,31505304
498,9,1791100,2,8,45,5,313,31505313
499,39,1791200,1,8,45,5,352,31505352
500,10,1791300,1,8,45,5,362,31505362
501,24,1791100,2,8,45,5,386,31505386
502,65,1791100,3,8,45,5,451,31505451
503,3,1791000,1,8,45,5,454,31505454
504,38,1791000,1,8,45,5,492,31505492
505,37,1791000,1,8,45,5,529,31505529
506,4,1791000,6,8,45,5,533,31505533
507,10,1791000,3,8,45,5,543,31505543
508,75,1791000,3,8,45,5,618,31505618
509,22,1790900,2,8,45,5,640,31505640
510,66,1790900,2,8,45,5,706,31505706
511,20,1790900,2,8,45,5,726,31505726
512,31,1790900,1,8,45,5,757,31505757
513,31,1790900,1,8,45,5,788,31505788
514,13,1790900,1,8,45,5,801,31505801
515,28,1790800,4,8,45,5,829,31505829
516,31,1790800,2,8,45,5,860,31505860
517,10,1790800,2,8,45,5,870,31505870
518,44,1790800,1,8,45,5,914,31505914
519,13,1790800,3,8,45,5,927,31505927
520,11,1790900,1,8,45,5,938,31505938
522,37,1790800,1,8,45,5,975,31505975
523,6,1790800,1,8,45,5,981,31505981
524,2,1790800,3,8,45,5,983,31505983
526,0,1790700,1,8,45,5,983,31505983
527,5,1790700,3,8,45,5,988,31505988
528,0,1790700,1,8,45,5,988,31505988
529,0,1790700,2,8,45,5,988,31505988
530,0,1790700,1,8,45,5,988,31505988
531,0,1790700,1,8,45,5,988,31505988
532,0,1790700,1,8,45,5,988,31505988
533,33,1790700,1,8,45,6,21,31506021
534,41,1790700,3,8,45,6,62,31506062
535,82,1790700,1,8,45,6,144,31506144
536,27,1790700,1,8,45,6,171,31506171
537,6,1790700,1,8,45,6,177,31506177
538,0,1790700,4,8,45,6,177,31506177
539,27,1790600,1,8,45,6,204,31506204
540,18,1790600,1,8,45,6,222,31506222
541,51,1790600,1,8,45,6,273,31506273
542,17,1790600,2,8,45,6,290,31506290
543,32,1790600,3,8,45,6,322,31506322
544,1,1790600,1,8,45,6,323,31506323
545,28,1790600,2,8,45,6,351,31506351
546,10,1790600,2,8,45,6,361,31506361
547,10,1790500,1,8,45,6,371,31506371
548,2,1790500,1,8,45,6,373,31506373
549,53,1790500,2,8,45,6,426,31506426
550,20,1790500,2,8,45,6,446,31506446
551,51,1790500,2,8,45,6,497,31506497
552,1,1790500,1,8,45,6,498,31506498
553,0,1790500,1,8,45,6,498,31506498
554,32,1790400,2,8,45,6,530,31506530
555,12,1790400,3,8,45,6,542,31506542
556,6,1790500,2,8,45,6,548,31506548
557,39,1790400,4,8,45,6,587,31506587
558,13,1790400,1,8,45,6,600,31506600
559,12,1790400,1,8,45,6,612,31506612
560,6,1790300,2,8,45,6,618,31506618
561,6,1790500,1,8,45,6,624,31506624
562,15,1790300,1,8,45,6,639,31506639
563,5,1790300,1,8,45,6,644,31506644
564,5,1790500,1,8,45,6,649,31506649
565,51,1790300,1,8,45,6,700,31506700
566,25,1790400,2,8,45,6,725,31506725
567,27,1790300,1,8,45,6,752,31506752
568,34,1790300,1,8,45,6,786,31506786
569,16,1790300,3,8,45,6,802,31506802
570,14,1790300,1,8,45,6,816,31506816
571,42,1790400,1,8,45,6,858,31506858
572,56,1790300,1,8,45,6,914,31506914
573,28,1790300,3,8,45,6,942,31506942
575,49,1790200,1,8,45,6,991,31506991
576,3,1790200,1,8,45,6,994,31506994
577,18,1790200,1,8,45,7,12,31507012
578,20,1790200,1,8,45,7,32,31507032
579,21,1790200,1,8,45,7,53,31507053
580,15,1790200,2,8,45,7,68,31507068
581,17,1790100,1,8,45,7,85,31507085
582,3,1790100,1,8,45,7,88,31507088
583,7,1790100,1,8,45,7,95,31507095
584,4,1790100,3,8,45,7,99,31507099
585,60,1790100,2,8,45,7,159,31507159
586,10,1790100,2,8,45,7,169,31507169
587,10,1790100,4,8,45,7,179,31507179
588,1,1790100,1,8,45,7,180,31507180
589,0,1790100,1,8,45,7,180,31507180
590,20,1790100,1,8,45,7,200,31507200
592,47,1790100,1,8,45,7,247,31507247
594,14,1790000,1,8,45,7,261,31507261
595,31,1790000,2,8,45,7,292,31507292
596,16,1790100,1,8,45,7,308,31507308
597,9,1790000,1,8,45,7,317,31507317
598,56,1790200,1,8,45,7,373,31507373
599,21,1790200,2,8,45,7,394,31507394
600,15,1790000,1,8,45,7,409,31507409
601,0,1790000,1,8,45,7,409,31507409
602,13,1790000,10,8,45,7,422,31507422
603,1,1790000,1,8,45,7,423,31507423
604,1,1790000,1,8,45,7,424,31507424
605,0,1790000,1,8,45,7,424,31507424
606,25,1790000,3,8,45,7,449,31507449
608,9,1790000,3,8,45,7,458,31507458
609,77,1789900,2,8,45,7,535,31507535
610,24,1790100,1,8,45,7,559,31507559
611,6,1790000,1,8,45,7,565,31507565
612,19,1789900,2,8,45,7,584,31507584
613,29,1789900,1,8,45,7,613,31507613
614,5,1789900,1,8,45,7,618,31507618
615,201,1789800,3,8,45,7,819,31507819
616,52,1789800,7,8,45,7,871,31507871
617,23,1789800,2,8,45,7,894,31507894
619,22,1789700,1,8,45,7,916,31507916
620,89,1789700,1,8,45,8,5,31508005
621,41,1789700,1,8,45,8,46,31508046
622,3,1789700,1,8,45,8,49,31508049
624,7,1789600,1,8,45,8,56,31508056
625,24,1789600,1,8,45,8,80,31508080
626,7,1789600,1,8,45,8,87,31508087
627,86,1789600,1,8,45,8,173,31508173
628,21,1789500,3,8,45,8,194,31508194
629,41,1789500,1,8,45,8,235,31508235
631,61,1789400,3,8,45,8,296,31508296
633,59,1789300,1,8,45,8,355,31508355
634,4,1789400,3,8,45,8,359,31508359
635,1,1789300,2,8,45,8,360,31508360
636,61,1789300,1,8,45,8,421,31508421
637,4,1789300,2,8,45,8,425,31508425
638,0,1789300,1,8,45,8,425,31508425
639,7,1789200,1,8,45,8,432,31508432
640,11,1789200,2,8,45,8,443,31508443
641,30,1789100,2,8,45,8,473,31508473
642,14,1789200,1,8,45,8,487,31508487
644,38,1789200,3,8,45,8,525,31508525
645,13,1789200,1,8,45,8,538,31508538
646,15,1789100,3,8,45,8,553,31508553
647,62,1789100,2,8,45,8,615,31508615
648,5,1789100,2,8,45,8,620,31508620
649,51,1789100,3,8,45,8,671,31508671
650,12,1789100,1,8,45,8,683,31508683
651,46,1789100,1,8,45,8,729,31508729
652,12,1789000,2,8,45,8,741,31508741
653,0,1789000,4,8,45,8,741,31508741
654,52,1789000,1,8,45,8,793,31508793
655,31,1789000,1,8,45,8,824,31508824
657,36,1788900,3,8,45,8,860,31508860
658,25,1788800,5,8,45,8,885,31508885
659,32,1788800,1,8,45,8,917,31508917
660,9,1788800,1,8,45,8,926,31508926
661,1,1788800,1,8,45,8,927,31508927
662,0,1788800,1,8,45,8,927,31508927
663,3,1788800,1,8,45,8,930,31508930
664,35,1788900,4,8,45,8,965,31508965
665,13,1789000,1,8,45,8,978,31508978
666,0,1788800,3,8,45,8,978,31508978
667,4,1788800,2,8,45,8,982,31508982
668,16,1788800,1,8,45,8,998,31508998
669,76,1788800,2,8,45,9,74,31509074
670,4,1788800,1,8,45,9,78,31509078
672,91,1788700,1,8,45,9,169,31509169
673,1,1788600,1,8,45,9,170,31509170
674,74,1788500,5,8,45,9,244,31509244
676,97,1788400,1,8,45,9,341,31509341
677,73,1788300,2,8,45,9,414,31509414
678,18,1788400,1,8,45,9,432,31509432
679,1,1788500,3,8,45,9,433,31509433
680,4,1788400,1,8,45,9,437,31509437
681,6,1788300,1,8,45,9,443,31509443
682,0,1788600,3,8,45,9,443,31509443
684,1,1788400,1,8,45,9,444,31509444
685,69,1788700,1,8,45,9,513,31509513
686,5,1788400,1,8,45,9,518,31509518
687,27,1788700,2,8,45,9,545,31509545
689,8,1788600,1,8,45,9,553,31509553
690,1,1788600,2,8,45,9,554,31509554
691,74,1788500,1,8,45,9,628,31509628
692,1,1788400,1,8,45,9,629,31509629
693,31,1788400,1,8,45,9,660,31509660
694,50,1788300,2,8,45,9,710,31509710
695,3,1788300,1,8,45,9,713,31509713
696,30,1788300,1,8,45,9,743,31509743
697,18,1788500,1,8,45,9,761,31509761
698,50,1788500,2,8,45,9,811,31509811
699,0,1788700,2,8,45,9,811,31509811
700,1,1788800,3,8,45,9,812,31509812
701,88,1788900,3,8,45,9,900,31509900
702,0,1788900,3,8,45,9,900,31509900
703,0,1788900,3,8,45,9,900,31509900
705,1,1789200,3,8,45,9,901,31509901
706,2,1789300,1,8,45,9,903,31509903
707,0,1789300,1,8,45,9,903,31509903
708,1,1789300,1,8,45,9,904,31509904
709,1,1789400,1,8,45,9,905,31509905
710,2,1789300,1,8,45,9,907,31509907
711,20,1789300,2,8,45,9,927,31509927
712,41,1789400,2,8,45,9,968,31509968
714,40,1789300,1,8,45,10,8,31510008
715,12,1789200,1,8,45,10,20,31510020
716,10,1789200,2,8,45,10,30,31510030
717,0,1789200,2,8,45,10,30,31510030
719,3,1788800,1,8,45,10,33,31510033
720,0,1788800,1,8,45,10,33,31510033
721,36,1788900,2,8,45,10,69,31510069
722,1,1788900,1,8,45,10,70,31510070
723,34,1788700,1,8,45,10,104,31510104
724,0,1789000,2,8,45,10,104,31510104
725,63,1788600,1,8,45,10,167,31510167
726,3,1789100,1,8,45,10,170,31510170
727,42,1788600,1,8,45,10,212,31510212
728,6,1788600,1,8,45,10,218,31510218
729,0,1788900,1,8,45,10,218,31510218
730,23,1789000,1,8,45,10,241,31510241
731,1,1789100,2,8,45,10,242,31510242
732,12,1789100,1,8,45,10,254,31510254
733,16,1789200,1,8,45,10,270,31510270
734,5,1789300,1,8,45,10,275,31510275
735,4,1788900,1,8,45,10,279,31510279
736,1,1789200,1,8,45,10,280,31510280
737,1,1789300,1,8,45,10,281,31510281
738,1,1789300,1,8,45,10,282,31510282
739,3,1789400,1,8,45,10,285,31510285
740,5,1789400,1,8,45,10,290,31510290
741,5,1789400,1,8,45,10,295,31510295
742,36,1789300,2,8,45,10,331,31510331
743,11,1789200,1,8,45,10,342,31510342
744,0,1789600,1,8,45,10,342,31510342
745,12,1789500,1,8,45,10,354,31510354
746,60,1789300,2,8,45,10,414,31510414
747,0,1789300,2,8,45,10,414,31510414
749,44,1789300,1,8,45,10,458,31510458
751,16,1789300,1,8,45,10,474,31510474
752,183,1789100,4,8,45,10,657,31510657
754,17,1789100,1,8,45,10,674,31510674
755,25,1789500,1,8,45,10,699,31510699
757,19,1789100,1,8,45,10,718,31510718
759,19,1789600,3,8,45,10,737,31510737
760,84,1789300,2,8,45,10,821,31510821
761,59,1789700,1,8,45,10,880,31510880
762,0,1789700,1,8,45,10,880,31510880
763,1,1789700,1,8,45,10,881,31510881
764,0,1789700,1,8,45,10,881,31510881
765,85,1789800,1,8,45,10,966,31510966
766,31,1789700,1,8,45,10,997,31510997
767,14,1789800,1,8,45,11,11,31511011
768,13,1789800,1,8,45,11,24,31511024
769,118,1789800,1,8,45,11,142,31511142
771,169,1789700,1,8,45,11,311,31511311
772,0,1789900,1,8,45,11,311,31511311
774,277,1790000,1,8,45,11,588,31511588
775,14,1790100,1,8,45,11,602,31511602
776,203,1790100,1,8,45,11,805,31511805
777,0,1790100,1,8,45,11,805,31511805
778,56,1790100,1,8,45,11,861,31511861
779,0,1790100,1,8,45,11,861,31511861
781,0,1790300,4,8,45,11,861,31511861
782,16,1790400,1,8,45,11,877,31511877
783,5,1790500,1,8,45,11,882,31511882
784,578,1790500,1,8,45,12,460,31512460
785,2,1790400,1,8,45,12,462,31512462
787,0,1790500,3,8,45,12,462,31512462
788,43,1790300,1,8,45,12,505,31512505
789,76,1790500,1,8,45,12,581,31512581
790,62,1790500,1,8,45,12,643,31512643
791,0,1790500,1,8,45,12,643,31512643
792,0,1790500,1,8,45,12,643,31512643
793,0,1790500,1,8,45,12,643,31512643
794,0,1790500,1,8,45,12,643,31512643
795,0,1790500,1,8,45,12,643,31512643
796,0,1790500,1,8,45,12,643,31512643
797,0,1790500,1,8,45,12,643,31512643
799,41,1791000,1,8,45,12,684,31512684
800,40,1791400,1,8,45,12,724,31512724
801,0,1791400,1,8,45,12,724,31512724
802,16,1791000,1,8,45,12,740,31512740
803,89,1791000,3,8,45,12,829,31512829
804,15,1791400,1,8,45,12,844,31512844
805,56,1791100,1,8,45,12,900,31512900
806,2,1791400,1,8,45,12,902,31512902
807,1,1791500,1,8,45,12,903,31512903
808,7,1791600,1,8,45,12,910,31512910
809,0,1791600,1,8,45,12,910,31512910
810,10,1791600,1,8,45,12,920,31512920
811,124,1791500,1,8,45,13,44,31513044
812,0,1791500,1,8,45,13,44,31513044
814,10,1791300,1,8,45,13,54,31513054
816,27,1791200,1,8,45,13,81,31513081
817,22,1791100,1,8,45,13,103,31513103
818,1,1791100,2,8,45,13,104,31513104
819,27,1791200,2,8,45,13,131,31513131
820,25,1791200,1,8,45,13,156,31513156
821,33,1791000,1,8,45,13,189,31513189
822,32,1790900,1,8,45,13,221,31513221
823,95,1791200,3,8,45,13,316,31513316
824,31,1791100,1,8,45,13,347,31513347
825,103,1791300,1,8,45,13,450,31513450
826,174,1791400,4,8,45,13,624,31513624
827,319,1791100,5,8,45,13,943,31513943
828,231,1791000,3,8,45,14,174,31514174
829,1,1791000,3,8,45,14,175,31514175
830,19,1791300,1,8,45,14,194,31514194
831,34,1791000,1,8,45,14,228,31514228
832,215,1790900,1,8,45,14,443,31514443
833,1,1790900,9,8,45,14,444,31514444
834,0,1790800,4,8,45,14,444,31514444
835,236,1790700,2,8,45,14,680,31514680
836,10,1790700,6,8,45,14,690,31514690
837,0,1790700,6,8,45,14,690,31514690
839,2,1790400,9,8,45,14,692,31514692
840,325,1790300,1,8,45,15,17,31515017
841,0,1790300,4,8,45,15,17,31515017
842,69,1790300,1,8,45,15,86,31515086
843,22,1790200,1,8,45,15,108,31515108
844,367,1790300,1,8,45,15,475,31515475
845,452,1790500,1,8,45,15,927,31515927
846,172,1790400,1,8,45,16,99,31516099
847,78,1790400,1,8,45,16,177,31516177
848,11,1790200,2,8,45,16,188,31516188
849,1,1790100,5,8,45,16,189,31516189
850,94,1790100,1,8,45,16,283,31516283
851,14,1790100,1,8,45,16,297,31516297
852,83,1790200,1,8,45,16,380,31516380
853,166,1790100,1,8,45,16,546,31516546
854,7,1790100,10,8,45,16,553,31516553
855,72,1790300,3,8,45,16,625,31516625
856,7,1790100,1,8,45,16,632,31516632
857,259,1790300,1,8,45,16,891,31516891
858,184,1790200,1,8,45,17,75,31517075
859,124,1790100,1,8,45,17,199,31517199
860,1,1790000,8,8,45,17,200,31517200
861,127,1790000,2,8,45,17,327,31517327
862,73,1790000,1,8,45,17,400,31517400
863,502,1789900,3,8,45,17,902,31517902
864,1,1789900,3,8,45,17,903,31517903
865,65,1789800,2,8,45,17,968,31517968
867,70,1789700,4,8,45,18,38,31518038
868,0,1789700,4,8,45,18,38,31518038
869,0,1789700,4,8,45,18,38,31518038
871,2,1789700,1,8,45,18,40,31518040
872,223,1789800,2,8,45,18,263,31518263
874,220,1789900,1,8,45,18,483,31518483
876,61,1789800,2,8,45,18,544,31518544
877,38,1790000,1,8,45,18,582,31518582
878,307,1790000,1,8,45,18,889,31518889
879,53,1790000,1,8,45,18,942,31518942
880,108,1790100,3,8,45,19,50,31519050
881,51,1790000,1,8,45,19,101,31519101
882,129,1790000,1,8,45,19,230,31519230
883,92,1790000,1,8,45,19,322,31519322
884,129,1790200,2,8,45,19,451,31519451
885,56,1790200,1,8,45,19,507,31519507
886,346,1790100,1,8,45,19,853,31519853
887,18,1790100,1,8,45,19,871,31519871
888,92,1790200,2,8,45,19,963,31519963
889,10,1790200,1,8,45,19,973,31519973
890,1,1790200,2,8,45,19,974,31519974
891,108,1790200,1,8,45,20,82,31520082
892,44,1790400,1,8,45,20,126,31520126
893,276,1790400,1,8,45,20,402,31520402
894,0,1790400,1,8,45,20,402,31520402
895,1,1790400,1,8,45,20,403,31520403
896,0,1790400,1,8,45,20,403,31520403
897,0,1790400,1,8,45,20,403,31520403
898,4,1790400,1,8,45,20,407,31520407
899,59,1790500,1,8,45,20,466,31520466
900,199,1790400,1,8,45,20,665,31520665
901,240,1790400,1,8,45,20,905,31520905
902,0,1790400,1,8,45,20,905,31520905
903,0,1790400,14,8,45,20,905,31520905
904,1,1790300,1,8,45,20,906,31520906
905,43,1790200,1,8,45,20,949,31520949
906,220,1790300,1,8,45,21,169,31521169
908,38,1790300,1,8,45,21,207,31521207
909,98,1790300,1,8,45,21,305,31521305
911,73,1790300,1,8,45,21,378,31521378
913,296,1790400,3,8,45,21,674,31521674
914,53,1790200,1,8,45,21,727,31521727
915,394,1790100,1,8,45,22,121,31522121
916,351,1790200,1,8,45,22,472,31522472
917,115,1790300,1,8,45,22,587,31522587
918,808,1790200,2,8,45,23,395,31523395
919,351,1790300,1,8,45,23,746,31523746
920,42,1790300,1,8,45,23,788,31523788
921,44,1790300,1,8,45,23,832,31523832
922,236,1790300,3,8,45,24,68,31524068
923,269,1790200,1,8,45,24,337,31524337
925,35,1790200,1,8,45,24,372,31524372
926,289,1790200,1,8,45,24,661,31524661
927,304,1790200,1,8,45,24,965,31524965
928,256,1790200,1,8,45,25,221,31525221
929,435,1790200,1,8,45,25,656,31525656
930,61,1790200,1,8,45,25,717,31525717
931,63,1790200,1,8,45,25,780,31525780
932,11,1790200,1,8,45,25,791,31525791
933,4,1790100,1,8,45,25,795,31525795
934,0,1790100,1,8,45,25,795,31525795
935,372,1790100,1,8,45,26,167,31526167
936,1,1790000,21,8,45,26,168,31526168
937,132,1790000,1,8,45,26,300,31526300
938,429,1790100,1,8,45,26,729,31526729
939,197,1790100,1,8,45,26,926,31526926
941,122,1790200,5,8,45,27,48,31527048
942,123,1790200,3,8,45,27,171,31527171
943,72,1790400,2,8,45,27,243,31527243
944,56,1790100,1,8,45,27,299,31527299
945,264,1790100,2,8,45,27,563,31527563
946,162,1790100,1,8,45,27,725,31527725
947,409,1790400,1,8,45,28,134,31528134
948,875,1790400,1,8,45,29,9,31529009
949,42,1790300,1,8,45,29,51,31529051
950,313,1790200,1,8,45,29,364,31529364
951,296,1790300,1,8,45,29,660,31529660
952,765,1790400,2,8,45,30,425,31530425
953,0,1790400,3,8,45,30,425,31530425
954,85,1790300,1,8,45,30,510,31530510
955,205,1790300,1,8,45,30,715,31530715
957,3,1790400,1,8,45,30,718,31530718
958,110,1790200,1,8,45,30,828,31530828
959,3,1790200,4,8,45,30,831,31530831
960,0,1790200,4,8,45,30,831,31530831
962,129,1790000,3,8,45,30,960,31530960
963,1018,1790200,1,8,45,31,978,31531978
964,116,1790000,2,8,45,32,94,31532094
965,124,1790100,1,8,45,32,218,31532218
966,215,1790200,1,8,45,32,433,31532433
967,127,1790100,1,8,45,32,560,31532560
968,55,1790100,1,8,45,32,615,31532615
970,1046,1790100,2,8,45,33,661,31533661
972,23,1790000,3,8,45,33,684,31533684
974,35,1789900,1,8,45,33,719,31533719
975,0,1789900,2,8,45,33,719,31533719
976,15,1789900,1,8,45,33,734,31533734
977,75,1789800,3,8,45,33,809,31533809
978,0,1789800,3,8,45,33,809,31533809
979,0,1789800,2,8,45,33,809,31533809
980,21,1789700,2,8,45,33,830,31533830
982,401,1789700,3,8,45,34,231,31534231
983,74,1789700,2,8,45,34,305,31534305
984,39,1789800,1,8,45,34,344,31534344
985,242,1789600,1,8,45,34,586,31534586
986,32,1789500,5,8,45,34,618,31534618
987,36,1789600,1,8,45,34,654,31534654
988,1,1789700,1,8,45,34,655,31534655
989,41,1789700,1,8,45,34,696,31534696
990,121,1789500,1,8,45,34,817,31534817
991,305,1789500,1,8,45,35,122,31535122
992,201,1789500,1,8,45,35,323,31535323
993,411,1789600,2,8,45,35,734,31535734
995,242,1789700,1,8,45,35,976,31535976
996,103,1789800,1,8,45,36,79,31536079
997,156,1789800,6,8,45,36,235,31536235
998,72,1789700,1,8,45,36,307,31536307
999,6,1789900,2,8,45,36,313,31536313
1000,7,1789800,1,8,45,36,320,31536320
1001,81,1790000,5,8,45,36,401,31536401
1002,444,1790200,1,8,45,36,845,31536845
1003,567,1790200,1,8,45,37,412,31537412
1004,213,1790000,5,8,45,37,625,31537625
1005,38,1790100,1,8,45,37,663,31537663
1006,1,1790100,1,8,45,37,664,31537664
1007,1,1790100,1,8,45,37,665,31537665
1008,466,1790000,2,8,45,38,131,31538131
1009,217,1790200,1,8,45,38,348,31538348
1010,100,1790000,1,8,45,38,448,31538448
1011,257,1790000,1,8,45,38,705,31538705
1012,305,1789900,1,8,45,39,10,31539010
1013,45,1790000,1,8,45,39,55,31539055
1014,192,1790000,1,8,45,39,247,31539247
1015,101,1790200,1,8,45,39,348,31539348
1016,1,1790200,1,8,45,39,349,31539349
1017,20,1790300,1,8,45,39,369,31539369
1018,0,1790300,5,8,45,39,369,31539369
1019,0,1790300,3,8,45,39,369,31539369
1020,79,1790300,1,8,45,39,448,31539448
1021,114,1790200,1,8,45,39,562,31539562
1022,93,1790200,2,8,45,39,655,31539655
1023,168,1790200,1,8,45,39,823,31539823
1024,292,1790300,1,8,45,40,115,31540115
1026,27,1790200,1,8,45,40,142,31540142
1027,253,1790100,1,8,45,40,395,31540395
1028,764,1790100,1,8,45,41,159,31541159
1029,0,1790100,1,8,45,41,159,31541159
1030,64,1790100,1,8,45,41,223,31541223
1031,0,1790100,3,8,45,41,223,31541223
1032,75,1790000,1,8,45,41,298,31541298
1033,66,1790100,1,8,45,41,364,31541364
1034,1322,1790100,1,8,45,42,686,31542686
1035,566,1790200,3,8,45,43,252,31543252
1037,47,1790300,2,8,45,43,299,31543299
1038,44,1790200,2,8,45,43,343,31543343
1039,1176,1790300,1,8,45,44,519,31544519
1040,87,1790300,1,8,45,44,606,31544606
1041,110,1790400,3,8,45,44,716,31544716
1042,290,1790400,1,8,45,45,6,31545006
1043,160,1790300,1,8,45,45,166,31545166
1044,761,1790300,2,8,45,45,927,31545927
1045,173,1790500,1,8,45,46,100,31546100
1046,210,1790400,2,8,45,46,310,31546310
1047,393,1790500,3,8,45,46,703,31546703
1048,651,1790400,2,8,45,47,354,31547354
1049,277,1790500,1,8,45,47,631,31547631
1050,299,1790300,7,8,45,47,930,31547930
1051,1,1790300,18,8,45,47,931,31547931
1052,191,1790300,3,8,45,48,122,31548122
1053,351,1790400,4,8,45,48,473,31548473
1054,373,1790400,1,8,45,48,846,31548846
1055,210,1790300,2,8,45,49,56,31549056
1057,373,1790200,1,8,45,49,429,31549429
1058,0,1790200,4,8,45,49,429,31549429
1059,10,1790300,1,8,45,49,439,31549439
1060,350,1790300,1,8,45,49,789,31549789
1061,1245,1790200,2,8,45,51,34,31551034
1062,987,1790200,1,8,45,52,21,31552021
1063,0,1790100,10,8,45,52,21,31552021
1064,5,1790000,6,8,45,52,26,31552026
1065,0,1790000,1,8,45,52,26,31552026
1066,0,1790000,3,8,45,52,26,31552026
1067,73,1789900,1,8,45,52,99,31552099
1068,0,1789800,7,8,45,52,99,31552099
1069,1,1789900,1,8,45,52,100,31552100
1070,29,1789700,3,8,45,52,129,31552129
1071,81,1789900,2,8,45,52,210,31552210
1072,58,1789700,1,8,45,52,268,31552268
1073,0,1789700,1,8,45,52,268,31552268
1074,83,1789800,1,8,45,52,351,31552351
1075,123,1789600,3,8,45,52,474,31552474
1076,0,1789600,12,8,45,52,474,31552474
1077,157,1789600,1,8,45,52,631,31552631
1078,7,1789600,1,8,45,52,638,31552638
1079,53,1789700,1,8,45,52,691,31552691
1080,159,1789700,1,8,45,52,850,31552850
1081,2,1789700,1,8,45,52,852,31552852
1082,177,1789700,1,8,45,53,29,31553029
1083,546,1789700,1,8,45,53,575,31553575
1084,88,1789700,1,8,45,53,663,31553663
1085,370,1789500,1,8,45,54,33,31554033
1086,0,1789500,5,8,45,54,33,31554033
1087,1,1789400,2,8,45,54,34,31554034
1088,1,1789500,1,8,45,54,35,31554035
1089,81,1789500,3,8,45,54,116,31554116
1091,444,1789600,10,8,45,54,560,31554560
1092,3,1789700,5,8,45,54,563,31554563
1093,39,1789800,2,8,45,54,602,31554602
1094,63,1789800,5,8,45,54,665,31554665
1095,1,1789900,4,8,45,54,666,31554666
1096,102,1789900,3,8,45,54,768,31554768
1097,258,1790100,3,8,45,55,26,31555026
1098,1,1790100,1,8,45,55,27,31555027
1099,2,1790100,2,8,45,55,29,31555029
1100,328,1790200,5,8,45,55,357,31555357
1101,461,1790200,1,8,45,55,818,31555818
1102,221,1790200,1,8,45,56,39,31556039
1103,430,1790200,1,8,45,56,469,31556469
1104,0,1790100,4,8,45,56,469,31556469
1105,142,1790200,1,8,45,56,611,31556611
1106,178,1790300,3,8,45,56,789,31556789
1107,2,1790300,1,8,45,56,791,31556791
1108,67,1790300,1,8,45,56,858,31556858
1109,419,1790400,3,8,45,57,277,31557277
1110,2,1790400,5,8,45,57,279,31557279
1111,101,1790500,8,8,45,57,380,31557380
1112,111,1790600,11,8,45,57,491,31557491
1113,5,1790700,9,8,45,57,496,31557496
1114,86,1790700,1,8,45,57,582,31557582
1116,88,1790800,2,8,45,57,670,31557670
1117,1,1790800,6,8,45,57,671,31557671
1118,15,1790900,2,8,45,57,686,31557686
1119,1,1790900,7,8,45,57,687,31557687
1120,1,1791000,1,8,45,57,688,31557688
1121,0,1791000,1,8,45,57,688,31557688
1122,0,1791000,1,8,45,57,688,31557688
1123,1,1791000,1,8,45,57,689,31557689
1124,0,1791000,1,8,45,57,689,31557689
1125,0,1791000,1,8,45,57,689,31557689
1126,84,1791000,15,8,45,57,773,31557773
1127,94,1791100,2,8,45,57,867,31557867
1128,8,1791100,7,8,45,57,875,31557875
1129,1,1791200,6,8,45,57,876,31557876
1130,5,1791200,4,8,45,57,881,31557881
1131,40,1791200,1,8,45,57,921,31557921
1132,24,1791200,1,8,45,57,945,31557945
1133,103,1791300,8,8,45,58,48,31558048
1134,4,1791400,5,8,45,58,52,31558052
1135,1,1791400,1,8,45,58,53,31558053
1136,30,1791300,1,8,45,58,83,31558083
1137,0,1791300,2,8,45,58,83,31558083
1138,3,1791400,1,8,45,58,86,31558086
1139,11,1791400,1,8,45,58,97,31558097
1140,8,1791400,2,8,45,58,105,31558105
1141,3,1791400,2,8,45,58,108,31558108
1142,63,1791400,2,8,45,58,171,31558171
1143,3,1791400,1,8,45,58,174,31558174
1144,9,1791400,1,8,45,58,183,31558183
1145,88,1791300,2,8,45,58,271,31558271
1147,4,1791400,1,8,45,58,275,31558275
1148,72,1791300,1,8,45,58,347,31558347
1149,6,1791400,1,8,45,58,353,31558353
1150,81,1791500,2,8,45,58,434,31558434
1151,62,1791500,2,8,45,58,496,31558496
1152,20,1791600,5,8,45,58,516,31558516
1153,81,1791700,5,8,45,58,597,31558597
1154,112,1791600,1,8,45,58,709,31558709
1155,8,1791600,1,8,45,58,717,31558717
1156,7,1791500,1,8,45,58,724,31558724
1158,2,1791600,1,8,45,58,726,31558726
1159,12,1791600,1,8,45,58,738,31558738
1160,54,1791600,3,8,45,58,792,31558792
1161,175,1791600,1,8,45,58,967,31558967
1162,32,1791500,1,8,45,58,999,31558999
1163,95,1791600,1,8,45,59,94,31559094
1164,167,1791500,1,8,45,59,261,31559261
1165,52,1791600,5,8,45,59,313,31559313
1166,44,1791500,1,8,45,59,357,31559357
1167,138,1791700,1,8,45,59,495,31559495
1168,54,1791500,1,8,45,59,549,31559549
1169,8,1791600,1,8,45,59,557,31559557
1170,154,1791400,2,8,45,59,711,31559711
1171,3,1791600,3,8,45,59,714,31559714
1172,32,1791600,1,8,45,59,746,31559746
1173,203,1791600,1,8,45,59,949,31559949
1174,1,1791400,1,8,45,59,950,31559950
1175,36,1791500,2,8,45,59,986,31559986
1176,13,1791500,1,8,45,59,999,31559999
1177,2,1791500,1,8,46,0,1,31560001
1178,6,1791500,1,8,46,0,7,31560007
1179,2,1791600,1,8,46,0,9,31560009
1180,9,1791500,1,8,46,0,18,31560018
1181,2,1791400,1,8,46,0,20,31560020
1182,3,1791300,1,8,46,0,23,31560023
1183,17,1791300,3,8,46,0,40,31560040
1184,40,1791300,1,8,46,0,80,31560080
1185,1,1791300,1,8,46,0,81,31560081
1186,22,1791400,1,8,46,0,103,31560103
1187,0,1791400,4,8,46,0,103,31560103
1188,0,1791500,1,8,46,0,103,31560103
1189,0,1791500,1,8,46,0,103,31560103
1190,0,1791300,1,8,46,0,103,31560103
1191,0,1791400,1,8,46,0,103,31560103
1192,1,1791500,2,8,46,0,104,31560104
1193,0,1791500,1,8,46,0,104,31560104
1194,63,1791400,2,8,46,0,167,31560167
1195,18,1791400,3,8,46,0,185,31560185
1196,0,1791400,3,8,46,0,185,31560185
1198,14,1791400,1,8,46,0,199,31560199
1199,22,1791300,3,8,46,0,221,31560221
1201,1,1791300,2,8,46,0,222,31560222
1202,13,1791100,2,8,46,0,235,31560235
1203,3,1791100,1,8,46,0,238,31560238
1204,21,1791200,1,8,46,0,259,31560259
1205,16,1791000,3,8,46,0,275,31560275
1207,8,1790800,1,8,46,0,283,31560283
1208,48,1790900,3,8,46,0,331,31560331
1209,30,1790900,1,8,46,0,361,31560361
1210,12,1790800,1,8,46,0,373,31560373
1211,66,1790800,3,8,46,0,439,31560439
1212,3,1790700,2,8,46,0,442,31560442
1213,1,1790700,1,8,46,0,443,31560443
1214,1,1790900,2,8,46,0,444,31560444
1215,1,1790700,2,8,46,0,445,31560445
1216,2,1790800,1,8,46,0,447,31560447
1217,1,1790900,1,8,46,0,448,31560448
1218,27,1790800,1,8,46,0,475,31560475
1219,70,1790700,2,8,46,0,545,31560545
1220,1,1790700,1,8,46,0,546,31560546
1221,6,1790800,1,8,46,0,552,31560552
1222,143,1790900,1,8,46,0,695,31560695
1223,188,1790700,1,8,46,0,883,31560883
1224,41,1790800,1,8,46,0,924,31560924
1225,2,1790700,2,8,46,0,926,31560926
1226,76,1790900,2,8,46,1,2,31561002
1227,209,1790700,1,8,46,1,211,31561211
1229,233,1790800,6,8,46,1,444,31561444
1230,1,1790900,1,8,46,1,445,31561445
1231,0,1790900,2,8,46,1,445,31561445
1232,21,1790800,1,8,46,1,466,31561466
1234,5,1790800,2,8,46,1,471,31561471
1235,13,1790900,2,8,46,1,484,31561484
1236,103,1791000,5,8,46,1,587,31561587
1237,1,1791100,2,8,46,1,588,31561588
1238,55,1791100,1,8,46,1,643,31561643
1239,33,1791000,1,8,46,1,676,31561676
1240,20,1791200,2,8,46,1,696,31561696
1241,16,1791100,1,8,46,1,712,31561712
1242,3,1791200,1,8,46,1,715,31561715
1243,15,1791300,2,8,46,1,730,31561730
1245,31,1791200,1,8,46,1,761,31561761
1246,32,1791300,2,8,46,1,793,31561793
1247,33,1791200,2,8,46,1,826,31561826
1248,0,1791200,2,8,46,1,826,31561826
1249,0,1791200,2,8,46,1,826,31561826
1250,0,1791200,2,8,46,1,826,31561826
1252,5,1791100,1,8,46,1,831,31561831
1253,3,1791100,2,8,46,1,834,31561834
1254,30,1791000,1,8,46,1,864,31561864
1255,19,1791200,2,8,46,1,883,31561883
1256,32,1791300,1,8,46,1,915,31561915
1257,0,1791300,1,8,46,1,915,31561915
1258,0,1791300,1,8,46,1,915,31561915
1260,21,1791300,6,8,46,1,936,31561936
1261,25,1791300,1,8,46,1,961,31561961
1262,17,1791200,1,8,46,1,978,31561978
1263,83,1791400,13,8,46,2,61,31562061
1264,43,1791500,1,8,46,2,104,31562104
1266,59,1791600,3,8,46,2,163,31562163
1267,88,1791500,1,8,46,2,251,31562251
1268,245,1791600,2,8,46,2,496,31562496
1269,111,1791700,3,8,46,2,607,31562607
1270,14,1791800,1,8,46,2,621,31562621
1271,103,1791800,5,8,46,2,724,31562724
1272,12,1791700,1,8,46,2,736,31562736
1273,40,1791700,4,8,46,2,776,31562776
1274,0,1791700,1,8,46,2,776,31562776
1275,4,1791800,2,8,46,2,780,31562780
1276,4,1791700,1,8,46,2,784,31562784
1278,6,1791800,1,8,46,2,790,31562790
1279,76,1791600,1,8,46,2,866,31562866
1280,254,1791700,1,8,46,3,120,31563120
1281,66,1791700,1,8,46,3,186,31563186
1282,56,1791600,1,8,46,3,242,31563242
1283,38,1791800,3,8,46,3,280,31563280
1284,1,1791800,2,8,46,3,281,31563281
1285,21,1791600,3,8,46,3,302,31563302
1286,182,1791600,1,8,46,3,484,31563484
1287,225,1791600,1,8,46,3,709,31563709
1288,4,1791700,3,8,46,3,713,31563713
1289,12,1791700,1,8,46,3,725,31563725
1290,102,1791600,6,8,46,3,827,31563827
1291,28,1791700,2,8,46,3,855,31563855
1293,50,1791600,5,8,46,3,905,31563905
1295,16,1791700,2,8,46,3,921,31563921
1296,8,1791700,4,8,46,3,929,31563929
1297,13,1791800,2,8,46,3,942,31563942
1298,34,1791700,2,8,46,3,976,31563976
1300,31,1791800,1,8,46,4,7,31564007
1301,107,1791700,5,8,46,4,114,31564114
1302,96,1791600,1,8,46,4,210,31564210
1303,53,1791600,1,8,46,4,263,31564263
1304,515,1791700,1,8,46,4,778,31564778
1305,60,1791600,1,8,46,4,838,31564838
1306,3,1791700,2,8,46,4,841,31564841
1307,0,1791500,1,8,46,4,841,31564841
1308,205,1791700,1,8,46,5,46,31565046
1309,60,1791700,2,8,46,5,106,31565106
1310,1,1791800,2,8,46,5,107,31565107
1311,7,1791600,1,8,46,5,114,31565114
1312,96,1791600,1,8,46,5,210,31565210
1313,148,1791600,1,8,46,5,358,31565358
1314,172,1791700,1,8,46,5,530,31565530
1315,24,1791700,1,8,46,5,554,31565554
1316,12,1791700,1,8,46,5,566,31565566
1317,1,1791600,1,8,46,5,567,31565567
1318,0,1791600,1,8,46,5,567,31565567
1319,273,1791700,2,8,46,5,840,31565840
1320,345,1791700,1,8,46,6,185,31566185
1321,6,1791800,1,8,46,6,191,31566191
1322,229,1791600,1,8,46,6,420,31566420
1323,30,1791600,1,8,46,6,450,31566450
1324,118,1791600,1,8,46,6,568,31566568
1325,86,1791700,1,8,46,6,654,31566654
1326,92,1791700,1,8,46,6,746,31566746
1327,188,1791800,2,8,46,6,934,31566934
1328,18,1791600,2,8,46,6,952,31566952
1329,64,1791600,1,8,46,7,16,31567016
1331,6,1791600,2,8,46,7,22,31567022
1332,6,1791500,3,8,46,7,28,31567028
1333,47,1791500,1,8,46,7,75,31567075
1334,4,1791600,1,8,46,7,79,31567079
1335,22,1791700,1,8,46,7,101,31567101
1336,0,1791700,1,8,46,7,101,31567101
1337,232,1791500,1,8,46,7,333,31567333
1338,146,1791700,3,8,46,7,479,31567479
1339,231,1791700,1,8,46,7,710,31567710
1340,152,1791600,1,8,46,7,862,31567862
1341,30,1791600,2,8,46,7,892,31567892
1343,1,1791500,5,8,46,7,893,31567893
1344,427,1791600,1,8,46,8,320,31568320
1345,556,1791600,1,8,46,8,876,31568876
1346,324,1791600,1,8,46,9,200,31569200
1347,102,1791400,1,8,46,9,302,31569302
1348,118,1791500,1,8,46,9,420,31569420
1349,108,1791600,1,8,46,9,528,31569528
1350,81,1791400,1,8,46,9,609,31569609
1351,620,1791600,1,8,46,10,229,31570229
1352,41,1791400,1,8,46,10,270,31570270
1353,823,1791400,1,8,46,11,93,31571093
1354,664,1791500,1,8,46,11,757,31571757
1355,256,1791500,1,8,46,12,13,31572013
1356,287,1791400,1,8,46,12,300,31572300
1357,0,1791400,3,8,46,12,300,31572300
1358,30,1791300,6,8,46,12,330,31572330
1359,1,1791300,1,8,46,12,331,31572331
1360,0,1791300,1,8,46,12,331,31572331
1361,24,1791300,2,8,46,12,355,31572355
1362,307,1791300,1,8,46,12,662,31572662
1363,73,1791200,1,8,46,12,735,31572735
1364,2712,1791200,2,8,46,15,447,31575447
1365,31,1791300,1,8,46,15,478,31575478
1366,435,1791300,2,8,46,15,913,31575913
1368,1,1791300,1,8,46,15,914,31575914
1369,71,1791300,1,8,46,15,985,31575985
1370,0,1791400,2,8,46,15,985,31575985
1371,302,1791200,1,8,46,16,287,31576287
1372,63,1791400,1,8,46,16,350,31576350
1373,196,1791400,3,8,46,16,546,31576546
1375,65,1791600,1,8,46,16,611,31576611
1376,1,1791600,1,8,46,16,612,31576612
1377,40,1791500,1,8,46,16,652,31576652
1378,108,1791500,1,8,46,16,760,31576760
1379,443,1791600,2,8,46,17,203,31577203
1380,0,1791600,2,8,46,17,203,31577203
1381,0,1791600,1,8,46,17,203,31577203
1382,2,1791700,6,8,46,17,205,31577205
1383,21,1791700,1,8,46,17,226,31577226
1384,0,1791700,1,8,46,17,226,31577226
1385,0,1791700,1,8,46,17,226,31577226
1386,0,1791700,1,8,46,17,226,31577226
1387,0,1791700,1,8,46,17,226,31577226
1388,0,1791700,1,8,46,17,226,31577226
1389,0,1791700,1,8,46,17,226,31577226
1390,0,1791700,1,8,46,17,226,31577226
1391,1,1791800,1,8,46,17,227,31577227
1392,0,1791800,1,8,46,17,227,31577227
1393,83,1791700,1,8,46,17,310,31577310
1394,214,1791700,1,8,46,17,524,31577524
1395,21,1791600,1,8,46,17,545,31577545
1396,334,1791800,1,8,46,17,879,31577879
1397,220,1791700,1,8,46,18,99,31578099
1398,331,1791800,1,8,46,18,430,31578430
1399,100,1791800,6,8,46,18,530,31578530
1400,106,1791700,1,8,46,18,636,31578636
1401,101,1791800,1,8,46,18,737,31578737
1402,82,1791900,14,8,46,18,819,31578819
1404,116,1792000,28,8,46,18,935,31578935
1405,1,1792000,1,8,46,18,936,31578936
1406,0,1792000,2,8,46,18,936,31578936
1407,0,1792100,1,8,46,18,936,31578936
1408,41,1792100,7,8,46,18,977,31578977
1409,0,1792100,5,8,46,18,977,31578977
1410,1,1792200,3,8,46,18,978,31578978
1411,0,1792300,3,8,46,18,978,31578978
1412,2,1792300,3,8,46,18,980,31578980
1413,8,1792300,1,8,46,18,988,31578988
1414,130,1792300,1,8,46,19,118,31579118
1415,8,1792300,1,8,46,19,126,31579126
1416,0,1792300,1,8,46,19,126,31579126
1418,78,1792300,1,8,46,19,204,31579204
1419,30,1792500,2,8,46,19,234,31579234
1420,23,1792500,2,8,46,19,257,31579257
1421,19,1792500,1,8,46,19,276,31579276
1422,10,1792500,6,8,46,19,286,31579286
1424,67,1792600,1,8,46,19,353,31579353
1425,1,1792600,1,8,46,19,354,31579354
1426,40,1792700,1,8,46,19,394,31579394
1427,31,1792700,1,8,46,19,425,31579425
1428,10,1792400,1,8,46,19,435,31579435
1429,40,1792400,3,8,46,19,475,31579475
1430,0,1792400,3,8,46,19,475,31579475
1432,2,1792300,2,8,46,19,477,31579477
1433,81,1792400,1,8,46,19,558,31579558
1434,204,1792400,2,8,46,19,762,31579762
1436,41,1792300,1,8,46,19,803,31579803
1437,150,1792300,1,8,46,19,953,31579953
1438,68,1792300,1,8,46,20,21,31580021
1439,16,1792400,1,8,46,20,37,31580037
1440,237,1792300,1,8,46,20,274,31580274
1441,1,1792300,2,8,46,20,275,31580275
1442,0,1792300,1,8,46,20,275,31580275
1443,55,1792100,1,8,46,20,330,31580330
1444,692,1792200,2,8,46,21,22,31581022
1446,308,1791900,1,8,46,21,330,31581330
1447,43,1792100,1,8,46,21,373,31581373
1448,944,1791900,1,8,46,22,317,31582317
1449,54,1791800,2,8,46,22,371,31582371
1451,71,1791600,1,8,46,22,442,31582442
1452,108,1791800,1,8,46,22,550,31582550
1453,170,1791600,1,8,46,22,720,31582720
1454,17,1791700,2,8,46,22,737,31582737
1455,85,1791600,1,8,46,22,822,31582822
1456,191,1791700,1,8,46,23,13,31583013
1457,362,1791600,1,8,46,23,375,31583375
1458,158,1791700,1,8,46,23,533,31583533
1459,114,1791700,1,8,46,23,647,31583647
1460,309,1791700,1,8,46,23,956,31583956
1461,33,1791500,1,8,46,23,989,31583989
1462,320,1791700,1,8,46,24,309,31584309
1463,187,1791700,1,8,46,24,496,31584496
1464,42,1791800,2,8,46,24,538,31584538
1465,1,1791900,1,8,46,24,539,31584539
1466,0,1791900,2,8,46,24,539,31584539
1467,3,1792000,2,8,46,24,542,31584542
1469,95,1792100,1,8,46,24,637,31584637
1470,0,1792100,2,8,46,24,637,31584637
1471,108,1792200,1,8,46,24,745,31584745
1473,0,1792300,4,8,46,24,745,31584745
1474,1515,1792000,1,8,46,26,260,31586260
1475,154,1791900,1,8,46,26,414,31586414
1476,155,1791900,1,8,46,26,569,31586569
1477,21,1792000,1,8,46,26,590,31586590
1478,101,1791800,1,8,46,26,691,31586691
1479,1007,1792000,6,8,46,27,698,31587698
1481,27,1792200,1,8,46,27,725,31587725
1482,0,1792200,1,8,46,27,725,31587725
1483,0,1792200,1,8,46,27,725,31587725
1484,1,1792200,1,8,46,27,726,31587726
1485,0,1792200,1,8,46,27,726,31587726
1486,0,1792200,1,8,46,27,726,31587726
1487,0,1792200,1,8,46,27,726,31587726
1488,0,1792200,1,8,46,27,726,31587726
1489,0,1792200,1,8,46,27,726,31587726
1490,0,1792200,1,8,46,27,726,31587726
1491,0,1792200,1,8,46,27,726,31587726
1492,0,1792200,1,8,46,27,726,31587726
1493,0,1792300,1,8,46,27,726,31587726
1494,4,1792200,2,8,46,27,730,31587730
1495,12,1792200,1,8,46,27,742,31587742
1496,19,1792200,1,8,46,27,761,31587761
1497,69,1792200,1,8,46,27,830,31587830
1498,56,1792300,1,8,46,27,886,31587886
1499,1418,1792200,1,8,46,29,304,31589304
1500,935,1792100,1,8,46,30,239,31590239
1501,31,1792100,1,8,46,30,270,31590270
1502,309,1792100,1,8,46,30,579,31590579
1503,924,1792200,2,8,46,31,503,31591503
1504,249,1792100,2,8,46,31,752,31591752
1505,307,1792300,1,8,46,32,59,31592059
1506,122,1792100,1,8,46,32,181,31592181
1507,189,1792000,1,8,46,32,370,31592370
1508,236,1792000,1,8,46,32,606,31592606
1509,14,1792000,1,8,46,32,620,31592620
1510,544,1792000,1,8,46,33,164,31593164
1511,67,1792000,2,8,46,33,231,31593231
1512,478,1792100,1,8,46,33,709,31593709
1513,162,1792100,1,8,46,33,871,31593871
1514,15,1792200,5,8,46,33,886,31593886
1515,257,1792200,1,8,46,34,143,31594143
1517,1,1792300,1,8,46,34,144,31594144
1518,40,1792200,2,8,46,34,184,31594184
1519,374,1792300,1,8,46,34,558,31594558
1520,72,1792200,1,8,46,34,630,31594630
1521,89,1792400,1,8,46,34,719,31594719
1522,330,1792400,7,8,46,35,49,31595049
1524,1,1792500,2,8,46,35,50,31595050
1525,570,1792400,1,8,46,35,620,31595620
1526,97,1792600,1,8,46,35,717,31595717
1527,970,1792400,2,8,46,36,687,31596687
1528,163,1792600,2,8,46,36,850,31596850
1529,73,1792600,3,8,46,36,923,31596923
1531,239,1792500,1,8,46,37,162,31597162
1532,63,1792700,1,8,46,37,225,31597225
1533,0,1792700,1,8,46,37,225,31597225
1534,1,1792700,1,8,46,37,226,31597226
1535,61,1792600,1,8,46,37,287,31597287
1536,273,1792800,1,8,46,37,560,31597560
1537,84,1792800,2,8,46,37,644,31597644
1538,100,1792600,1,8,46,37,744,31597744
1539,39,1792800,1,8,46,37,783,31597783
1540,120,1792800,12,8,46,37,903,31597903
1541,0,1792800,12,8,46,37,903,31597903
1543,2,1793100,4,8,46,37,905,31597905
1544,0,1793100,1,8,46,37,905,31597905
1545,0,1793100,1,8,46,37,905,31597905
1546,1,1793100,1,8,46,37,906,31597906
1547,0,1793100,1,8,46,37,906,31597906
1548,0,1793100,1,8,46,37,906,31597906
1549,1,1793100,6,8,46,37,907,31597907
1551,0,1793000,12,8,46,37,907,31597907
1552,1,1793100,5,8,46,37,908,31597908
1554,0,1793200,3,8,46,37,908,31597908
1555,23,1793000,6,8,46,37,931,31597931
1556,103,1793100,1,8,46,38,34,31598034
1557,22,1792900,1,8,46,38,56,31598056
1558,49,1793000,3,8,46,38,105,31598105
1560,176,1793000,1,8,46,38,281,31598281
1561,188,1792800,2,8,46,38,469,31598469
1562,80,1792800,1,8,46,38,549,31598549
1563,2,1792800,1,8,46,38,551,31598551
1564,22,1792900,1,8,46,38,573,31598573
1565,37,1792900,1,8,46,38,610,31598610
1566,161,1792900,1,8,46,38,771,31598771
1567,105,1792700,1,8,46,38,876,31598876
1568,46,1792900,1,8,46,38,922,31598922
1569,99,1792700,1,8,46,39,21,31599021
1570,233,1792900,1,8,46,39,254,31599254
1571,86,1792700,1,8,46,39,340,31599340
1572,27,1792900,3,8,46,39,367,31599367
1573,274,1792700,1,8,46,39,641,31599641
1574,143,1792800,2,8,46,39,784,31599784
1575,71,1792700,1,8,46,39,855,31599855
1576,134,1792800,1,8,46,39,989,31599989
1577,289,1792600,4,8,46,40,278,31600278
1578,207,1792600,1,8,46,40,485,31600485
1579,80,1792800,4,8,46,40,565,31600565
1580,187,1792900,2,8,46,40,752,31600752
1581,1,1793000,6,8,46,40,753,31600753
1582,40,1792900,1,8,46,40,793,31600793
1583,187,1793100,1,8,46,40,980,31600980
1584,0,1793200,9,8,46,40,980,31600980
1585,1,1793200,1,8,46,40,981,31600981
1586,153,1793100,1,8,46,41,134,31601134
1587,109,1793300,9,8,46,41,243,31601243
1588,1,1793300,1,8,46,41,244,31601244
1589,0,1793400,4,8,46,41,244,31601244
1590,42,1793400,1,8,46,41,286,31601286
1591,100,1793400,1,8,46,41,386,31601386
1592,94,1793300,1,8,46,41,480,31601480
1593,22,1793300,1,8,46,41,502,31601502
1594,349,1793300,1,8,46,41,851,31601851
1595,80,1793300,1,8,46,41,931,31601931
1597,225,1793200,1,8,46,42,156,31602156
1598,388,1793400,1,8,46,42,544,31602544
1599,6,1793200,1,8,46,42,550,31602550
1600,92,1793400,1,8,46,42,642,31602642
1601,95,1793300,1,8,46,42,737,31602737
1602,419,1793200,1,8,46,43,156,31603156
1603,7,1793200,1,8,46,43,163,31603163
1604,81,1793200,1,8,46,43,244,31603244
1605,154,1793200,1,8,46,43,398,31603398
1606,63,1793200,1,8,46,43,461,31603461
1607,299,1793100,1,8,46,43,760,31603760
1608,71,1793200,1,8,46,43,831,31603831
1609,200,1793100,1,8,46,44,31,31604031
1610,64,1793000,2,8,46,44,95,31604095
1611,207,1793200,1,8,46,44,302,31604302
1612,503,1793200,1,8,46,44,805,31604805
1613,307,1793200,1,8,46,45,112,31605112
1615,167,1793300,1,8,46,45,279,31605279
1616,548,1793100,1,8,46,45,827,31605827
1617,302,1793200,1,8,46,46,129,31606129
1618,626,1793000,23,8,46,46,755,31606755
1619,1,1792900,1,8,46,46,756,31606756
1620,0,1792900,2,8,46,46,756,31606756
1621,1,1792800,13,8,46,46,757,31606757
1622,2,1792700,1,8,46,46,759,31606759
1623,246,1792800,2,8,46,47,5,31607005
1625,96,1792900,1,8,46,47,101,31607101
1626,942,1792900,3,8,46,48,43,31608043
1627,77,1792800,1,8,46,48,120,31608120
1628,425,1792800,1,8,46,48,545,31608545
1629,206,1792900,4,8,46,48,751,31608751
1630,190,1792800,1,8,46,48,941,31608941
1631,44,1792700,1,8,46,48,985,31608985
1632,254,1792800,1,8,46,49,239,31609239
1633,192,1792900,3,8,46,49,431,31609431
1634,9,1793000,1,8,46,49,440,31609440
1635,393,1792700,1,8,46,49,833,31609833
1636,26,1792900,1,8,46,49,859,31609859
1637,13,1792900,1,8,46,49,872,31609872
1638,1228,1792800,1,8,46,51,100,31611100
1639,781,1792700,1,8,46,51,881,31611881
1640,825,1792800,1,8,46,52,706,31612706
1641,321,1792800,8,8,46,53,27,31613027
1642,0,1792900,2,8,46,53,27,31613027
1643,0,1792900,3,8,46,53,27,31613027
1644,1,1792900,4,8,46,53,28,31613028
1645,28,1792800,3,8,46,53,56,31613056
1646,81,1793000,4,8,46,53,137,31613137
1647,1,1793000,6,8,46,53,138,31613138
1648,0,1793000,1,8,46,53,138,31613138
1649,1,1793000,1,8,46,53,139,31613139
1650,521,1792900,2,8,46,53,660,31613660
1651,41,1793000,1,8,46,53,701,31613701
1652,132,1793000,1,8,46,53,833,31613833
1653,67,1793000,1,8,46,53,900,31613900
1654,164,1793000,1,8,46,54,64,31614064
1655,669,1793000,1,8,46,54,733,31614733
1656,20,1793000,4,8,46,54,753,31614753
1657,100,1793000,1,8,46,54,853,31614853
1658,72,1793000,1,8,46,54,925,31614925
1659,495,1792900,1,8,46,55,420,31615420
1660,218,1793000,2,8,46,55,638,31615638
1661,111,1793000,5,8,46,55,749,31615749
1662,385,1793000,5,8,46,56,134,31616134
1663,0,1793000,5,8,46,56,134,31616134
1664,477,1793100,4,8,46,56,611,31616611
1665,172,1793100,7,8,46,56,783,31616783
1666,0,1793100,7,8,46,56,783,31616783
1667,0,1793100,7,8,46,56,783,31616783
1668,0,1793100,7,8,46,56,783,31616783
1670,3,1793500,2,8,46,56,786,31616786
1671,0,1793600,1,8,46,56,786,31616786
1672,1,1793500,34,8,46,56,787,31616787
1673,1,1793500,2,8,46,56,788,31616788
1675,0,1793600,5,8,46,56,788,31616788
1676,0,1793600,1,8,46,56,788,31616788
1677,1,1793600,1,8,46,56,789,31616789
1678,2,1793700,1,8,46,56,791,31616791
1679,0,1793600,3,8,46,56,791,31616791
1680,0,1793600,1,8,46,56,791,31616791
1681,37,1793700,1,8,46,56,828,31616828
1682,13,1793600,3,8,46,56,841,31616841
1683,69,1793600,1,8,46,56,910,31616910
1684,76,1793500,1,8,46,56,986,31616986
1685,244,1793700,1,8,46,57,230,31617230
1686,39,1793500,5,8,46,57,269,31617269
1688,53,1793300,2,8,46,57,322,31617322
1689,29,1793500,1,8,46,57,351,31617351
1690,132,1793500,2,8,46,57,483,31617483
1691,52,1793300,1,8,46,57,535,31617535
1692,25,1793200,1,8,46,57,560,31617560
1693,267,1793300,4,8,46,57,827,31617827
1695,1,1793300,1,8,46,57,828,31617828
1696,56,1793300,1,8,46,57,884,31617884
1697,31,1793500,2,8,46,57,915,31617915
1698,647,1793500,1,8,46,58,562,31618562
1699,166,1793600,1,8,46,58,728,31618728
1700,4,1793500,5,8,46,58,732,31618732
1701,1264,1793500,1,8,46,59,996,31619996
1702,219,1793500,1,8,47,0,215,31620215
1703,44,1793500,1,8,47,0,259,31620259
1704,27,1793500,1,8,47,0,286,31620286
1705,65,1793500,1,8,47,0,351,31620351
1706,164,1793600,1,8,47,0,515,31620515
1707,99,1793600,3,8,47,0,614,31620614
1708,9,1793600,1,8,47,0,623,31620623
1710,0,1793700,5,8,47,0,623,31620623
1711,90,1793600,1,8,47,0,713,31620713
1712,206,1793800,1,8,47,0,919,31620919
1713,77,1793600,3,8,47,0,996,31620996
1714,161,1793600,2,8,47,1,157,31621157
1715,270,1793500,2,8,47,1,427,31621427
1716,1,1793500,2,8,47,1,428,31621428
1717,53,1793500,2,8,47,1,481,31621481
1718,23,1793500,1,8,47,1,504,31621504
1719,1,1793400,1,8,47,1,505,31621505
1720,80,1793500,2,8,47,1,585,31621585
1721,1,1793500,1,8,47,1,586,31621586
1722,0,1793500,1,8,47,1,586,31621586
1723,140,1793500,4,8,47,1,726,31621726
1724,56,1793500,1,8,47,1,782,31621782
1726,17,1793300,2,8,47,1,799,31621799
1727,322,1793300,1,8,47,2,121,31622121
1728,6,1793300,1,8,47,2,127,31622127
1729,11,1793300,1,8,47,2,138,31622138
1730,143,1793300,3,8,47,2,281,31622281
1731,414,1793200,1,8,47,2,695,31622695
1732,0,1793200,1,8,47,2,695,31622695
1734,350,1793200,1,8,47,3,45,31623045
1735,10,1793200,1,8,47,3,55,31623055
1736,195,1793200,2,8,47,3,250,31623250
1737,121,1793300,1,8,47,3,371,31623371
1738,791,1793400,1,8,47,4,162,31624162
1739,809,1793400,1,8,47,4,971,31624971
1740,0,1793500,4,8,47,4,971,31624971
1741,8,1793300,1,8,47,4,979,31624979
1742,1152,1793400,1,8,47,6,131,31626131
1743,707,1793400,1,8,47,6,838,31626838
1744,112,1793400,1,8,47,6,950,31626950
1745,74,1793500,1,8,47,7,24,31627024
1746,508,1793400,2,8,47,7,532,31627532
1747,102,1793300,2,8,47,7,634,31627634
1748,11,1793300,1,8,47,7,645,31627645
1749,65,1793300,1,8,47,7,710,31627710
1750,91,1793400,1,8,47,7,801,31627801
1751,424,1793400,1,8,47,8,225,31628225
1752,162,1793400,1,8,47,8,387,31628387
1753,2078,1793500,1,8,47,10,465,31630465
1754,315,1793400,1,8,47,10,780,31630780
1755,446,1793500,1,8,47,11,226,31631226
1756,1449,1793500,1,8,47,12,675,31632675
1757,23,1793400,2,8,47,12,698,31632698
1758,1303,1793500,1,8,47,14,1,31634001
1759,456,1793500,1,8,47,14,457,31634457
1760,190,1793400,1,8,47,14,647,31634647
1761,579,1793500,1,8,47,15,226,31635226
1762,933,1793500,4,8,47,16,159,31636159
1763,0,1793500,2,8,47,16,159,31636159
1764,0,1793500,3,8,47,16,159,31636159
1765,0,1793500,5,8,47,16,159,31636159
1766,58,1793500,3,8,47,16,217,31636217
1767,203,1793500,1,8,47,16,420,31636420
1768,490,1793600,2,8,47,16,910,31636910
1769,1,1793600,2,8,47,16,911,31636911
1770,0,1793600,2,8,47,16,911,31636911
1771,0,1793600,5,8,47,16,911,31636911
1772,37,1793700,2,8,47,16,948,31636948
1773,47,1793700,1,8,47,16,995,31636995
1774,207,1793700,1,8,47,17,202,31637202
1775,433,1793800,1,8,47,17,635,31637635
1776,109,1793700,1,8,47,17,744,31637744
1777,4,1793800,1,8,47,17,748,31637748
1778,219,1793800,7,8,47,17,967,31637967
1779,0,1793800,7,8,47,17,967,31637967
1781,3,1794000,1,8,47,17,970,31637970
1782,0,1794000,5,8,47,17,970,31637970
1783,106,1794100,1,8,47,18,76,31638076
1784,37,1794100,1,8,47,18,113,31638113
1785,139,1794000,1,8,47,18,252,31638252
1786,73,1794000,2,8,47,18,325,31638325
1787,97,1794100,1,8,47,18,422,31638422
1788,230,1794100,2,8,47,18,652,31638652
1789,29,1794100,2,8,47,18,681,31638681
1790,1,1794100,1,8,47,18,682,31638682
1791,452,1794100,1,8,47,19,134,31639134
1793,566,1794100,1,8,47,19,700,31639700
1794,0,1794100,1,8,47,19,700,31639700
1796,210,1794100,1,8,47,19,910,31639910
1797,86,1794100,1,8,47,19,996,31639996
1798,167,1794200,1,8,47,20,163,31640163
1799,302,1794000,1,8,47,20,465,31640465
1800,108,1794000,3,8,47,20,573,31640573
1801,97,1794000,1,8,47,20,670,31640670
1802,77,1793900,1,8,47,20,747,31640747
1803,53,1793900,3,8,47,20,800,31640800
1804,73,1793900,1,8,47,20,873,31640873
1805,249,1793800,1,8,47,21,122,31641122
1806,66,1793900,2,8,47,21,188,31641188
1807,21,1794000,1,8,47,21,209,31641209
1808,38,1794000,1,8,47,21,247,31641247
1809,294,1794000,2,8,47,21,541,31641541
1810,116,1794000,1,8,47,21,657,31641657
1811,385,1794000,1,8,47,22,42,31642042
1812,308,1793800,1,8,47,22,350,31642350
1813,67,1793800,1,8,47,22,417,31642417
1814,161,1793900,1,8,47,22,578,31642578
1815,336,1793700,1,8,47,22,914,31642914
1816,257,1793800,1,8,47,23,171,31643171
1817,822,1793700,1,8,47,23,993,31643993
1818,204,1793700,1,8,47,24,197,31644197
1819,815,1793900,1,8,47,25,12,31645012
1820,0,1793900,1,8,47,25,12,31645012
1821,535,1794000,2,8,47,25,547,31645547
1823,240,1794200,4,8,47,25,787,31645787
1824,0,1794200,1,8,47,25,787,31645787
1825,0,1794200,7,8,47,25,787,31645787
1826,1,1794200,2,8,47,25,788,31645788
1827,1,1794300,6,8,47,25,789,31645789
1828,0,1794300,1,8,47,25,789,31645789
1829,145,1794300,1,8,47,25,934,31645934
1830,6,1794400,1,8,47,25,940,31645940
1831,217,1794300,3,8,47,26,157,31646157
1832,275,1794300,1,8,47,26,432,31646432
1833,183,1794300,1,8,47,26,615,31646615
1834,130,1794300,2,8,47,26,745,31646745
1835,125,1794300,2,8,47,26,870,31646870
1837,310,1794400,1,8,47,27,180,31647180
1838,311,1794300,1,8,47,27,491,31647491
1839,102,1794200,1,8,47,27,593,31647593
1840,99,1794200,1,8,47,27,692,31647692
1841,111,1794200,1,8,47,27,803,31647803
1842,1381,1794200,2,8,47,29,184,31649184
1843,1814,1794300,1,8,47,30,998,31650998
1844,32,1794200,1,8,47,31,30,31651030
1845,18,1794200,1,8,47,31,48,31651048
1846,559,1794300,1,8,47,31,607,31651607
1847,19,1794300,1,8,47,31,626,31651626
1848,1,1794400,2,8,47,31,627,31651627
1849,0,1794400,1,8,47,31,627,31651627
1850,275,1794300,9,8,47,31,902,31651902
1851,0,1794300,9,8,47,31,902,31651902
1853,2,1794100,3,8,47,31,904,31651904
1854,35,1794000,1,8,47,31,939,31651939
1855,138,1794100,1,8,47,32,77,31652077
1856,173,1794100,1,8,47,32,250,31652250
1857,352,1794000,1,8,47,32,602,31652602
1858,1,1794000,1,8,47,32,603,31652603
1859,105,1794000,5,8,47,32,708,31652708
1860,173,1794000,1,8,47,32,881,31652881
1861,460,1794000,1,8,47,33,341,31653341
1862,193,1794000,1,8,47,33,534,31653534
1863,110,1794000,2,8,47,33,644,31653644
1864,1,1794100,2,8,47,33,645,31653645
1865,331,1794100,1,8,47,33,976,31653976
1867,453,1794200,15,8,47,34,429,31654429
1869,136,1794200,1,8,47,34,565,31654565
1870,171,1794200,1,8,47,34,736,31654736
1871,316,1794200,1,8,47,35,52,31655052
1872,109,1794200,1,8,47,35,161,31655161
1873,529,1794300,1,8,47,35,690,31655690
1874,476,1794200,1,8,47,36,166,31656166
1875,63,1794300,1,8,47,36,229,31656229
1876,199,1794300,1,8,47,36,428,31656428
1877,223,1794300,1,8,47,36,651,31656651
1878,513,1794300,1,8,47,37,164,31657164
1879,62,1794300,1,8,47,37,226,31657226
1880,756,1794300,1,8,47,37,982,31657982
1881,183,1794300,1,8,47,38,165,31658165
1882,444,1794300,1,8,47,38,609,31658609
1883,970,1794300,1,8,47,39,579,31659579
1884,493,1794400,5,8,47,40,72,31660072
1886,43,1794300,1,8,47,40,115,31660115
1887,55,1794500,1,8,47,40,170,31660170
1888,0,1794500,1,8,47,40,170,31660170
1889,152,1794300,2,8,47,40,322,31660322
1890,0,1794500,1,8,47,40,322,31660322
1891,1,1794500,1,8,47,40,323,31660323
1892,402,1794300,1,8,47,40,725,31660725
1893,223,1794400,1,8,47,40,948,31660948
1894,16,1794400,1,8,47,40,964,31660964
1895,210,1794400,3,8,47,41,174,31661174
1896,1,1794400,6,8,47,41,175,31661175
1897,15,1794400,1,8,47,41,190,31661190
1898,1,1794400,1,8,47,41,191,31661191
1899,132,1794400,1,8,47,41,323,31661323
1900,543,1794500,1,8,47,41,866,31661866
1901,332,1794500,1,8,47,42,198,31662198
1902,328,1794400,3,8,47,42,526,31662526
1903,70,1794400,2,8,47,42,596,31662596
1904,120,1794500,1,8,47,42,716,31662716
1905,27,1794500,1,8,47,42,743,31662743
1906,549,1794400,1,8,47,43,292,31663292
1907,1,1794500,2,8,47,43,293,31663293
1908,11,1794300,1,8,47,43,304,31663304
1909,1117,1794600,2,8,47,44,421,31664421
1910,334,1794600,1,8,47,44,755,31664755
1911,128,1794400,1,8,47,44,883,31664883
1912,210,1794400,2,8,47,45,93,31665093
1913,141,1794500,2,8,47,45,234,31665234
1914,190,1794400,1,8,47,45,424,31665424
1915,163,1794300,2,8,47,45,587,31665587
1916,0,1794300,1,8,47,45,587,31665587
1917,0,1794300,7,8,47,45,587,31665587
1918,0,1794300,1,8,47,45,587,31665587
1919,0,1794300,1,8,47,45,587,31665587
1920,72,1794300,1,8,47,45,659,31665659
1921,4,1794200,1,8,47,45,663,31665663
1922,63,1794400,1,8,47,45,726,31665726
1923,59,1794400,1,8,47,45,785,31665785
1924,809,1794200,1,8,47,46,594,31666594
1925,663,1794200,1,8,47,47,257,31667257
1926,67,1794200,1,8,47,47,324,31667324
1927,163,1794200,2,8,47,47,487,31667487
1928,40,1794400,2,8,47,47,527,31667527
1929,1052,1794400,1,8,47,48,579,31668579
1930,1026,1794400,4,8,47,49,605,31669605
1932,1,1794500,3,8,47,49,606,31669606
1933,0,1794500,4,8,47,49,606,31669606
1934,496,1794300,2,8,47,50,102,31670102
1935,877,1794300,1,8,47,50,979,31670979
1936,397,1794400,1,8,47,51,376,31671376
1937,283,1794300,1,8,47,51,659,31671659
1938,996,1794300,3,8,47,52,655,31672655
1939,195,1794300,1,8,47,52,850,31672850
1940,0,1794300,1,8,47,52,850,31672850
1941,0,1794300,1,8,47,52,850,31672850
1943,4,1794000,3,8,47,52,854,31672854
1944,41,1793900,7,8,47,52,895,31672895
1945,563,1793900,2,8,47,53,458,31673458
1946,114,1794000,3,8,47,53,572,31673572
1947,469,1793800,1,8,47,54,41,31674041
1948,19,1793800,1,8,47,54,60,31674060
1949,99,1793800,1,8,47,54,159,31674159
1950,1061,1793800,1,8,47,55,220,31675220
1951,40,1793900,1,8,47,55,260,31675260
1952,543,1793900,1,8,47,55,803,31675803
1953,339,1794000,1,8,47,56,142,31676142
1954,109,1793900,1,8,47,56,251,31676251
1955,211,1793800,1,8,47,56,462,31676462
1956,835,1793800,1,8,47,57,297,31677297
1957,89,1793800,1,8,47,57,386,31677386
1958,278,1793900,1,8,47,57,664,31677664
1959,319,1793800,9,8,47,57,983,31677983
1960,10,1793800,1,8,47,57,993,31677993
1961,302,1793700,1,8,47,58,295,31678295
1962,685,1793800,1,8,47,58,980,31678980
1963,66,1793800,1,8,47,59,46,31679046
1965,53,1793800,5,8,47,59,99,31679099
1966,1,1793800,5,8,47,59,100,31679100
1967,211,1793800,1,8,47,59,311,31679311
1968,473,1794000,2,8,47,59,784,31679784
1969,296,1794000,3,8,48,0,80,31680080
1970,1,1794000,3,8,48,0,81,31680081
1971,0,1794000,2,8,48,0,81,31680081
1972,0,1794000,1,8,48,0,81,31680081
1973,91,1794200,1,8,48,0,172,31680172
1974,81,1794000,1,8,48,0,253,31680253
1975,77,1794000,3,8,48,0,330,31680330
1976,1,1794000,3,8,48,0,331,31680331
1977,0,1794100,1,8,48,0,331,31680331
1978,0,1794100,1,8,48,0,331,31680331
1979,63,1794200,1,8,48,0,394,31680394
1980,43,1794000,2,8,48,0,437,31680437
1981,76,1793900,1,8,48,0,513,31680513
1982,152,1793900,2,8,48,0,665,31680665
1984,47,1794000,2,8,48,0,712,31680712
1985,374,1794000,3,8,48,1,86,31681086
1987,109,1794000,3,8,48,1,195,31681195
1988,157,1793900,2,8,48,1,352,31681352
1989,104,1793900,1,8,48,1,456,31681456
1990,247,1793800,2,8,48,1,703,31681703
1991,128,1793800,1,8,48,1,831,31681831
1992,80,1793800,2,8,48,1,911,31681911
1993,20,1793800,1,8,48,1,931,31681931
1994,421,1793800,3,8,48,2,352,31682352
1995,340,1793700,4,8,48,2,692,31682692
1996,196,1793700,2,8,48,2,888,31682888
1997,573,1793700,2,8,48,3,461,31683461
1998,240,1793700,1,8,48,3,701,31683701
1999,289,1793700,1,8,48,3,990,31683990
2000,212,1793700,1,8,48,4,202,31684202
2001,755,1793700,1,8,48,4,957,31684957
2002,753,1793700,3,8,48,5,710,31685710
2003,35,1793700,2,8,48,5,745,31685745
2004,289,1793600,9,8,48,6,34,31686034
2005,221,1793600,1,8,48,6,255,31686255
2006,2,1793600,1,8,48,6,257,31686257
2007,323,1793500,4,8,48,6,580,31686580
2008,211,1793500,2,8,48,6,791,31686791
2009,225,1793500,2,8,48,7,16,31687016
2011,85,1793500,1,8,48,7,101,31687101
2012,1440,1793400,4,8,48,8,541,31688541
2014,467,1793400,1,8,48,9,8,31689008
2015,437,1793500,1,8,48,9,445,31689445
2016,693,1793500,1,8,48,10,138,31690138
2017,318,1793600,4,8,48,10,456,31690456
2018,621,1793600,1,8,48,11,77,31691077
2019,517,1793600,1,8,48,11,594,31691594
2020,2,1793600,1,8,48,11,596,31691596
2021,84,1793600,1,8,48,11,680,31691680
2022,52,1793700,1,8,48,11,732,31691732
2023,359,1793600,1,8,48,12,91,31692091
2024,1,1793600,5,8,48,12,92,31692092
2025,281,1793700,1,8,48,12,373,31692373
2026,876,1793600,4,8,48,13,249,31693249
2028,388,1793600,2,8,48,13,637,31693637
2029,550,1793600,1,8,48,14,187,31694187
2030,1236,1793600,1,8,48,15,423,31695423
2031,72,1793700,2,8,48,15,495,31695495
2032,157,1793600,1,8,48,15,652,31695652
2033,1270,1793600,1,8,48,16,922,31696922
2034,151,1793700,4,8,48,17,73,31697073
2035,1795,1793500,1,8,48,18,868,31698868
2036,439,1793500,1,8,48,19,307,31699307
2037,315,1793700,2,8,48,19,622,31699622
2038,351,1793600,2,8,48,19,973,31699973
2039,566,1793500,1,8,48,20,539,31700539
2040,175,1793500,1,8,48,20,714,31700714
2041,537,1793500,1,8,48,21,251,31701251
2042,215,1793500,1,8,48,21,466,31701466
2043,1088,1793700,1,8,48,22,554,31702554
2044,15,1793700,1,8,48,22,569,31702569
2045,0,1793700,2,8,48,22,569,31702569
2046,436,1793800,1,8,48,23,5,31703005
2047,104,1793800,1,8,48,23,109,31703109
2048,753,1793600,3,8,48,23,862,31703862
2050,3,1793500,1,8,48,23,865,31703865
2051,1,1793500,18,8,48,23,866,31703866
2052,0,1793500,3,8,48,23,866,31703866
2053,512,1793500,5,8,48,24,378,31704378
2054,139,1793400,2,8,48,24,517,31704517
2056,354,1793500,1,8,48,24,871,31704871
2057,416,1793500,1,8,48,25,287,31705287
2058,64,1793500,2,8,48,25,351,31705351
2059,1259,1793400,1,8,48,26,610,31706610
2060,147,1793400,1,8,48,26,757,31706757
2061,61,1793500,1,8,48,26,818,31706818
2062,686,1793400,1,8,48,27,504,31707504
2063,97,1793500,1,8,48,27,601,31707601
2064,206,1793300,1,8,48,27,807,31707807
2065,263,1793300,1,8,48,28,70,31708070
2066,757,1793500,1,8,48,28,827,31708827
2067,701,1793300,6,8,48,29,528,31709528
2069,892,1793400,6,8,48,30,420,31710420
2070,63,1793400,1,8,48,30,483,31710483
2071,95,1793300,1,8,48,30,578,31710578
2072,150,1793300,1,8,48,30,728,31710728
2073,108,1793300,1,8,48,30,836,31710836
2074,107,1793500,7,8,48,30,943,31710943
2075,0,1793500,7,8,48,30,943,31710943
2076,0,1793500,7,8,48,30,943,31710943
2077,0,1793500,7,8,48,30,943,31710943
2079,54,1793900,1,8,48,30,997,31710997
2080,33,1793800,1,8,48,31,30,31711030
2081,1966,1793600,1,8,48,32,996,31712996
2082,1804,1793700,1,8,48,34,800,31714800
2083,747,1793500,4,8,48,35,547,31715547
2084,2561,1793400,1,8,48,38,108,31718108
2085,1003,1793600,2,8,48,39,111,31719111
2086,569,1793500,1,8,48,39,680,31719680
2087,522,1793600,2,8,48,40,202,31720202
2088,2428,1793700,1,8,48,42,630,31722630
2089,1,1793700,5,8,48,42,631,31722631
2090,442,1793600,1,8,48,43,73,31723073
2091,2821,1793800,16,8,48,45,894,31725894
2093,589,1793800,1,8,48,46,483,31726483
2094,235,1793800,1,8,48,46,718,31726718
2095,2180,1793600,1,8,48,48,898,31728898
2096,78,1793800,1,8,48,48,976,31728976
2097,128,1793600,2,8,48,49,104,31729104
2098,27,1793600,2,8,48,49,131,31729131
2099,22,1793500,1,8,48,49,153,31729153
2100,1106,1793600,1,8,48,50,259,31730259
2101,2265,1793500,13,8,48,52,524,31732524
2102,0,1793500,1,8,48,52,524,31732524
2103,1,1793500,1,8,48,52,525,31732525
2104,2,1793400,1,8,48,52,527,31732527
2105,25,1793500,1,8,48,52,552,31732552
2106,1,1793500,1,8,48,52,553,31732553
2107,1708,1793400,1,8,48,54,261,31734261
2108,68,1793600,5,8,48,54,329,31734329
2110,1138,1793600,1,8,48,55,467,31735467
2111,0,1793700,9,8,48,55,467,31735467
2112,757,1793500,1,8,48,56,224,31736224
2113,3614,1793600,1,8,48,59,838,31739838
2114,1087,1793600,5,8,49,0,925,31740925
2115,197,1793700,2,8,49,1,122,31741122
2116,565,1793600,1,8,49,1,687,31741687
2117,1176,1793600,4,8,49,2,863,31742863
2118,428,1793600,1,8,49,3,291,31743291
2119,72,1793600,1,8,49,3,363,31743363
2120,806,1793700,4,8,49,4,169,31744169
2122,851,1793600,1,8,49,5,20,31745020
2123,1132,1793600,1,8,49,6,152,31746152
2124,308,1793600,1,8,49,6,460,31746460
2125,1872,1793700,6,8,49,8,332,31748332
2126,1,1793800,2,8,49,8,333,31748333
2127,20,1793800,4,8,49,8,353,31748353
2128,1,1793900,1,8,49,8,354,31748354
2129,0,1793900,7,8,49,8,354,31748354
2130,148,1794000,1,8,49,8,502,31748502
2131,2,1794000,1,8,49,8,504,31748504
2132,166,1793800,2,8,49,8,670,31748670
2133,16,1794000,1,8,49,8,686,31748686
2134,289,1793800,1,8,49,8,975,31748975
2135,74,1793800,1,8,49,9,49,31749049
2136,81,1794000,12,8,49,9,130,31749130
2137,3,1794100,1,8,49,9,133,31749133
2138,0,1794100,2,8,49,9,133,31749133
2139,167,1794100,1,8,49,9,300,31749300
2140,0,1794200,1,8,49,9,300,31749300
2141,289,1794100,6,8,49,9,589,31749589
2142,0,1794100,6,8,49,9,589,31749589
2143,0,1794100,6,8,49,9,589,31749589
2145,2,1793900,1,8,49,9,591,31749591
2146,1,1793900,1,8,49,9,592,31749592
2147,0,1793900,1,8,49,9,592,31749592
2148,1,1793900,1,8,49,9,593,31749593
2149,0,1793900,1,8,49,9,593,31749593
2150,38,1793800,1,8,49,9,631,31749631
2151,391,1793900,2,8,49,10,22,31750022
2152,584,1793900,4,8,49,10,606,31750606
2154,105,1793800,2,8,49,10,711,31750711
2155,0,1793900,2,8,49,10,711,31750711
2156,1518,1793800,1,8,49,12,229,31752229
2157,97,1793800,2,8,49,12,326,31752326
2158,595,1793900,1,8,49,12,921,31752921
2159,127,1793700,1,8,49,13,48,31753048
2160,1494,1793800,1,8,49,14,542,31754542
2161,164,1793700,1,8,49,14,706,31754706
2162,553,1793800,1,8,49,15,259,31755259
2163,993,1793800,1,8,49,16,252,31756252
2164,421,1793700,1,8,49,16,673,31756673
2165,1452,1793700,1,8,49,18,125,31758125
2166,163,1793800,2,8,49,18,288,31758288
2167,1115,1793800,1,8,49,19,403,31759403
2168,1306,1793700,1,8,49,20,709,31760709
2169,621,1793800,1,8,49,21,330,31761330
2170,621,1793800,1,8,49,21,951,31761951
2171,46,1793800,1,8,49,21,997,31761997
2172,0,1793800,3,8,49,21,997,31761997
2173,1,1793900,1,8,49,21,998,31761998
2174,2386,1793800,1,8,49,24,384,31764384
2175,1151,1793800,1,8,49,25,535,31765535
2176,835,1793800,1,8,49,26,370,31766370
2177,1739,1793800,4,8,49,28,109,31768109
2178,117,1793900,1,8,49,28,226,31768226
2179,274,1793900,3,8,49,28,500,31768500
2180,261,1793800,1,8,49,28,761,31768761
2181,1537,1793800,5,8,49,30,298,31770298
2182,765,1793800,1,8,49,31,63,31771063
2183,106,1793900,1,8,49,31,169,31771169
2184,1395,1793800,1,8,49,32,564,31772564
2185,33,1793900,4,8,49,32,597,31772597
2187,945,1794000,7,8,49,33,542,31773542
2188,0,1794000,7,8,49,33,542,31773542
2189,0,1794000,7,8,49,33,542,31773542
2191,256,1794200,2,8,49,33,798,31773798
2193,219,1794100,1,8,49,34,17,31774017
2194,160,1794300,1,8,49,34,177,31774177
2195,294,1794100,4,8,49,34,471,31774471
2196,413,1794000,3,8,49,34,884,31774884
2197,380,1794100,1,8,49,35,264,31775264
2198,680,1794200,3,8,49,35,944,31775944
2199,1440,1794300,5,8,49,37,384,31777384
2200,0,1794400,1,8,49,37,384,31777384
2201,1,1794400,6,8,49,37,385,31777385
2202,153,1794300,3,8,49,37,538,31777538
2204,126,1794300,1,8,49,37,664,31777664
2205,578,1794400,2,8,49,38,242,31778242
2206,496,1794400,1,8,49,38,738,31778738
2207,1,1794400,1,8,49,38,739,31778739
2208,309,1794500,2,8,49,39,48,31779048
2209,1116,1794400,1,8,49,40,164,31780164
2210,172,1794400,1,8,49,40,336,31780336
2211,88,1794400,2,8,49,40,424,31780424
2212,150,1794400,3,8,49,40,574,31780574
2213,335,1794500,2,8,49,40,909,31780909
2214,959,1794500,1,8,49,41,868,31781868
2215,0,1794500,1,8,49,41,868,31781868
2216,839,1794500,5,8,49,42,707,31782707
2217,225,1794500,1,8,49,42,932,31782932
2218,94,1794500,3,8,49,43,26,31783026
2219,0,1794500,1,8,49,43,26,31783026
2220,72,1794500,1,8,49,43,98,31783098
2221,93,1794500,1,8,49,43,191,31783191
2222,413,1794500,1,8,49,43,604,31783604
2223,97,1794500,1,8,49,43,701,31783701
2224,273,1794500,1,8,49,43,974,31783974
2225,162,1794500,1,8,49,44,136,31784136
2226,16,1794400,1,8,49,44,152,31784152
2227,220,1794500,1,8,49,44,372,31784372
2228,385,1794400,1,8,49,44,757,31784757
2229,183,1794400,1,8,49,44,940,31784940
2230,85,1794500,1,8,49,45,25,31785025
2231,247,1794400,3,8,49,45,272,31785272
2232,257,1794500,1,8,49,45,529,31785529
2233,379,1794400,1,8,49,45,908,31785908
2234,320,1794400,1,8,49,46,228,31786228
2235,158,1794500,1,8,49,46,386,31786386
2236,62,1794500,1,8,49,46,448,31786448
2237,221,1794400,5,8,49,46,669,31786669
2238,197,1794400,1,8,49,46,866,31786866
2239,286,1794400,1,8,49,47,152,31787152
2240,16,1794400,1,8,49,47,168,31787168
2241,2,1794400,2,8,49,47,170,31787170
2242,1601,1794400,1,8,49,48,771,31788771
2243,446,1794300,1,8,49,49,217,31789217
2244,288,1794300,3,8,49,49,505,31789505
2245,338,1794200,3,8,49,49,843,31789843
2246,87,1794400,6,8,49,49,930,31789930
2247,790,1794400,1,8,49,50,720,31790720
2248,442,1794500,2,8,49,51,162,31791162
2249,343,1794400,1,8,49,51,505,31791505
2250,1216,1794400,8,8,49,52,721,31792721
2251,2,1794300,4,8,49,52,723,31792723
2252,55,1794300,1,8,49,52,778,31792778
2253,34,1794300,2,8,49,52,812,31792812
2254,95,1794300,1,8,49,52,907,31792907
2255,437,1794400,1,8,49,53,344,31793344
2256,358,1794300,1,8,49,53,702,31793702
2257,67,1794400,4,8,49,53,769,31793769
2258,556,1794300,1,8,49,54,325,31794325
2259,425,1794400,49,8,49,54,750,31794750
2261,115,1794500,1,8,49,54,865,31794865
2262,0,1794500,1,8,49,54,865,31794865
2263,701,1794300,3,8,49,55,566,31795566
2264,778,1794500,1,8,49,56,344,31796344
2265,631,1794500,2,8,49,56,975,31796975
2266,479,1794400,1,8,49,57,454,31797454
2267,341,1794200,3,8,49,57,795,31797795
2268,878,1794400,1,8,49,58,673,31798673
2269,27,1794400,1,8,49,58,700,31798700
2270,227,1794400,1,8,49,58,927,31798927
2271,1,1794400,1,8,49,58,928,31798928
2272,60,1794500,1,8,49,58,988,31798988
2273,105,1794500,10,8,49,59,93,31799093
2274,774,1794400,2,8,49,59,867,31799867
2276,257,1794300,1,8,50,0,124,31800124
2277,67,1794500,2,8,50,0,191,31800191
2278,4,1794500,7,8,50,0,195,31800195
2279,9,1794600,4,8,50,0,204,31800204
2280,0,1794600,4,8,50,0,204,31800204
2281,16,1794600,4,8,50,0,220,31800220
2282,19,1794600,1,8,50,0,239,31800239
2283,27,1794600,2,8,50,0,266,31800266
2284,88,1794700,1,8,50,0,354,31800354
2285,44,1794700,2,8,50,0,398,31800398
2286,303,1794700,1,8,50,0,701,31800701
2287,229,1794500,1,8,50,0,930,31800930
2288,88,1794500,3,8,50,1,18,31801018
2289,83,1794700,1,8,50,1,101,31801101
2290,37,1794700,1,8,50,1,138,31801138
2291,174,1794500,2,8,50,1,312,31801312
2292,24,1794500,5,8,50,1,336,31801336
2294,69,1794400,1,8,50,1,405,31801405
2295,57,1794400,2,8,50,1,462,31801462
2296,12,1794400,2,8,50,1,474,31801474
2297,3,1794400,2,8,50,1,477,31801477
2298,131,1794400,10,8,50,1,608,31801608
2299,221,1794400,1,8,50,1,829,31801829
2300,453,1794400,1,8,50,2,282,31802282
2301,6,1794400,1,8,50,2,288,31802288
2302,302,1794400,1,8,50,2,590,31802590
2303,292,1794400,1,8,50,2,882,31802882
2304,78,1794400,1,8,50,2,960,31802960
2305,91,1794400,1,8,50,3,51,31803051
2306,216,1794400,5,8,50,3,267,31803267
2307,182,1794400,2,8,50,3,449,31803449
2308,1,1794300,3,8,50,3,450,31803450
2309,0,1794300,3,8,50,3,450,31803450
2310,1157,1794300,1,8,50,4,607,31804607
2311,4,1794300,1,8,50,4,611,31804611
2312,2,1794300,1,8,50,4,613,31804613
2313,192,1794400,10,8,50,4,805,31804805
2314,30,1794300,1,8,50,4,835,31804835
2315,67,1794400,1,8,50,4,902,31804902
2316,366,1794400,2,8,50,5,268,31805268
2318,73,1794400,1,8,50,5,341,31805341
2319,171,1794400,1,8,50,5,512,31805512
2320,392,1794500,1,8,50,5,904,31805904
2321,607,1794400,4,8,50,6,511,31806511
2323,246,1794500,8,8,50,6,757,31806757
2324,1,1794500,2,8,50,6,758,31806758
2325,419,1794600,1,8,50,7,177,31807177
2326,48,1794600,1,8,50,7,225,31807225
2327,0,1794600,1,8,50,7,225,31807225
2328,0,1794600,1,8,50,7,225,31807225
2329,1,1794600,1,8,50,7,226,31807226
2330,0,1794600,1,8,50,7,226,31807226
2331,1,1794600,1,8,50,7,227,31807227
2332,796,1794500,1,8,50,8,23,31808023
2333,1416,1794500,1,8,50,9,439,31809439
2334,415,1794500,1,8,50,9,854,31809854
2335,94,1794500,3,8,50,9,948,31809948
2337,35,1794600,1,8,50,9,983,31809983
2338,185,1794500,1,8,50,10,168,31810168
2339,204,1794400,1,8,50,10,372,31810372
2340,803,1794500,1,8,50,11,175,31811175
2341,121,1794600,1,8,50,11,296,31811296
2342,213,1794500,1,8,50,11,509,31811509
2343,634,1794400,3,8,50,12,143,31812143
2344,96,1794300,1,8,50,12,239,31812239
2345,452,1794300,1,8,50,12,691,31812691
2346,887,1794400,1,8,50,13,578,31813578
2347,208,1794400,1,8,50,13,786,31813786
2348,235,1794500,2,8,50,14,21,31814021
2349,153,1794500,1,8,50,14,174,31814174
2350,477,1794500,1,8,50,14,651,31814651
2351,306,1794400,1,8,50,14,957,31814957
2352,735,1794300,6,8,50,15,692,31815692
2353,670,1794300,1,8,50,16,362,31816362
2354,219,1794300,1,8,50,16,581,31816581
2355,193,1794300,1,8,50,16,774,31816774
2356,102,1794300,2,8,50,16,876,31816876
2357,889,1794200,1,8,50,17,765,31817765
2358,85,1794300,1,8,50,17,850,31817850
2359,0,1794400,1,8,50,17,850,31817850
2360,0,1794400,1,8,50,17,850,31817850
2361,0,1794400,1,8,50,17,850,31817850
2362,0,1794400,1,8,50,17,850,31817850
2363,0,1794400,1,8,50,17,850,31817850
2364,0,1794400,1,8,50,17,850,31817850
2365,1,1794400,1,8,50,17,851,31817851
2366,600,1794200,1,8,50,18,451,31818451
2367,501,1794200,1,8,50,18,952,31818952
2368,75,1794300,1,8,50,19,27,31819027
2370,637,1794200,1,8,50,19,664,31819664
2371,59,1794300,2,8,50,19,723,31819723
2372,2732,1794300,1,8,50,22,455,31822455
2373,440,1794300,3,8,50,22,895,31822895
2374,2066,1794300,1,8,50,24,961,31824961
2375,160,1794300,1,8,50,25,121,31825121
2376,1042,1794300,1,8,50,26,163,31826163
2377,1820,1794400,6,8,50,27,983,31827983
2378,117,1794500,1,8,50,28,100,31828100
2379,0,1794500,1,8,50,28,100,31828100
2380,0,1794500,1,8,50,28,100,31828100
2381,950,1794500,3,8,50,29,50,31829050
2382,74,1794500,3,8,50,29,124,31829124
2383,627,1794400,5,8,50,29,751,31829751
2384,876,1794400,1,8,50,30,627,31830627
2385,1505,1794400,1,8,50,32,132,31832132
2386,0,1794300,6,8,50,32,132,31832132
2387,1,1794200,7,8,50,32,133,31832133
2388,2,1794100,6,8,50,32,135,31832135
2389,1,1794100,5,8,50,32,136,31832136
2390,239,1794200,1,8,50,32,375,31832375
2391,1935,1794000,1,8,50,34,310,31834310
2392,752,1794000,5,8,50,35,62,31835062
2393,1,1794000,12,8,50,35,63,31835063
2394,569,1794000,1,8,50,35,632,31835632
2395,453,1794100,10,8,50,36,85,31836085
2396,400,1794100,1,8,50,36,485,31836485
2397,1514,1794200,1,8,50,37,999,31837999
2398,102,1794300,1,8,50,38,101,31838101
2399,0,1794300,1,8,50,38,101,31838101
2400,579,1794100,2,8,50,38,680,31838680
2401,301,1794300,1,8,50,38,981,31838981
2402,156,1794100,1,8,50,39,137,31839137
2403,1044,1794100,1,8,50,40,181,31840181
2404,1,1794100,1,8,50,40,182,31840182
2405,191,1794000,1,8,50,40,373,31840373
2406,232,1794000,4,8,50,40,605,31840605
2407,2365,1794200,1,8,50,42,970,31842970
2408,133,1794100,1,8,50,43,103,31843103
2409,554,1794200,4,8,50,43,657,31843657
2410,1,1794200,1,8,50,43,658,31843658
2411,990,1794200,1,8,50,44,648,31844648
2412,333,1794200,2,8,50,44,981,31844981
2413,445,1794200,1,8,50,45,426,31845426
2414,796,1794200,1,8,50,46,222,31846222
2415,3769,1794200,2,8,50,49,991,31849991
2416,421,1794200,3,8,50,50,412,31850412
2418,103,1794000,1,8,50,50,515,31850515
2419,283,1794200,4,8,50,50,798,31850798
2421,1674,1794000,1,8,50,52,472,31852472
2422,650,1794100,1,8,50,53,122,31853122
2423,1621,1794100,1,8,50,54,743,31854743
2424,54,1794100,1,8,50,54,797,31854797
2425,6,1794000,1,8,50,54,803,31854803
2426,115,1794000,1,8,50,54,918,31854918
2427,758,1794100,1,8,50,55,676,31855676
2428,467,1794000,2,8,50,56,143,31856143
2429,803,1794000,10,8,50,56,946,31856946
2430,1,1794000,6,8,50,56,947,31856947
2431,459,1793900,1,8,50,57,406,31857406
2432,1,1793900,1,8,50,57,407,31857407
2433,31,1793900,1,8,50,57,438,31857438
2434,208,1793900,2,8,50,57,646,31857646
2435,249,1794000,1,8,50,57,895,31857895
2436,1,1793900,7,8,50,57,896,31857896
2437,1546,1794000,1,8,50,59,442,31859442
2438,90,1793800,1,8,50,59,532,31859532
2439,9,1794000,8,8,50,59,541,31859541
2440,129,1793900,1,8,50,59,670,31859670
2442,349,1794000,1,8,51,0,19,31860019
2443,38,1794000,1,8,51,0,57,31860057
2444,185,1793800,1,8,51,0,242,31860242
2445,121,1793900,2,8,51,0,363,31860363
2446,30,1793900,2,8,51,0,393,31860393
2447,3,1793900,2,8,51,0,396,31860396
2448,36,1794000,2,8,51,0,432,31860432
2449,902,1793900,1,8,51,1,334,31861334
2450,1439,1793800,3,8,51,2,773,31862773
2451,621,1793800,4,8,51,3,394,31863394
2453,1175,1793700,1,8,51,4,569,31864569
2454,76,1793700,1,8,51,4,645,31864645
2455,168,1793700,1,8,51,4,813,31864813
2456,119,1793700,3,8,51,4,932,31864932
2457,2919,1793700,1,8,51,7,851,31867851
2458,911,1793800,6,8,51,8,762,31868762
2460,349,1793800,2,8,51,9,111,31869111
2461,704,1793900,2,8,51,9,815,31869815
2462,1037,1794000,3,8,51,10,852,31870852
2463,1957,1794000,1,8,51,12,809,31872809
2464,116,1794000,8,8,51,12,925,31872925
2465,75,1794000,1,8,51,13,0,31873000
2466,677,1793900,1,8,51,13,677,31873677
2467,45,1793800,1,8,51,13,722,31873722
2468,1872,1794000,4,8,51,15,594,31875594
2469,11,1794100,1,8,51,15,605,31875605
2470,0,1794100,6,8,51,15,605,31875605
2471,0,1794100,3,8,51,15,605,31875605
2472,116,1794100,1,8,51,15,721,31875721
2473,1805,1794000,1,8,51,17,526,31877526
2474,1188,1794100,1,8,51,18,714,31878714
2475,218,1794200,1,8,51,18,932,31878932
2476,1494,1794200,1,8,51,20,426,31880426
2477,1320,1794000,2,8,51,21,746,31881746
2478,1063,1794000,5,8,51,22,809,31882809
2479,68,1794000,1,8,51,22,877,31882877
2480,330,1793900,2,8,51,23,207,31883207
2481,2130,1794000,8,8,51,25,337,31885337
2483,1534,1793900,1,8,51,26,871,31886871
2484,546,1794100,6,8,51,27,417,31887417
2485,1089,1794200,6,8,51,28,506,31888506
2486,637,1794300,13,8,51,29,143,31889143
2487,0,1794300,13,8,51,29,143,31889143
2489,4,1794500,2,8,51,29,147,31889147
2490,0,1794500,3,8,51,29,147,31889147
2491,190,1794500,46,8,51,29,337,31889337
2492,0,1794500,46,8,51,29,337,31889337
2493,0,1794500,46,8,51,29,337,31889337
2495,0,1794500,1,8,51,29,337,31889337
2496,7,1794100,1,8,51,29,344,31889344
2497,241,1794200,1,8,51,29,585,31889585
2498,353,1794200,1,8,51,29,938,31889938
2499,363,1794200,1,8,51,30,301,31890301
2500,915,1794200,1,8,51,31,216,31891216
2501,109,1794200,1,8,51,31,325,31891325
2502,75,1794300,1,8,51,31,400,31891400
2503,710,1794200,1,8,51,32,110,31892110
2504,2505,1794100,1,8,51,34,615,31894615
2505,425,1794100,2,8,51,35,40,31895040
2506,206,1794100,1,8,51,35,246,31895246
2507,376,1794200,5,8,51,35,622,31895622
2508,1556,1794300,3,8,51,37,178,31897178
2509,364,1794300,3,8,51,37,542,31897542
2510,3696,1794100,2,8,51,41,238,31901238
2512,2,1794000,1,8,51,41,240,31901240
2513,1,1793900,9,8,51,41,241,31901241
2514,1,1793900,5,8,51,41,242,31901242
2515,162,1793800,1,8,51,41,404,31901404
2516,462,1793900,2,8,51,41,866,31901866
2517,119,1793900,3,8,51,41,985,31901985
2518,1902,1793800,1,8,51,43,887,31903887
2519,132,1793800,2,8,51,44,19,31904019
2520,0,1793800,10,8,51,44,19,31904019
2521,76,1793800,1,8,51,44,95,31904095
2522,560,1793700,3,8,51,44,655,31904655
2523,1,1793700,2,8,51,44,656,31904656
2524,54,1793800,1,8,51,44,710,31904710
2525,296,1793700,1,8,51,45,6,31905006
2526,0,1793700,6,8,51,45,6,31905006
2527,172,1793600,1,8,51,45,178,31905178
2528,67,1793600,1,8,51,45,245,31905245
2529,216,1793600,4,8,51,45,461,31905461
2530,634,1793600,2,8,51,46,95,31906095
2531,228,1793600,1,8,51,46,323,31906323
2532,469,1793700,2,8,51,46,792,31906792
2533,3932,1793600,1,8,51,50,724,31910724
2534,410,1793600,1,8,51,51,134,31911134
2535,1267,1793500,1,8,51,52,401,31912401
2536,188,1793500,1,8,51,52,589,31912589
2537,270,1793600,1,8,51,52,859,31912859
2538,398,1793600,3,8,51,53,257,31913257
2539,97,1793600,1,8,51,53,354,31913354
2540,111,1793600,1,8,51,53,465,31913465
2541,329,1793600,3,8,51,53,794,31913794
2542,479,1793700,1,8,51,54,273,31914273
2543,1258,1793600,1,8,51,55,531,31915531
2544,229,1793500,1,8,51,55,760,31915760
2545,317,1793600,3,8,51,56,77,31916077
2546,785,1793600,2,8,51,56,862,31916862
2548,467,1793500,1,8,51,57,329,31917329
2549,1123,1793600,2,8,51,58,452,31918452
2550,4247,1793600,1,8,52,2,699,31922699
2551,350,1793600,2,8,52,3,49,31923049
2552,216,1793600,2,8,52,3,265,31923265
2553,1169,1793500,9,8,52,4,434,31924434
2554,0,1793400,5,8,52,4,434,31924434
2555,8,1793300,5,8,52,4,442,31924442
2556,62,1793200,1,8,52,4,504,31924504
2557,101,1793200,5,8,52,4,605,31924605
2558,0,1793200,7,8,52,4,605,31924605
2559,1,1793200,5,8,52,4,606,31924606
2560,122,1793100,1,8,52,4,728,31924728
2561,0,1793100,1,8,52,4,728,31924728
2562,1,1793100,1,8,52,4,729,31924729
2563,65,1793300,1,8,52,4,794,31924794
2564,5,1793300,1,8,52,4,799,31924799
2565,17,1793100,1,8,52,4,816,31924816
2566,26,1793100,1,8,52,4,842,31924842
2567,27,1793100,8,8,52,4,869,31924869
2568,1,1793100,3,8,52,4,870,31924870
2569,0,1793100,2,8,52,4,870,31924870
2570,2,1793000,3,8,52,4,872,31924872
2571,4,1793000,1,8,52,4,876,31924876
2572,58,1793000,1,8,52,4,934,31924934
2573,2,1793000,1,8,52,4,936,31924936
2574,14,1793000,1,8,52,4,950,31924950
2575,135,1793000,1,8,52,5,85,31925085
2576,388,1793000,3,8,52,5,473,31925473
2577,1,1793000,5,8,52,5,474,31925474
2578,1313,1793000,1,8,52,6,787,31926787
2579,304,1793000,13,8,52,7,91,31927091
2580,212,1793000,1,8,52,7,303,31927303
2581,123,1793000,1,8,52,7,426,31927426
2582,25,1793000,1,8,52,7,451,31927451
2583,209,1793100,1,8,52,7,660,31927660
2584,69,1793100,1,8,52,7,729,31927729
2585,152,1793000,1,8,52,7,881,31927881
2586,175,1793100,3,8,52,8,56,31928056
2587,1079,1793100,1,8,52,9,135,31929135
2588,6,1793100,2,8,52,9,141,31929141
2590,125,1793200,1,8,52,9,266,31929266
2591,96,1793100,1,8,52,9,362,31929362
2592,927,1793100,5,8,52,10,289,31930289
2593,31,1793100,5,8,52,10,320,31930320
2594,182,1793000,1,8,52,10,502,31930502
2595,593,1793000,1,8,52,11,95,31931095
2596,1,1793000,4,8,52,11,96,31931096
2597,766,1792900,1,8,52,11,862,31931862
2598,245,1793000,1,8,52,12,107,31932107
2599,61,1793100,1,8,52,12,168,31932168
2600,94,1793000,1,8,52,12,262,31932262
2601,1220,1793000,1,8,52,13,482,31933482
2602,542,1793100,6,8,52,14,24,31934024
2603,1,1793200,2,8,52,14,25,31934025
2604,115,1793300,1,8,52,14,140,31934140
2605,178,1793400,1,8,52,14,318,31934318
2606,1218,1793300,1,8,52,15,536,31935536
2607,77,1793400,1,8,52,15,613,31935613
2608,650,1793400,1,8,52,16,263,31936263
2609,228,1793300,1,8,52,16,491,31936491
2610,972,1793300,1,8,52,17,463,31937463
2611,242,1793300,1,8,52,17,705,31937705
2612,1866,1793400,1,8,52,19,571,31939571
2613,2161,1793400,1,8,52,21,732,31941732
2614,831,1793500,3,8,52,22,563,31942563
2615,1,1793400,1,8,52,22,564,31942564
2616,133,1793400,1,8,52,22,697,31942697
2617,766,1793300,1,8,52,23,463,31943463
2618,5,1793300,1,8,52,23,468,31943468
2619,58,1793400,1,8,52,23,526,31943526
2621,165,1793400,1,8,52,23,691,31943691
2622,46,1793200,1,8,52,23,737,31943737
2623,264,1793400,1,8,52,24,1,31944001
2624,245,1793300,1,8,52,24,246,31944246
2625,216,1793300,1,8,52,24,462,31944462
2626,583,1793200,1,8,52,25,45,31945045
2627,167,1793200,1,8,52,25,212,31945212
2628,2072,1793300,1,8,52,27,284,31947284
2629,555,1793200,1,8,52,27,839,31947839
2630,150,1793400,1,8,52,27,989,31947989
2631,156,1793300,1,8,52,28,145,31948145
2632,894,1793300,1,8,52,29,39,31949039
2633,70,1793400,1,8,52,29,109,31949109
2634,402,1793200,1,8,52,29,511,31949511
2635,115,1793400,1,8,52,29,626,31949626
2636,1473,1793300,1,8,52,31,99,31951099
2637,190,1793300,1,8,52,31,289,31951289
2638,96,1793300,2,8,52,31,385,31951385
2639,258,1793400,1,8,52,31,643,31951643
2640,1022,1793200,1,8,52,32,665,31952665
2641,91,1793400,1,8,52,32,756,31952756
2642,1195,1793300,1,8,52,33,951,31953951
2643,1814,1793300,1,8,52,35,765,31955765
2644,2277,1793300,1,8,52,38,42,31958042
2645,103,1793200,1,8,52,38,145,31958145
2646,3019,1793200,1,8,52,41,164,31961164
2647,2079,1793300,1,8,52,43,243,31963243
2648,460,1793400,3,8,52,43,703,31963703
2650,2,1793500,2,8,52,43,705,31963705
2651,0,1793500,2,8,52,43,705,31963705
2652,0,1793500,2,8,52,43,705,31963705
2653,3,1793600,4,8,52,43,708,31963708
2654,45,1793700,1,8,52,43,753,31963753
2655,90,1793600,1,8,52,43,843,31963843
2656,63,1793500,1,8,52,43,906,31963906
2657,33,1793700,2,8,52,43,939,31963939
2658,73,1793700,1,8,52,44,12,31964012
2659,176,1793700,1,8,52,44,188,31964188
2660,132,1793700,1,8,52,44,320,31964320
2662,1646,1793600,1,8,52,45,966,31965966
2663,4296,1793800,1,8,52,50,262,31970262
2664,304,1793700,1,8,52,50,566,31970566
2665,12,1793600,1,8,52,50,578,31970578
2666,715,1793800,1,8,52,51,293,31971293
2667,1197,1793700,1,8,52,52,490,31972490
2668,1230,1793600,1,8,52,53,720,31973720
2669,233,1793600,1,8,52,53,953,31973953
2670,77,1793700,1,8,52,54,30,31974030
2671,612,1793800,2,8,52,54,642,31974642
2672,768,1793800,1,8,52,55,410,31975410
2673,861,1793800,6,8,52,56,271,31976271
2674,3922,1793800,1,8,53,0,193,31980193
2675,685,1793700,3,8,53,0,878,31980878
2676,13,1793800,7,8,53,0,891,31980891
2677,274,1793800,1,8,53,1,165,31981165
2678,303,1793800,1,8,53,1,468,31981468
2679,868,1793800,3,8,53,2,336,31982336
2680,499,1793800,1,8,53,2,835,31982835
2681,3,1793900,1,8,53,2,838,31982838
2682,354,1793800,1,8,53,3,192,31983192
2683,5094,1793700,1,8,53,8,286,31988286
2684,1013,1793600,1,8,53,9,299,31989299
2685,353,1793600,1,8,53,9,652,31989652
2686,205,1793500,1,8,53,9,857,31989857
2687,1441,1793500,4,8,53,11,298,31991298
2688,1,1793500,1,8,53,11,299,31991299
2689,0,1793500,1,8,53,11,299,31991299
2690,0,1793500,1,8,53,11,299,31991299
2691,0,1793500,2,8,53,11,299,31991299
2692,0,1793500,20,8,53,11,299,31991299
2693,5,1793400,2,8,53,11,304,31991304
2694,163,1793400,1,8,53,11,467,31991467
2695,328,1793400,1,8,53,11,795,31991795
2696,1251,1793300,1,8,53,13,46,31993046
2697,2006,1793400,1,8,53,15,52,31995052
2698,240,1793300,1,8,53,15,292,31995292
2699,234,1793300,1,8,53,15,526,31995526
2700,1060,1793400,9,8,53,16,586,31996586
2701,128,1793500,6,8,53,16,714,31996714
2702,200,1793400,2,8,53,16,914,31996914
2703,534,1793600,1,8,53,17,448,31997448
2704,285,1793500,1,8,53,17,733,31997733
2705,0,1793500,1,8,53,17,733,31997733
2706,1348,1793600,1,8,53,19,81,31999081
2707,495,1793500,1,8,53,19,576,31999576
2708,1168,1793600,2,8,53,20,744,32000744
2709,213,1793700,2,8,53,20,957,32000957
2710,204,1793700,1,8,53,21,161,32001161
2711,0,1793700,1,8,53,21,161,32001161
2712,1,1793800,3,8,53,21,162,32001162
2713,285,1793800,1,8,53,21,447,32001447
2715,1227,1793900,1,8,53,22,674,32002674
2716,155,1793800,1,8,53,22,829,32002829
2717,283,1793800,1,8,53,23,112,32003112
2718,210,1793800,1,8,53,23,322,32003322
2719,1202,1793800,1,8,53,24,524,32004524
2720,1482,1793800,1,8,53,26,6,32006006
2721,837,1793800,1,8,53,26,843,32006843
2722,130,1793900,3,8,53,26,973,32006973
2723,169,1793900,1,8,53,27,142,32007142
2724,2495,1794000,1,8,53,29,637,32009637
2725,1550,1794000,1,8,53,31,187,32011187
2726,2969,1793900,1,8,53,34,156,32014156
2727,42,1793900,2,8,53,34,198,32014198
2728,1192,1793900,4,8,53,35,390,32015390
2729,2876,1793900,1,8,53,38,266,32018266
2730,1230,1793900,1,8,53,39,496,32019496
2731,1963,1793800,1,8,53,41,459,32021459
2732,822,1793800,2,8,53,42,281,32022281
2734,505,1793800,1,8,53,42,786,32022786
2735,3755,1793900,2,8,53,46,541,32026541
2736,415,1793800,1,8,53,46,956,32026956
2737,2424,1793700,9,8,53,49,380,32029380
2739,1,1793600,1,8,53,49,381,32029381
2740,1,1793700,1,8,53,49,382,32029382
2741,1,1793700,1,8,53,49,383,32029383
2742,413,1793700,1,8,53,49,796,32029796
2743,233,1793800,1,8,53,50,29,32030029
2744,1804,1793700,1,8,53,51,833,32031833
2745,1,1793600,1,8,53,51,834,32031834
2746,2214,1793600,1,8,53,54,48,32034048
2747,5083,1793700,1,8,53,59,131,32039131
2748,1,1793600,2,8,53,59,132,32039132
2749,2962,1793600,1,8,54,2,94,32042094
2750,184,1793700,1,8,54,2,278,32042278
2751,0,1793700,1,8,54,2,278,32042278
2752,1,1793700,7,8,54,2,279,32042279
2753,34,1793800,5,8,54,2,313,32042313
2754,354,1793800,1,8,54,2,667,32042667
2755,1788,1793800,7,8,54,4,455,32044455
2756,1,1793800,1,8,54,4,456,32044456
2757,277,1793800,1,8,54,4,733,32044733
2758,1,1793800,1,8,54,4,734,32044734
2759,0,1793700,2,8,54,4,734,32044734
2760,0,1793700,1,8,54,4,734,32044734
2761,321,1793800,1,8,54,5,55,32045055
2762,125,1793700,1,8,54,5,180,32045180
2763,237,1793700,4,8,54,5,417,32045417
2764,107,1793900,1,8,54,5,524,32045524
2765,381,1793800,1,8,54,5,905,32045905
2766,1366,1793800,2,8,54,7,271,32047271
2768,2,1793900,1,8,54,7,273,32047273
2769,2032,1793900,10,8,54,9,305,32049305
2770,3430,1793900,1,8,54,12,735,32052735
2771,1027,1794000,18,8,54,13,762,32053762
2772,2,1794100,10,8,54,13,764,32053764
2773,1,1794100,1,8,54,13,765,32053765
2774,0,1794100,1,8,54,13,765,32053765
2775,1,1794100,2,8,54,13,766,32053766
2776,1015,1794000,1,8,54,14,781,32054781
2777,1135,1794200,1,8,54,15,916,32055916
2778,179,1794000,1,8,54,16,95,32056095
2779,622,1794100,1,8,54,16,717,32056717
2780,818,1794000,1,8,54,17,535,32057535
2781,88,1794100,1,8,54,17,623,32057623
2782,213,1794200,1,8,54,17,836,32057836
2783,1212,1794100,1,8,54,19,48,32059048
2784,188,1794200,1,8,54,19,236,32059236
2785,1438,1794100,2,8,54,20,674,32060674
2786,132,1794100,1,8,54,20,806,32060806
2787,380,1794100,1,8,54,21,186,32061186
2788,0,1794100,1,8,54,21,186,32061186
2789,40,1794200,1,8,54,21,226,32061226
2790,326,1794200,1,8,54,21,552,32061552
2791,812,1794100,1,8,54,22,364,32062364
2792,377,1794100,3,8,54,22,741,32062741
2793,2232,1794100,1,8,54,24,973,32064973
2794,1612,1794100,1,8,54,26,585,32066585
2795,4256,1794100,4,8,54,30,841,32070841
2796,78,1794100,1,8,54,30,919,32070919
2797,110,1794100,2,8,54,31,29,32071029
2798,234,1794000,1,8,54,31,263,32071263
2799,0,1794000,2,8,54,31,263,32071263
2800,1,1794000,5,8,54,31,264,32071264
2801,0,1794000,7,8,54,31,264,32071264
2802,140,1793900,9,8,54,31,404,32071404
2803,238,1793800,1,8,54,31,642,32071642
2804,85,1793800,1,8,54,31,727,32071727
2805,967,1793700,1,8,54,32,694,32072694
2806,526,1793700,1,8,54,33,220,32073220
2807,213,1793700,3,8,54,33,433,32073433
2808,0,1793700,10,8,54,33,433,32073433
2809,211,1793700,1,8,54,33,644,32073644
2810,1,1793600,1,8,54,33,645,32073645
2811,619,1793600,1,8,54,34,264,32074264
2812,1005,1793600,1,8,54,35,269,32075269
2813,87,1793500,4,8,54,35,356,32075356
2814,218,1793500,5,8,54,35,574,32075574
2815,17,1793600,5,8,54,35,591,32075591
2816,5,1793600,4,8,54,35,596,32075596
2818,62,1793600,1,8,54,35,658,32075658
2819,135,1793600,3,8,54,35,793,32075793
2820,151,1793600,2,8,54,35,944,32075944
2821,821,1793600,1,8,54,36,765,32076765
2823,2,1793800,2,8,54,36,767,32076767
2824,0,1793800,1,8,54,36,767,32076767
2825,0,1793800,1,8,54,36,767,32076767
2826,359,1793800,1,8,54,37,126,32077126
2827,570,1793900,1,8,54,37,696,32077696
2829,1975,1794000,1,8,54,39,671,32079671
2830,370,1794000,3,8,54,40,41,32080041
2831,3190,1794000,1,8,54,43,231,32083231
2832,47,1794100,1,8,54,43,278,32083278
2833,1,1794100,2,8,54,43,279,32083279
2834,1156,1794100,1,8,54,44,435,32084435
2835,741,1794200,5,8,54,45,176,32085176
2836,1,1794200,7,8,54,45,177,32085177
2837,666,1794200,1,8,54,45,843,32085843
2838,107,1794300,5,8,54,45,950,32085950
2839,0,1794300,5,8,54,45,950,32085950
2840,0,1794300,1,8,54,45,950,32085950
2841,0,1794300,6,8,54,45,950,32085950
2842,0,1794300,11,8,54,45,950,32085950
2843,0,1794300,1,8,54,45,950,32085950
2844,0,1794300,8,8,54,45,950,32085950
2845,251,1794300,1,8,54,46,201,32086201
2846,1336,1794400,1,8,54,47,537,32087537
2847,493,1794400,1,8,54,48,30,32088030
2848,317,1794400,1,8,54,48,347,32088347
2849,477,1794400,1,8,54,48,824,32088824
2850,97,1794400,1,8,54,48,921,32088921
2851,617,1794400,7,8,54,49,538,32089538
2852,1857,1794400,1,8,54,51,395,32091395
2853,467,1794400,1,8,54,51,862,32091862
2854,410,1794500,1,8,54,52,272,32092272
2855,0,1794500,1,8,54,52,272,32092272
2856,0,1794500,1,8,54,52,272,32092272
2857,0,1794500,16,8,54,52,272,32092272
2858,0,1794500,1,8,54,52,272,32092272
2859,1,1794500,1,8,54,52,273,32092273
2860,0,1794500,1,8,54,52,273,32092273
2861,198,1794400,1,8,54,52,471,32092471
2862,149,1794600,1,8,54,52,620,32092620
2863,2,1794600,1,8,54,52,622,32092622
2864,194,1794400,1,8,54,52,816,32092816
2865,3,1794400,1,8,54,52,819,32092819
2866,1238,1794600,5,8,54,54,57,32094057
2867,76,1794600,6,8,54,54,133,32094133
2868,63,1794500,1,8,54,54,196,32094196
2869,368,1794600,1,8,54,54,564,32094564
2870,530,1794600,1,8,54,55,94,32095094
2871,79,1794700,1,8,54,55,173,32095173
2872,55,1794700,1,8,54,55,228,32095228
2873,0,1794700,1,8,54,55,228,32095228
2874,1,1794700,2,8,54,55,229,32095229
2875,190,1794600,1,8,54,55,419,32095419
2876,59,1794700,7,8,54,55,478,32095478
2877,255,1794600,1,8,54,55,733,32095733
2878,12,1794600,2,8,54,55,745,32095745
2879,433,1794700,2,8,54,56,178,32096178
2880,191,1794700,1,8,54,56,369,32096369
2881,119,1794600,1,8,54,56,488,32096488
2882,75,1794600,1,8,54,56,563,32096563
2883,161,1794600,6,8,54,56,724,32096724
2884,679,1794600,1,8,54,57,403,32097403
2885,0,1794500,5,8,54,57,403,32097403
2886,1,1794500,4,8,54,57,404,32097404
2887,0,1794500,1,8,54,57,404,32097404
2888,1,1794500,2,8,54,57,405,32097405
2889,137,1794500,1,8,54,57,542,32097542
2890,576,1794500,1,8,54,58,118,32098118
2891,93,1794500,2,8,54,58,211,32098211
2892,135,1794500,1,8,54,58,346,32098346
2893,207,1794400,1,8,54,58,553,32098553
2894,537,1794400,1,8,54,59,90,32099090
2895,175,1794500,4,8,54,59,265,32099265
2897,372,1794400,1,8,54,59,637,32099637
2898,142,1794600,1,8,54,59,779,32099779
2899,3,1794400,1,8,54,59,782,32099782
2900,242,1794600,1,8,55,0,24,32100024
2901,79,1794600,1,8,55,0,103,32100103
2902,0,1794600,1,8,55,0,103,32100103
2903,138,1794600,1,8,55,0,241,32100241
2904,20,1794600,1,8,55,0,261,32100261
2905,4,1794600,2,8,55,0,265,32100265
2906,1,1794600,4,8,55,0,266,32100266
2907,8,1794700,5,8,55,0,274,32100274
2908,7,1794500,1,8,55,0,281,32100281
2909,35,1794700,1,8,55,0,316,32100316
2910,7,1794500,1,8,55,0,323,32100323
2911,5,1794700,1,8,55,0,328,32100328
2912,123,1794700,1,8,55,0,451,32100451
2913,38,1794700,1,8,55,0,489,32100489
2914,28,1794700,1,8,55,0,517,32100517
2915,58,1794500,2,8,55,0,575,32100575
2916,23,1794700,3,8,55,0,598,32100598
2917,60,1794500,2,8,55,0,658,32100658
2918,55,1794600,1,8,55,0,713,32100713
2919,262,1794600,1,8,55,0,975,32100975
2920,39,1794700,1,8,55,1,14,32101014
2921,225,1794700,1,8,55,1,239,32101239
2922,550,1794600,1,8,55,1,789,32101789
2923,1485,1794600,1,8,55,3,274,32103274
2924,397,1794600,1,8,55,3,671,32103671
2925,490,1794600,3,8,55,4,161,32104161
2926,1,1794600,1,8,55,4,162,32104162
2927,419,1794500,2,8,55,4,581,32104581
2928,2,1794500,1,8,55,4,583,32104583
2929,91,1794600,2,8,55,4,674,32104674
2930,1,1794500,2,8,55,4,675,32104675
2931,0,1794500,1,8,55,4,675,32104675
2932,32,1794400,1,8,55,4,707,32104707
2933,491,1794500,6,8,55,5,198,32105198
2934,1,1794500,4,8,55,5,199,32105199
2935,139,1794300,4,8,55,5,338,32105338
2937,1434,1794200,2,8,55,6,772,32106772
2938,848,1794200,2,8,55,7,620,32107620
2939,37,1794200,1,8,55,7,657,32107657
2940,69,1794300,1,8,55,7,726,32107726
2941,360,1794200,1,8,55,8,86,32108086
2942,1371,1794100,5,8,55,9,457,32109457
2943,2,1794000,15,8,55,9,459,32109459
2944,1,1794000,12,8,55,9,460,32109460
2945,0,1794000,5,8,55,9,460,32109460
2946,1,1793900,3,8,55,9,461,32109461
2947,329,1793800,2,8,55,9,790,32109790
2948,52,1793800,1,8,55,9,842,32109842
2949,565,1793800,2,8,55,10,407,32110407
2950,263,1793900,1,8,55,10,670,32110670
2951,709,1793700,2,8,55,11,379,32111379
2952,3,1793800,1,8,55,11,382,32111382
2953,17,1793800,1,8,55,11,399,32111399
2954,892,1793700,1,8,55,12,291,32112291
2955,940,1793700,1,8,55,13,231,32113231
2956,542,1793700,2,8,55,13,773,32113773
2957,51,1793600,1,8,55,13,824,32113824
2958,425,1793700,1,8,55,14,249,32114249
2959,64,1793600,1,8,55,14,313,32114313
2960,308,1793700,1,8,55,14,621,32114621
2961,194,1793700,5,8,55,14,815,32114815
2962,157,1793800,1,8,55,14,972,32114972
2963,0,1793800,1,8,55,14,972,32114972
2964,0,1793800,1,8,55,14,972,32114972
2965,126,1793900,1,8,55,15,98,32115098
2966,334,1793800,5,8,55,15,432,32115432
2968,2,1794000,5,8,55,15,434,32115434
2969,2529,1794100,4,8,55,17,963,32117963
2970,1073,1794200,1,8,55,19,36,32119036
2971,2927,1794200,2,8,55,21,963,32121963
2972,488,1794300,1,8,55,22,451,32122451
2973,486,1794300,3,8,55,22,937,32122937
2974,1685,1794300,1,8,55,24,622,32124622
2975,2176,1794200,2,8,55,26,798,32126798
2976,213,1794200,1,8,55,27,11,32127011
2977,89,1794300,1,8,55,27,100,32127100
2978,496,1794300,1,8,55,27,596,32127596
2979,3765,1794200,1,8,55,31,361,32131361
2980,355,1794200,1,8,55,31,716,32131716
2981,589,1794200,1,8,55,32,305,32132305
2982,6898,1794200,1,8,55,39,203,32139203
2983,1,1794100,3,8,55,39,204,32139204
2984,0,1794100,4,8,55,39,204,32139204
2985,1041,1794200,7,8,55,40,245,32140245
2987,106,1794300,1,8,55,40,351,32140351
2988,2983,1794300,1,8,55,43,334,32143334
2989,612,1794200,1,8,55,43,946,32143946
2990,63,1794200,2,8,55,44,9,32144009
2991,289,1794100,1,8,55,44,298,32144298
2992,431,1794300,8,8,55,44,729,32144729
2993,1,1794300,1,8,55,44,730,32144730
2994,1,1794200,1,8,55,44,731,32144731
2995,456,1794100,1,8,55,45,187,32145187
2996,1134,1794200,2,8,55,46,321,32146321
2997,1194,1794200,1,8,55,47,515,32147515
2998,2301,1794200,1,8,55,49,816,32149816
3000,1,1794300,2,8,55,49,817,32149817
3001,20,1794100,2,8,55,49,837,32149837
3002,548,1794100,1,8,55,50,385,32150385
3003,4388,1794100,1,8,55,54,773,32154773
3004,3052,1794000,1,8,55,57,825,32157825
3005,310,1794100,1,8,55,58,135,32158135
3006,1282,1794200,9,8,55,59,417,32159417
3007,869,1794100,1,8,56,0,286,32160286
3008,65,1794100,2,8,56,0,351,32160351
3009,1,1794100,1,8,56,0,352,32160352
3010,257,1794100,2,8,56,0,609,32160609
3011,185,1794200,2,8,56,0,794,32160794
3012,594,1794200,1,8,56,1,388,32161388
3013,87,1794300,1,8,56,1,475,32161475
3014,0,1794300,1,8,56,1,475,32161475
3015,0,1794300,1,8,56,1,475,32161475
3016,0,1794300,1,8,56,1,475,32161475
3017,1,1794300,1,8,56,1,476,32161476
3018,0,1794400,1,8,56,1,476,32161476
3019,0,1794400,1,8,56,1,476,32161476
3020,0,1794400,1,8,56,1,476,32161476
3021,921,1794400,9,8,56,2,397,32162397
3022,44,1794500,5,8,56,2,441,32162441
3023,0,1794500,1,8,56,2,441,32162441
3024,0,1794500,1,8,56,2,441,32162441
3025,0,1794500,1,8,56,2,441,32162441
3026,81,1794600,1,8,56,2,522,32162522
3027,152,1794600,1,8,56,2,674,32162674
3028,67,1794600,1,8,56,2,741,32162741
3029,77,1794600,2,8,56,2,818,32162818
3030,421,1794600,1,8,56,3,239,32163239
3031,966,1794500,1,8,56,4,205,32164205
3032,34,1794600,1,8,56,4,239,32164239
3033,866,1794600,1,8,56,5,105,32165105
3034,2312,1794500,1,8,56,7,417,32167417
3035,112,1794600,1,8,56,7,529,32167529
3036,879,1794300,1,8,56,8,408,32168408
3037,68,1794500,1,8,56,8,476,32168476
3038,1,1794500,1,8,56,8,477,32168477
3039,1,1794500,1,8,56,8,478,32168478
3040,2488,1794600,1,8,56,10,966,32170966
3041,65,1794600,1,8,56,11,31,32171031
3042,413,1794500,1,8,56,11,444,32171444
3044,61,1794500,1,8,56,11,505,32171505
3045,189,1794600,4,8,56,11,694,32171694
3046,140,1794600,1,8,56,11,834,32171834
3047,1648,1794600,3,8,56,13,482,32173482
3048,22,1794600,1,8,56,13,504,32173504
3049,577,1794600,1,8,56,14,81,32174081
3050,271,1794700,1,8,56,14,352,32174352
3051,561,1794600,2,8,56,14,913,32174913
3052,516,1794700,1,8,56,15,429,32175429
3053,1,1794700,11,8,56,15,430,32175430
3054,1,1794700,3,8,56,15,431,32175431
3055,0,1794700,1,8,56,15,431,32175431
3056,0,1794700,1,8,56,15,431,32175431
3057,0,1794700,1,8,56,15,431,32175431
3059,0,1794800,1,8,56,15,431,32175431
3060,1,1794800,8,8,56,15,432,32175432
3061,21,1794900,1,8,56,15,453,32175453
3062,0,1794900,1,8,56,15,453,32175453
3063,0,1794900,1,8,56,15,453,32175453
3064,0,1794900,1,8,56,15,453,32175453
3065,0,1794900,1,8,56,15,453,32175453
3066,0,1794900,4,8,56,15,453,32175453
3067,152,1795000,1,8,56,15,605,32175605
3068,4,1795000,8,8,56,15,609,32175609
3069,0,1795000,16,8,56,15,609,32175609
3070,0,1795000,1,8,56,15,609,32175609
3071,1,1795100,1,8,56,15,610,32175610
3072,0,1795100,1,8,56,15,610,32175610
3073,0,1795100,1,8,56,15,610,32175610
3074,15,1795100,6,8,56,15,625,32175625
3075,6,1795200,6,8,56,15,631,32175631
3076,1,1795200,12,8,56,15,632,32175632
3077,0,1795200,7,8,56,15,632,32175632
3078,108,1795300,1,8,56,15,740,32175740
3079,14,1795100,1,8,56,15,754,32175754
3080,7,1795300,1,8,56,15,761,32175761
3081,16,1795100,5,8,56,15,777,32175777
3082,4,1795300,2,8,56,15,781,32175781
3083,2,1795300,1,8,56,15,783,32175783
3084,3,1795300,2,8,56,15,786,32175786
3085,23,1795100,1,8,56,15,809,32175809
3086,68,1795100,1,8,56,15,877,32175877
3087,48,1795300,2,8,56,15,925,32175925
3088,39,1795300,1,8,56,15,964,32175964
3089,66,1795300,3,8,56,16,30,32176030
3090,87,1795100,1,8,56,16,117,32176117
3091,29,1795300,1,8,56,16,146,32176146
3092,108,1795400,2,8,56,16,254,32176254
3093,341,1795100,2,8,56,16,595,32176595
3094,142,1795300,2,8,56,16,737,32176737
3095,1762,1795300,1,8,56,18,499,32178499
3096,121,1795200,1,8,56,18,620,32178620
3097,279,1795300,1,8,56,18,899,32178899
3098,590,1795200,1,8,56,19,489,32179489
3099,844,1795300,6,8,56,20,333,32180333
3101,563,1795200,1,8,56,20,896,32180896
3102,214,1795300,1,8,56,21,110,32181110
3103,374,1795300,4,8,56,21,484,32181484
3105,2,1795300,1,8,56,21,486,32181486
3106,72,1795200,2,8,56,21,558,32181558
3107,108,1795300,3,8,56,21,666,32181666
3108,166,1795400,1,8,56,21,832,32181832
3109,922,1795300,2,8,56,22,754,32182754
3110,568,1795300,1,8,56,23,322,32183322
3111,46,1795300,1,8,56,23,368,32183368
3112,105,1795200,1,8,56,23,473,32183473
3113,664,1795200,7,8,56,24,137,32184137
3114,17,1795200,1,8,56,24,154,32184154
3115,24,1795200,1,8,56,24,178,32184178
3116,191,1795200,1,8,56,24,369,32184369
3117,47,1795100,1,8,56,24,416,32184416
3118,867,1795300,1,8,56,25,283,32185283
3119,356,1795200,1,8,56,25,639,32185639
3120,0,1795200,1,8,56,25,639,32185639
3122,866,1795100,1,8,56,26,505,32186505
3123,100,1795100,1,8,56,26,605,32186605
3124,115,1795100,1,8,56,26,720,32186720
3125,304,1795200,1,8,56,27,24,32187024
3126,76,1795200,1,8,56,27,100,32187100
3127,0,1795200,1,8,56,27,100,32187100
3128,893,1795300,5,8,56,27,993,32187993
3129,29,1795100,1,8,56,28,22,32188022
3130,1691,1795100,2,8,56,29,713,32189713
3131,481,1795300,8,8,56,30,194,32190194
3133,24,1795200,4,8,56,30,218,32190218
3135,143,1795100,8,8,56,30,361,32190361
3137,136,1795200,1,8,56,30,497,32190497
3138,49,1795200,1,8,56,30,546,32190546
3139,322,1795000,1,8,56,30,868,32190868
3140,2327,1795100,1,8,56,33,195,32193195
3141,1217,1795100,3,8,56,34,412,32194412
3143,652,1795000,1,8,56,35,64,32195064
3144,512,1795200,1,8,56,35,576,32195576
3145,635,1795100,1,8,56,36,211,32196211
3146,936,1795100,1,8,56,37,147,32197147
3147,1044,1795100,1,8,56,38,191,32198191
3148,100,1795200,10,8,56,38,291,32198291
3149,399,1795200,1,8,56,38,690,32198690
3150,1560,1795200,5,8,56,40,250,32200250
3151,226,1795300,2,8,56,40,476,32200476
3152,1,1795300,1,8,56,40,477,32200477
3153,617,1795300,1,8,56,41,94,32201094
3154,522,1795400,2,8,56,41,616,32201616
3155,6,1795400,1,8,56,41,622,32201622
3156,0,1795400,1,8,56,41,622,32201622
3157,0,1795400,1,8,56,41,622,32201622
3158,970,1795500,1,8,56,42,592,32202592
3159,28,1795500,1,8,56,42,620,32202620
3160,51,1795400,1,8,56,42,671,32202671
3161,60,1795400,1,8,56,42,731,32202731
3162,105,1795400,5,8,56,42,836,32202836
3163,444,1795500,15,8,56,43,280,32203280
3164,129,1795500,2,8,56,43,409,32203409
3165,29,1795500,1,8,56,43,438,32203438
3166,127,1795600,1,8,56,43,565,32203565
3167,307,1795600,7,8,56,43,872,32203872
3168,1,1795600,1,8,56,43,873,32203873
3169,1,1795600,5,8,56,43,874,32203874
3170,6,1795700,1,8,56,43,880,32203880
3171,162,1795700,2,8,56,44,42,32204042
3172,5,1795700,2,8,56,44,47,32204047
3173,26,1795700,2,8,56,44,73,32204073
3174,83,1795700,1,8,56,44,156,32204156
3175,18,1795700,1,8,56,44,174,32204174
3176,23,1795600,1,8,56,44,197,32204197
3177,41,1795600,1,8,56,44,238,32204238
3178,17,1795600,1,8,56,44,255,32204255
3179,65,1795700,1,8,56,44,320,32204320
3180,179,1795600,1,8,56,44,499,32204499
3181,630,1795700,2,8,56,45,129,32205129
3182,68,1795600,1,8,56,45,197,32205197
3183,1264,1795700,1,8,56,46,461,32206461
3184,321,1795700,1,8,56,46,782,32206782
3185,733,1795600,1,8,56,47,515,32207515
3186,86,1795700,1,8,56,47,601,32207601
3187,0,1795700,1,8,56,47,601,32207601
3188,73,1795700,1,8,56,47,674,32207674
3189,219,1795700,5,8,56,47,893,32207893
3190,356,1795700,1,8,56,48,249,32208249
3191,103,1795600,3,8,56,48,352,32208352
3192,4,1795700,1,8,56,48,356,32208356
3193,396,1795600,1,8,56,48,752,32208752
3194,402,1795600,8,8,56,49,154,32209154
3195,331,1795600,1,8,56,49,485,32209485
3196,16,1795500,1,8,56,49,501,32209501
3197,262,1795700,1,8,56,49,763,32209763
3198,598,1795700,1,8,56,50,361,32210361
3199,336,1795700,1,8,56,50,697,32210697
3200,12,1795700,5,8,56,50,709,32210709
3201,341,1795700,1,8,56,51,50,32211050
3202,1342,1795500,1,8,56,52,392,32212392
3203,115,1795700,2,8,56,52,507,32212507
3204,90,1795700,1,8,56,52,597,32212597
3205,213,1795500,1,8,56,52,810,32212810
3206,1053,1795500,2,8,56,53,863,32213863
3207,0,1795500,3,8,56,53,863,32213863
3208,73,1795500,2,8,56,53,936,32213936
3209,887,1795600,1,8,56,54,823,32214823
3210,145,1795500,1,8,56,54,968,32214968
3211,974,1795600,5,8,56,55,942,32215942
3212,1087,1795600,1,8,56,57,29,32217029
3213,778,1795500,1,8,56,57,807,32217807
3214,257,1795700,1,8,56,58,64,32218064
3215,37,1795700,1,8,56,58,101,32218101
3216,386,1795500,1,8,56,58,487,32218487
3217,126,1795700,1,8,56,58,613,32218613
3218,752,1795700,1,8,56,59,365,32219365
3219,773,1795600,1,8,57,0,138,32220138
3220,89,1795700,2,8,57,0,227,32220227
3221,1,1795700,1,8,57,0,228,32220228
3222,0,1795700,1,8,57,0,228,32220228
3223,0,1795700,1,8,57,0,228,32220228
3224,1,1795700,1,8,57,0,229,32220229
3225,0,1795700,1,8,57,0,229,32220229
3226,10,1795800,3,8,57,0,239,32220239
3227,61,1795700,2,8,57,0,300,32220300
3228,69,1795800,1,8,57,0,369,32220369
3229,6,1795800,1,8,57,0,375,32220375
3230,10,1795800,1,8,57,0,385,32220385
3231,2,1795800,1,8,57,0,387,32220387
3232,2,1795800,1,8,57,0,389,32220389
3233,57,1795800,1,8,57,0,446,32220446
3234,11,1795800,4,8,57,0,457,32220457
3235,10,1795800,1,8,57,0,467,32220467
3236,4,1795800,1,8,57,0,471,32220471
3237,8,1795800,1,8,57,0,479,32220479
3238,30,1795800,1,8,57,0,509,32220509
3239,1,1795800,1,8,57,0,510,32220510
3240,0,1795800,1,8,57,0,510,32220510
3241,0,1795800,1,8,57,0,510,32220510
3242,72,1795700,1,8,57,0,582,32220582
3243,79,1795800,2,8,57,0,661,32220661
3244,16,1795800,1,8,57,0,677,32220677
3245,20,1795800,1,8,57,0,697,32220697
3246,22,1795800,1,8,57,0,719,32220719
3247,76,1795800,1,8,57,0,795,32220795
3248,345,1795800,4,8,57,1,140,32221140
3249,85,1795800,1,8,57,1,225,32221225
3250,0,1795800,1,8,57,1,225,32221225
3251,1,1795900,1,8,57,1,226,32221226
3252,0,1795900,1,8,57,1,226,32221226
3253,0,1795900,1,8,57,1,226,32221226
3254,0,1795900,1,8,57,1,226,32221226
3255,0,1795900,1,8,57,1,226,32221226
3256,0,1795900,1,8,57,1,226,32221226
3257,1,1796000,1,8,57,1,227,32221227
3258,51,1796000,1,8,57,1,278,32221278
3259,100,1796000,1,8,57,1,378,32221378
3260,2,1796000,1,8,57,1,380,32221380
3261,34,1796000,1,8,57,1,414,32221414
3262,4,1796000,1,8,57,1,418,32221418
3263,4,1796000,1,8,57,1,422,32221422
3264,1,1796000,1,8,57,1,423,32221423
3265,1,1796000,1,8,57,1,424,32221424
3266,78,1796000,1,8,57,1,502,32221502
3267,4,1796000,1,8,57,1,506,32221506
3268,3,1796000,1,8,57,1,509,32221509
3269,10,1796000,1,8,57,1,519,32221519
3270,15,1796000,1,8,57,1,534,32221534
3271,21,1796000,1,8,57,1,555,32221555
3272,18,1796000,1,8,57,1,573,32221573
3273,30,1796000,4,8,57,1,603,32221603
3274,1,1796000,1,8,57,1,604,32221604
3275,98,1796000,1,8,57,1,702,32221702
3276,12,1796000,1,8,57,1,714,32221714
3277,25,1796000,1,8,57,1,739,32221739
3278,25,1795900,4,8,57,1,764,32221764
3280,91,1796000,2,8,57,1,855,32221855
3281,6,1796000,1,8,57,1,861,32221861
3282,105,1795800,1,8,57,1,966,32221966
3283,132,1796000,1,8,57,2,98,32222098
3284,228,1795900,1,8,57,2,326,32222326
3285,105,1796000,1,8,57,2,431,32222431
3286,196,1795800,1,8,57,2,627,32222627
3287,150,1795800,2,8,57,2,777,32222777
3288,220,1795900,1,8,57,2,997,32222997
3289,85,1795900,1,8,57,3,82,32223082
3290,60,1795900,2,8,57,3,142,32223142
3291,47,1795800,1,8,57,3,189,32223189
3292,330,1795900,1,8,57,3,519,32223519
3293,242,1795700,2,8,57,3,761,32223761
3294,79,1795900,1,8,57,3,840,32223840
3295,29,1795800,1,8,57,3,869,32223869
3296,1044,1795900,1,8,57,4,913,32224913
3297,1,1795900,1,8,57,4,914,32224914
3299,496,1795900,1,8,57,5,410,32225410
3301,590,1796000,1,8,57,6,0,32226000
3302,27,1795900,1,8,57,6,27,32226027
3303,100,1796000,5,8,57,6,127,32226127
3304,656,1796000,10,8,57,6,783,32226783
3305,225,1796000,1,8,57,7,8,32227008
3306,15,1796100,2,8,57,7,23,32227023
3307,77,1796100,1,8,57,7,100,32227100
3308,1,1796100,1,8,57,7,101,32227101
3309,0,1796100,1,8,57,7,101,32227101
3310,0,1796100,1,8,57,7,101,32227101
3311,0,1796100,1,8,57,7,101,32227101
3312,0,1796100,1,8,57,7,101,32227101
3313,0,1796200,1,8,57,7,101,32227101
3314,1,1796200,1,8,57,7,102,32227102
3315,204,1796000,1,8,57,7,306,32227306
3316,124,1796100,7,8,57,7,430,32227430
3317,100,1796200,1,8,57,7,530,32227530
3318,472,1796200,1,8,57,8,2,32228002
3319,146,1796200,1,8,57,8,148,32228148
3320,307,1796100,1,8,57,8,455,32228455
3321,133,1796100,1,8,57,8,588,32228588
3323,11,1796200,1,8,57,8,599,32228599
3324,203,1796100,2,8,57,8,802,32228802
3325,311,1796100,1,8,57,9,113,32229113
3326,216,1796100,1,8,57,9,329,32229329
3327,556,1796100,2,8,57,9,885,32229885
3328,162,1796100,1,8,57,10,47,32230047
3329,110,1796200,1,8,57,10,157,32230157
3330,247,1796200,1,8,57,10,404,32230404
3331,6,1796100,1,8,57,10,410,32230410
3332,859,1796100,1,8,57,11,269,32231269
3333,521,1796100,10,8,57,11,790,32231790
3334,175,1796100,1,8,57,11,965,32231965
3335,448,1796100,1,8,57,12,413,32232413
3336,407,1795900,1,8,57,12,820,32232820
3337,55,1796000,2,8,57,12,875,32232875
3338,1045,1795900,3,8,57,13,920,32233920
3340,377,1795900,1,8,57,14,297,32234297
3341,41,1796000,1,8,57,14,338,32234338
3342,461,1796000,8,8,57,14,799,32234799
3344,265,1796100,1,8,57,15,64,32235064
3345,227,1796100,2,8,57,15,291,32235291
3346,906,1796200,2,8,57,16,197,32236197
3347,112,1796000,3,8,57,16,309,32236309
3348,61,1796000,1,8,57,16,370,32236370
3349,1066,1796000,4,8,57,17,436,32237436
3350,1,1796000,4,8,57,17,437,32237437
3351,38,1796000,1,8,57,17,475,32237475
3352,0,1796100,1,8,57,17,475,32237475
3353,0,1796100,1,8,57,17,475,32237475
3354,0,1796100,1,8,57,17,475,32237475
3355,0,1796100,1,8,57,17,475,32237475
3356,1,1796100,1,8,57,17,476,32237476
3357,0,1796200,1,8,57,17,476,32237476
3358,307,1796200,1,8,57,17,783,32237783
3359,962,1796000,1,8,57,18,745,32238745
3360,158,1796200,1,8,57,18,903,32238903
3361,22,1796000,1,8,57,18,925,32238925
3362,1499,1796200,1,8,57,20,424,32240424
3363,11,1796200,1,8,57,20,435,32240435
3364,43,1796200,1,8,57,20,478,32240478
3365,16,1796100,3,8,57,20,494,32240494
3366,726,1796100,3,8,57,21,220,32241220
3367,847,1796100,6,8,57,22,67,32242067
3369,159,1796100,1,8,57,22,226,32242226
3370,1,1796100,6,8,57,22,227,32242227
3371,1711,1796100,1,8,57,23,938,32243938
3372,270,1796100,2,8,57,24,208,32244208
3373,422,1796100,1,8,57,24,630,32244630
3374,872,1796100,3,8,57,25,502,32245502
3376,2502,1796100,1,8,57,28,4,32248004
3377,182,1796100,1,8,57,28,186,32248186
3378,227,1796200,1,8,57,28,413,32248413
3379,88,1796200,1,8,57,28,501,32248501
3380,1255,1796200,4,8,57,29,756,32249756
3381,94,1796200,1,8,57,29,850,32249850
3382,0,1796300,1,8,57,29,850,32249850
3383,1,1796300,1,8,57,29,851,32249851
3384,0,1796300,1,8,57,29,851,32249851
3385,0,1796300,1,8,57,29,851,32249851
3386,1,1796300,1,8,57,29,852,32249852
3387,286,1796300,1,8,57,30,138,32250138
3388,34,1796300,3,8,57,30,172,32250172
3389,673,1796300,1,8,57,30,845,32250845
3390,0,1796300,1,8,57,30,845,32250845
3391,1,1796300,1,8,57,30,846,32250846
3392,0,1796300,4,8,57,30,846,32250846
3393,24,1796400,3,8,57,30,870,32250870
3394,147,1796400,8,8,57,31,17,32251017
3396,16,1796300,1,8,57,31,33,32251033
3397,129,1796400,1,8,57,31,162,32251162
3398,12,1796400,1,8,57,31,174,32251174
3399,91,1796300,1,8,57,31,265,32251265
3400,52,1796400,3,8,57,31,317,32251317
3401,29,1796400,3,8,57,31,346,32251346
3402,26,1796500,1,8,57,31,372,32251372
3403,24,1796500,1,8,57,31,396,32251396
3404,59,1796500,1,8,57,31,455,32251455
3405,29,1796400,2,8,57,31,484,32251484
3406,2,1796300,1,8,57,31,486,32251486
3407,86,1796400,1,8,57,31,572,32251572
3408,13,1796300,1,8,57,31,585,32251585
3409,50,1796400,1,8,57,31,635,32251635
3410,6,1796400,1,8,57,31,641,32251641
3412,1,1796300,1,8,57,31,642,32251642
3413,66,1796400,1,8,57,31,708,32251708
3414,188,1796400,2,8,57,31,896,32251896
3415,33,1796200,1,8,57,31,929,32251929
3416,34,1796200,5,8,57,31,963,32251963
3417,24,1796300,1,8,57,31,987,32251987
3418,183,1796200,1,8,57,32,170,32252170
3419,463,1796300,3,8,57,32,633,32252633
3421,996,1796200,1,8,57,33,629,32253629
3422,314,1796200,1,8,57,33,943,32253943
3423,26,1796300,1,8,57,33,969,32253969
3424,384,1796300,1,8,57,34,353,32254353
3425,28,1796300,1,8,57,34,381,32254381
3426,70,1796300,1,8,57,34,451,32254451
3427,1,1796200,1,8,57,34,452,32254452
3428,195,1796300,1,8,57,34,647,32254647
3429,763,1796300,1,8,57,35,410,32255410
3430,11,1796300,1,8,57,35,421,32255421
3431,25,1796300,1,8,57,35,446,32255446
3432,279,1796300,1,8,57,35,725,32255725
3433,260,1796100,12,8,57,35,985,32255985
3434,4,1796000,2,8,57,35,989,32255989
3435,2,1795900,1,8,57,35,991,32255991
3436,136,1795800,1,8,57,36,127,32256127
3437,47,1796000,2,8,57,36,174,32256174
3438,5,1795800,1,8,57,36,179,32256179
3439,35,1796000,1,8,57,36,214,32256214
3440,140,1796000,1,8,57,36,354,32256354
3441,80,1796000,1,8,57,36,434,32256434
3442,193,1796000,1,8,57,36,627,32256627
3443,1390,1795900,1,8,57,38,17,32258017
3445,83,1796000,1,8,57,38,100,32258100
3446,0,1796000,1,8,57,38,100,32258100
3447,0,1796000,1,8,57,38,100,32258100
3448,0,1796000,1,8,57,38,100,32258100
3449,0,1796100,1,8,57,38,100,32258100
3450,0,1796100,1,8,57,38,100,32258100
3451,0,1796100,1,8,57,38,100,32258100
3452,1,1796100,1,8,57,38,101,32258101
3453,0,1796100,1,8,57,38,101,32258101
3454,47,1796000,1,8,57,38,148,32258148
3455,0,1796000,1,8,57,38,148,32258148
3457,2,1796100,1,8,57,38,150,32258150
3458,1208,1796200,1,8,57,39,358,32259358
3459,36,1796200,1,8,57,39,394,32259394
3460,77,1796300,1,8,57,39,471,32259471
3461,175,1796400,1,8,57,39,646,32259646
3462,1268,1796300,4,8,57,40,914,32260914
3463,1249,1796300,6,8,57,42,163,32262163
3464,603,1796400,2,8,57,42,766,32262766
3465,442,1796300,3,8,57,43,208,32263208
3466,55,1796400,1,8,57,43,263,32263263
3467,964,1796400,1,8,57,44,227,32264227
3468,52,1796500,2,8,57,44,279,32264279
3469,1669,1796400,1,8,57,45,948,32265948
3470,491,1796400,1,8,57,46,439,32266439
3471,34,1796400,1,8,57,46,473,32266473
3472,154,1796400,10,8,57,46,627,32266627
3473,0,1796400,2,8,57,46,627,32266627
3474,385,1796400,1,8,57,47,12,32267012
3475,88,1796400,1,8,57,47,100,32267100
3476,0,1796400,1,8,57,47,100,32267100
3477,1,1796400,1,8,57,47,101,32267101
3478,76,1796300,4,8,57,47,177,32267177
3480,1371,1796200,11,8,57,48,548,32268548
3481,473,1796200,2,8,57,49,21,32269021
3482,58,1796200,1,8,57,49,79,32269079
3483,573,1796200,1,8,57,49,652,32269652
3484,63,1796200,1,8,57,49,715,32269715
3486,301,1796400,10,8,57,50,16,32270016
3488,3,1796600,3,8,57,50,19,32270019
3489,0,1796600,1,8,57,50,19,32270019
3490,1,1796600,1,8,57,50,20,32270020
3491,0,1796600,1,8,57,50,20,32270020
3492,0,1796600,2,8,57,50,20,32270020
3493,0,1796600,5,8,57,50,20,32270020
3494,0,1796600,1,8,57,50,20,32270020
3495,0,1796600,1,8,57,50,20,32270020
3496,0,1796600,1,8,57,50,20,32270020
3497,0,1796600,1,8,57,50,20,32270020
3498,1,1796600,1,8,57,50,21,32270021
3499,0,1796700,6,8,57,50,21,32270021
3500,1,1796700,5,8,57,50,22,32270022
3501,0,1796700,1,8,57,50,22,32270022
3502,1,1796700,1,8,57,50,23,32270023
3503,84,1796800,1,8,57,50,107,32270107
3504,121,1796800,1,8,57,50,228,32270228
3505,17,1796600,1,8,57,50,245,32270245
3506,92,1796800,1,8,57,50,337,32270337
3507,206,1796800,3,8,57,50,543,32270543
3508,201,1796600,1,8,57,50,744,32270744
3509,102,1796800,1,8,57,50,846,32270846
3510,125,1796600,4,8,57,50,971,32270971
3511,316,1796800,1,8,57,51,287,32271287
3512,27,1796600,1,8,57,51,314,32271314
3513,533,1796800,1,8,57,51,847,32271847
3514,288,1796600,5,8,57,52,135,32272135
3516,1,1796600,1,8,57,52,136,32272136
3517,43,1796500,2,8,57,52,179,32272179
3518,30,1796700,1,8,57,52,209,32272209
3519,396,1796600,1,8,57,52,605,32272605
3520,57,1796700,4,8,57,52,662,32272662
3522,7,1796700,1,8,57,52,669,32272669
3523,825,1796500,5,8,57,53,494,32273494
3524,881,1796700,1,8,57,54,375,32274375
3525,153,1796700,1,8,57,54,528,32274528
3526,204,1796600,1,8,57,54,732,32274732
3527,463,1796600,1,8,57,55,195,32275195
3528,259,1796600,1,8,57,55,454,32275454
3529,1,1796600,1,8,57,55,455,32275455
3530,496,1796700,2,8,57,55,951,32275951
3531,29,1796700,1,8,57,55,980,32275980
3533,47,1796700,2,8,57,56,27,32276027
3534,81,1796800,2,8,57,56,108,32276108
3535,51,1796800,2,8,57,56,159,32276159
3536,4,1796600,1,8,57,56,163,32276163
3537,216,1796600,5,8,57,56,379,32276379
3539,659,1796500,1,8,57,57,38,32277038
3540,1595,1796600,2,8,57,58,633,32278633
3541,316,1796700,3,8,57,58,949,32278949
3542,12,1796600,1,8,57,58,961,32278961
3543,14,1796700,1,8,57,58,975,32278975
3544,235,1796600,1,8,57,59,210,32279210
3545,148,1796500,1,8,57,59,358,32279358
3546,111,1796600,1,8,57,59,469,32279469
3547,2,1796600,1,8,57,59,471,32279471
3548,120,1796500,2,8,57,59,591,32279591
3549,133,1796600,1,8,57,59,724,32279724
3550,126,1796500,1,8,57,59,850,32279850
3551,4,1796500,1,8,57,59,854,32279854
3552,344,1796700,1,8,58,0,198,32280198
3553,10,1796700,2,8,58,0,208,32280208
3554,18,1796700,1,8,58,0,226,32280226
3555,0,1796700,3,8,58,0,226,32280226
3556,1,1796700,1,8,58,0,227,32280227
3557,0,1796700,1,8,58,0,227,32280227
3558,0,1796700,1,8,58,0,227,32280227
3559,0,1796800,1,8,58,0,227,32280227
3560,197,1796600,2,8,58,0,424,32280424
3561,693,1796600,1,8,58,1,117,32281117
3562,108,1796700,1,8,58,1,225,32281225
3563,266,1796800,1,8,58,1,491,32281491
3564,234,1796800,1,8,58,1,725,32281725
3565,174,1796800,2,8,58,1,899,32281899
3566,327,1796800,6,8,58,2,226,32282226
3567,121,1796700,1,8,58,2,347,32282347
3568,506,1796900,2,8,58,2,853,32282853
3569,479,1796700,1,8,58,3,332,32283332
3570,34,1796700,1,8,58,3,366,32283366
3571,23,1796800,1,8,58,3,389,32283389
3572,1,1796800,2,8,58,3,390,32283390
3573,8,1796800,1,8,58,3,398,32283398
3574,754,1796800,3,8,58,4,152,32284152
3576,215,1796800,1,8,58,4,367,32284367
3577,374,1796800,1,8,58,4,741,32284741
3578,461,1796800,2,8,58,5,202,32285202
3579,21,1796800,2,8,58,5,223,32285223
3580,57,1796800,1,8,58,5,280,32285280
3581,77,1796700,1,8,58,5,357,32285357
3583,247,1796700,3,8,58,5,604,32285604
3584,705,1796700,5,8,58,6,309,32286309
3585,272,1796700,2,8,58,6,581,32286581
3586,303,1796600,1,8,58,6,884,32286884
3587,87,1796600,1,8,58,6,971,32286971
3588,33,1796700,1,8,58,7,4,32287004
3589,96,1796700,1,8,58,7,100,32287100
3590,0,1796700,1,8,58,7,100,32287100
3591,0,1796700,1,8,58,7,100,32287100
3592,117,1796700,2,8,58,7,217,32287217
3593,655,1796700,1,8,58,7,872,32287872
3594,347,1796700,1,8,58,8,219,32288219
3595,638,1796600,4,8,58,8,857,32288857
3597,355,1796700,2,8,58,9,212,32289212
3598,211,1796500,1,8,58,9,423,32289423
3599,375,1796500,2,8,58,9,798,32289798
3600,376,1796700,1,8,58,10,174,32290174
3601,1505,1796700,2,8,58,11,679,32291679
3602,930,1796600,1,8,58,12,609,32292609
3603,0,1796600,1,8,58,12,609,32292609
3604,0,1796600,1,8,58,12,609,32292609
3605,0,1796600,1,8,58,12,609,32292609
3606,371,1796700,1,8,58,12,980,32292980
3607,670,1796700,1,8,58,13,650,32293650
3608,400,1796500,5,8,58,14,50,32294050
3609,1349,1796500,49,8,58,15,399,32295399
3610,1,1796500,12,8,58,15,400,32295400
3611,0,1796500,8,8,58,15,400,32295400
3612,1,1796500,7,8,58,15,401,32295401
3613,1,1796500,100,8,58,15,402,32295402
3614,0,1796500,2,8,58,15,402,32295402
3615,0,1796500,1,8,58,15,402,32295402
3616,0,1796500,1,8,58,15,402,32295402
3617,0,1796500,1,8,58,15,402,32295402
3618,0,1796500,1,8,58,15,402,32295402
3619,0,1796500,4,8,58,15,402,32295402
3620,1,1796500,18,8,58,15,403,32295403
3621,0,1796500,4,8,58,15,403,32295403
3622,0,1796500,2,8,58,15,403,32295403
3623,0,1796500,1,8,58,15,403,32295403
3624,0,1796500,1,8,58,15,403,32295403
3625,0,1796500,1,8,58,15,403,32295403
3626,0,1796500,1,8,58,15,403,32295403
3627,0,1796500,1,8,58,15,403,32295403
3628,2,1796500,8,8,58,15,405,32295405
3629,1,1796500,1,8,58,15,406,32295406
3630,0,1796500,1,8,58,15,406,32295406
3631,252,1796500,2,8,58,15,658,32295658
3632,143,1796500,1,8,58,15,801,32295801
3633,0,1796500,1,8,58,15,801,32295801
3634,0,1796500,1,8,58,15,801,32295801
3635,178,1796600,1,8,58,15,979,32295979
3636,32,1796500,1,8,58,16,11,32296011
3637,70,1796600,1,8,58,16,81,32296081
3638,305,1796500,1,8,58,16,386,32296386
3639,493,1796600,1,8,58,16,879,32296879
3640,25,1796600,6,8,58,16,904,32296904
3642,2,1796700,2,8,58,16,906,32296906
3643,0,1796700,1,8,58,16,906,32296906
3644,0,1796700,2,8,58,16,906,32296906
3645,169,1796700,1,8,58,17,75,32297075
3646,25,1796800,1,8,58,17,100,32297100
3647,1,1796800,1,8,58,17,101,32297101
3648,0,1796800,1,8,58,17,101,32297101
3649,162,1796700,1,8,58,17,263,32297263
3650,534,1796700,1,8,58,17,797,32297797
3651,122,1796700,1,8,58,17,919,32297919
3652,62,1796800,1,8,58,17,981,32297981
3653,0,1796800,5,8,58,17,981,32297981
3654,0,1796800,4,8,58,17,981,32297981
3655,124,1796800,1,8,58,18,105,32298105
3656,427,1796800,1,8,58,18,532,32298532
3657,226,1796800,1,8,58,18,758,32298758
3658,226,1796900,6,8,58,18,984,32298984
3659,1076,1796700,1,8,58,20,60,32300060
3660,644,1796800,1,8,58,20,704,32300704
3661,1027,1796800,1,8,58,21,731,32301731
3662,1037,1796800,1,8,58,22,768,32302768
3663,205,1796900,5,8,58,22,973,32302973
3664,1,1796900,40,8,58,22,974,32302974
3665,2,1797000,1,8,58,22,976,32302976
3666,0,1797000,1,8,58,22,976,32302976
3667,0,1797000,1,8,58,22,976,32302976
3668,0,1797000,2,8,58,22,976,32302976
3669,0,1797000,1,8,58,22,976,32302976
3670,0,1797000,2,8,58,22,976,32302976
3671,0,1797000,1,8,58,22,976,32302976
3672,0,1797000,1,8,58,22,976,32302976
3673,179,1797000,1,8,58,23,155,32303155
3674,127,1797100,1,8,58,23,282,32303282
3675,282,1797100,1,8,58,23,564,32303564
3676,36,1797100,4,8,58,23,600,32303600
3677,2,1797100,1,8,58,23,602,32303602
3678,231,1797200,2,8,58,23,833,32303833
3679,211,1797200,1,8,58,24,44,32304044
3680,40,1797200,2,8,58,24,84,32304084
3681,176,1797200,1,8,58,24,260,32304260
3682,231,1797200,1,8,58,24,491,32304491
3683,37,1797200,1,8,58,24,528,32304528
3684,352,1797000,2,8,58,24,880,32304880
3685,93,1797000,1,8,58,24,973,32304973
3686,1148,1797000,1,8,58,26,121,32306121
3687,495,1797000,1,8,58,26,616,32306616
3688,349,1796900,1,8,58,26,965,32306965
3689,36,1796800,1,8,58,27,1,32307001
3690,99,1797000,1,8,58,27,100,32307100
3691,1,1797000,1,8,58,27,101,32307101
3692,1741,1797000,2,8,58,28,842,32308842
3693,299,1796900,1,8,58,29,141,32309141
3694,71,1797000,2,8,58,29,212,32309212
3695,534,1797100,2,8,58,29,746,32309746
3696,821,1797100,1,8,58,30,567,32310567
3697,960,1797100,4,8,58,31,527,32311527
3698,370,1797200,2,8,58,31,897,32311897
3699,1228,1797200,1,8,58,33,125,32313125
3700,803,1797100,1,8,58,33,928,32313928
3701,96,1797100,1,8,58,34,24,32314024
3702,790,1797100,1,8,58,34,814,32314814
3703,26,1797200,1,8,58,34,840,32314840
3704,79,1797100,1,8,58,34,919,32314919
3705,184,1797100,1,8,58,35,103,32315103
3706,294,1797200,3,8,58,35,397,32315397
3707,294,1797200,1,8,58,35,691,32315691
3708,31,1797200,1,8,58,35,722,32315722
3709,641,1797200,2,8,58,36,363,32316363
3710,552,1797200,1,8,58,36,915,32316915
3711,312,1797200,1,8,58,37,227,32317227
3712,123,1797300,1,8,58,37,350,32317350
3713,1,1797300,1,8,58,37,351,32317351
3714,4,1797300,1,8,58,37,355,32317355
3715,129,1797300,1,8,58,37,484,32317484
3716,25,1797300,3,8,58,37,509,32317509
3717,121,1797300,3,8,58,37,630,32317630
3719,110,1797400,1,8,58,37,740,32317740
3720,57,1797400,1,8,58,37,797,32317797
3721,4,1797400,1,8,58,37,801,32317801
3722,5,1797400,1,8,58,37,806,32317806
3723,4,1797400,1,8,58,37,810,32317810
3724,1,1797400,2,8,58,37,811,32317811
3725,7,1797500,1,8,58,37,818,32317818
3726,0,1797500,1,8,58,37,818,32317818
3727,0,1797500,1,8,58,37,818,32317818
3728,0,1797500,1,8,58,37,818,32317818
3729,14,1797500,1,8,58,37,832,32317832
3730,21,1797500,1,8,58,37,853,32317853
3731,28,1797500,1,8,58,37,881,32317881
3732,46,1797300,3,8,58,37,927,32317927
3733,40,1797400,1,8,58,37,967,32317967
3734,11,1797400,3,8,58,37,978,32317978
3735,6,1797400,2,8,58,37,984,32317984
3736,3,1797400,1,8,58,37,987,32317987
3738,73,1797500,1,8,58,38,60,32318060
3739,18,1797300,2,8,58,38,78,32318078
3740,150,1797300,1,8,58,38,228,32318228
3741,269,1797300,6,8,58,38,497,32318497
3742,74,1797200,1,8,58,38,571,32318571
3743,253,1797200,1,8,58,38,824,32318824
3744,111,1797200,2,8,58,38,935,32318935
3745,133,1797200,3,8,58,39,68,32319068
3746,117,1797100,2,8,58,39,185,32319185
3747,399,1797300,1,8,58,39,584,32319584
3748,243,1797300,2,8,58,39,827,32319827
3749,475,1797200,1,8,58,40,302,32320302
3750,589,1797300,1,8,58,40,891,32320891
3751,630,1797400,2,8,58,41,521,32321521
3752,154,1797500,2,8,58,41,675,32321675
3753,108,1797500,1,8,58,41,783,32321783
3754,101,1797400,1,8,58,41,884,32321884
3755,671,1797500,3,8,58,42,555,32322555
3756,1770,1797400,1,8,58,44,325,32324325
3757,357,1797300,5,8,58,44,682,32324682
3758,137,1797400,1,8,58,44,819,32324819
3759,167,1797400,1,8,58,44,986,32324986
3760,222,1797400,1,8,58,45,208,32325208
3761,205,1797300,1,8,58,45,413,32325413
3762,67,1797400,1,8,58,45,480,32325480
3763,694,1797400,2,8,58,46,174,32326174
3764,461,1797400,3,8,58,46,635,32326635
3765,133,1797500,10,8,58,46,768,32326768
3766,1187,1797300,3,8,58,47,955,32327955
3767,20,1797300,1,8,58,47,975,32327975
3768,52,1797300,1,8,58,48,27,32328027
3769,126,1797200,2,8,58,48,153,32328153
3770,56,1797200,1,8,58,48,209,32328209
3771,97,1797300,2,8,58,48,306,32328306
3772,0,1797300,2,8,58,48,306,32328306
3773,0,1797300,2,8,58,48,306,32328306
3774,0,1797300,2,8,58,48,306,32328306
3776,1,1797700,28,8,58,48,307,32328307
3777,3,1797700,1,8,58,48,310,32328310
3778,0,1797800,2,8,58,48,310,32328310
3779,1,1797800,1,8,58,48,311,32328311
3780,0,1797800,1,8,58,48,311,32328311
3781,0,1797800,1,8,58,48,311,32328311
3782,0,1797800,2,8,58,48,311,32328311
3783,0,1797800,1,8,58,48,311,32328311
3784,0,1797800,3,8,58,48,311,32328311
3785,0,1797800,1,8,58,48,311,32328311
3786,0,1797800,2,8,58,48,311,32328311
3787,0,1797800,1,8,58,48,311,32328311
3788,1,1797900,2,8,58,48,312,32328312
3789,0,1797700,1,8,58,48,312,32328312
3790,1,1797800,1,8,58,48,313,32328313
3791,1,1797900,1,8,58,48,314,32328314
3792,1,1797800,1,8,58,48,315,32328315
3793,0,1797900,1,8,58,48,315,32328315
3794,0,1797900,6,8,58,48,315,32328315
3795,0,1797900,6,8,58,48,315,32328315
3796,1,1797900,1,8,58,48,316,32328316
3797,0,1797900,2,8,58,48,316,32328316
3798,0,1797900,1,8,58,48,316,32328316
3799,0,1797900,1,8,58,48,316,32328316
3800,2,1798000,1,8,58,48,318,32328318
3801,1,1798000,1,8,58,48,319,32328319
3802,30,1798000,1,8,58,48,349,32328349
3803,1,1798000,1,8,58,48,350,32328350
3804,0,1798000,1,8,58,48,350,32328350
3805,0,1798000,1,8,58,48,350,32328350
3806,1,1798000,1,8,58,48,351,32328351
3807,31,1798000,1,8,58,48,382,32328382
3808,1,1798000,2,8,58,48,383,32328383
3809,21,1798000,2,8,58,48,404,32328404
3810,2,1798000,2,8,58,48,406,32328406
3811,5,1798000,2,8,58,48,411,32328411
3812,3,1798000,5,8,58,48,414,32328414
3813,0,1798000,5,8,58,48,414,32328414
3814,1,1798000,1,8,58,48,415,32328415
3815,0,1798000,9,8,58,48,415,32328415
3816,0,1798000,10,8,58,48,415,32328415
3817,0,1798000,3,8,58,48,415,32328415
3818,8,1798100,2,8,58,48,423,32328423
3819,1,1798000,1,8,58,48,424,32328424
3820,5,1798100,1,8,58,48,429,32328429
3821,27,1798100,2,8,58,48,456,32328456
3822,19,1798100,2,8,58,48,475,32328475
3823,27,1798100,1,8,58,48,502,32328502
3825,4,1798000,3,8,58,48,506,32328506
3826,57,1798100,2,8,58,48,563,32328563
3827,1,1798000,1,8,58,48,564,32328564
3829,10,1798100,2,8,58,48,574,32328574
3830,21,1798000,1,8,58,48,595,32328595
3831,18,1798100,2,8,58,48,613,32328613
3832,0,1798100,2,8,58,48,613,32328613
3833,2,1797900,1,8,58,48,615,32328615
3834,1,1798100,3,8,58,48,616,32328616
3835,1,1798100,1,8,58,48,617,32328617
3836,9,1798100,2,8,58,48,626,32328626
3837,4,1798200,1,8,58,48,630,32328630
3838,10,1798200,11,8,58,48,640,32328640
3840,1,1798200,1,8,58,48,641,32328641
3841,0,1798300,1,8,58,48,641,32328641
3842,0,1798300,1,8,58,48,641,32328641
3843,10,1798300,2,8,58,48,651,32328651
3844,0,1798300,2,8,58,48,651,32328651
3845,0,1798300,2,8,58,48,651,32328651
3847,2,1798500,1,8,58,48,653,32328653
3848,2,1798600,1,8,58,48,655,32328655
3849,1,1798500,2,8,58,48,656,32328656
3850,20,1798600,2,8,58,48,676,32328676
3851,3,1798600,2,8,58,48,679,32328679
3852,2,1798600,1,8,58,48,681,32328681
3853,24,1798600,1,8,58,48,705,32328705
3855,25,1798700,4,8,58,48,730,32328730
3856,3,1798700,1,8,58,48,733,32328733
3857,11,1798700,2,8,58,48,744,32328744
3858,0,1798600,1,8,58,48,744,32328744
3859,1,1798700,3,8,58,48,745,32328745
3860,15,1798700,1,8,58,48,760,32328760
3861,9,1798700,3,8,58,48,769,32328769
3862,1,1798600,1,8,58,48,770,32328770
3863,4,1798700,2,8,58,48,774,32328774
3864,7,1798600,2,8,58,48,781,32328781
3865,9,1798600,1,8,58,48,790,32328790
3866,0,1798500,1,8,58,48,790,32328790
3867,8,1798600,3,8,58,48,798,32328798
3868,6,1798600,2,8,58,48,804,32328804
3870,7,1798700,2,8,58,48,811,32328811
3871,1,1798700,1,8,58,48,812,32328812
3872,3,1798800,1,8,58,48,815,32328815
3873,6,1798600,1,8,58,48,821,32328821
3874,1,1798600,1,8,58,48,822,32328822
3875,10,1798700,2,8,58,48,832,32328832
3876,22,1798700,1,8,58,48,854,32328854
3877,2,1798700,2,8,58,48,856,32328856
3879,1,1798800,1,8,58,48,857,32328857
3880,17,1798800,2,8,58,48,874,32328874
3881,4,1798800,3,8,58,48,878,32328878
3882,5,1798800,1,8,58,48,883,32328883
3883,30,1798800,2,8,58,48,913,32328913
3884,3,1798800,4,8,58,48,916,32328916
3885,6,1798800,3,8,58,48,922,32328922
3886,0,1798700,1,8,58,48,922,32328922
3887,2,1798800,2,8,58,48,924,32328924
3888,6,1798800,1,8,58,48,930,32328930
3889,9,1798800,1,8,58,48,939,32328939
3890,4,1798800,1,8,58,48,943,32328943
3891,0,1798700,1,8,58,48,943,32328943
3892,11,1798800,4,8,58,48,954,32328954
3894,56,1798800,1,8,58,49,10,32329010
3895,2,1798900,1,8,58,49,12,32329012
3896,14,1798900,1,8,58,49,26,32329026
3897,5,1798900,1,8,58,49,31,32329031
3898,2,1798900,1,8,58,49,33,32329033
3899,5,1798900,1,8,58,49,38,32329038
3900,39,1798700,1,8,58,49,77,32329077
3901,4,1798800,1,8,58,49,81,32329081
3902,12,1798800,1,8,58,49,93,32329093
3903,4,1798700,1,8,58,49,97,32329097
3904,2,1798700,1,8,58,49,99,32329099
3906,7,1798600,1,8,58,49,106,32329106
3907,3,1798800,1,8,58,49,109,32329109
3908,4,1798600,1,8,58,49,113,32329113
3909,4,1798800,1,8,58,49,117,32329117
3910,1,1798600,2,8,58,49,118,32329118
3911,10,1798800,1,8,58,49,128,32329128
3912,32,1798800,1,8,58,49,160,32329160
3913,22,1798800,1,8,58,49,182,32329182
3914,14,1798800,1,8,58,49,196,32329196
3915,64,1798800,2,8,58,49,260,32329260
3916,3,1798600,4,8,58,49,263,32329263
3917,67,1798600,1,8,58,49,330,32329330
3919,7,1798700,1,8,58,49,337,32329337
3920,16,1798700,1,8,58,49,353,32329353
3921,22,1798700,1,8,58,49,375,32329375
3922,80,1798700,2,8,58,49,455,32329455
3923,20,1798800,1,8,58,49,475,32329475
3924,10,1798800,1,8,58,49,485,32329485
3925,21,1798600,1,8,58,49,506,32329506
3926,170,1798800,1,8,58,49,676,32329676
3927,30,1798800,1,8,58,49,706,32329706
3928,4,1798800,1,8,58,49,710,32329710
3929,9,1798600,5,8,58,49,719,32329719
3931,187,1798700,1,8,58,49,906,32329906
3932,114,1798600,1,8,58,50,20,32330020
3933,279,1798600,1,8,58,50,299,32330299
3934,41,1798400,1,8,58,50,340,32330340
3935,60,1798500,1,8,58,50,400,32330400
3936,231,1798600,1,8,58,50,631,32330631
3937,36,1798400,1,8,58,50,667,32330667
3938,73,1798400,1,8,58,50,740,32330740
3939,138,1798400,1,8,58,50,878,32330878
3940,166,1798400,1,8,58,51,44,32331044
3941,45,1798400,4,8,58,51,89,32331089
3943,40,1798500,1,8,58,51,129,32331129
3944,92,1798300,1,8,58,51,221,32331221
3945,246,1798300,1,8,58,51,467,32331467
3946,63,1798500,3,8,58,51,530,32331530
3947,13,1798400,2,8,58,51,543,32331543
3948,338,1798300,1,8,58,51,881,32331881
3949,10,1798300,1,8,58,51,891,32331891
3950,9,1798500,1,8,58,51,900,32331900
3951,87,1798300,1,8,58,51,987,32331987
3952,231,1798200,1,8,58,52,218,32332218
3953,410,1798200,1,8,58,52,628,32332628
3955,74,1798300,10,8,58,52,702,32332702
3956,266,1798200,1,8,58,52,968,32332968
3957,248,1798200,2,8,58,53,216,32333216
3958,73,1798300,1,8,58,53,289,32333289
3959,176,1798400,1,8,58,53,465,32333465
3960,150,1798200,3,8,58,53,615,32333615
3961,26,1798400,1,8,58,53,641,32333641
3962,201,1798400,1,8,58,53,842,32333842
3963,200,1798400,1,8,58,54,42,32334042
3964,180,1798300,1,8,58,54,222,32334222
3965,81,1798300,1,8,58,54,303,32334303
3966,4,1798300,1,8,58,54,307,32334307
3967,463,1798300,3,8,58,54,770,32334770
3968,202,1798300,1,8,58,54,972,32334972
3969,391,1798200,1,8,58,55,363,32335363
3970,255,1798300,1,8,58,55,618,32335618
3971,2591,1798200,3,8,58,58,209,32338209
3973,827,1798100,1,8,58,59,36,32339036
3974,9,1798100,7,8,58,59,45,32339045
3976,35,1798000,1,8,58,59,80,32339080
3977,236,1798000,1,8,58,59,316,32339316
3978,136,1798000,1,8,58,59,452,32339452
3979,171,1798000,1,8,58,59,623,32339623
3980,256,1798000,1,8,58,59,879,32339879
3981,251,1797900,1,8,59,0,130,32340130
3982,102,1798000,2,8,59,0,232,32340232
3984,312,1797900,1,8,59,0,544,32340544
3985,173,1797800,1,8,59,0,717,32340717
3986,245,1797800,1,8,59,0,962,32340962
3987,272,1797800,1,8,59,1,234,32341234
3988,121,1797900,1,8,59,1,355,32341355
3989,255,1797700,1,8,59,1,610,32341610
3990,289,1797900,2,8,59,1,899,32341899
3991,143,1797700,3,8,59,2,42,32342042
3992,60,1797800,1,8,59,2,102,32342102
3993,599,1797800,1,8,59,2,701,32342701
3994,9,1797800,1,8,59,2,710,32342710
3995,3,1797700,1,8,59,2,713,32342713
3996,2,1797700,1,8,59,2,715,32342715
3997,66,1797600,1,8,59,2,781,32342781
3998,80,1797800,1,8,59,2,861,32342861
3999,54,1797700,1,8,59,2,915,32342915
4000,574,1797700,1,8,59,3,489,32343489
4001,368,1797700,1,8,59,3,857,32343857
4002,348,1797700,1,8,59,4,205,32344205
4003,205,1797800,1,8,59,4,410,32344410
4004,517,1797600,1,8,59,4,927,32344927
4005,378,1797800,1,8,59,5,305,32345305
4006,300,1797700,1,8,59,5,605,32345605
4007,44,1797700,2,8,59,5,649,32345649
4009,468,1797600,2,8,59,6,117,32346117
4010,138,1797600,2,8,59,6,255,32346255
4012,228,1797600,1,8,59,6,483,32346483
4013,200,1797700,3,8,59,6,683,32346683
4014,59,1797700,1,8,59,6,742,32346742
4015,272,1797500,1,8,59,7,14,32347014
4016,472,1797600,3,8,59,7,486,32347486
4017,224,1797700,1,8,59,7,710,32347710
4018,631,1797500,1,8,59,8,341,32348341
4019,877,1797500,1,8,59,9,218,32349218
4020,374,1797600,1,8,59,9,592,32349592
4021,50,1797500,1,8,59,9,642,32349642
4022,126,1797400,1,8,59,9,768,32349768
4023,288,1797400,1,8,59,10,56,32350056
4024,538,1797400,2,8,59,10,594,32350594
4025,110,1797500,1,8,59,10,704,32350704
4026,1,1797500,1,8,59,10,705,32350705
4027,73,1797500,1,8,59,10,778,32350778
4028,142,1797400,2,8,59,10,920,32350920
4029,3,1797400,1,8,59,10,923,32350923
4030,329,1797500,1,8,59,11,252,32351252
4031,4,1797500,1,8,59,11,256,32351256
4032,326,1797400,1,8,59,11,582,32351582
4033,10,1797300,1,8,59,11,592,32351592
4034,89,1797500,1,8,59,11,681,32351681
4035,530,1797500,1,8,59,12,211,32352211
4036,633,1797300,1,8,59,12,844,32352844
4037,777,1797400,3,8,59,13,621,32353621
4038,363,1797400,1,8,59,13,984,32353984
4039,262,1797300,1,8,59,14,246,32354246
4040,5,1797500,1,8,59,14,251,32354251
4041,40,1797500,1,8,59,14,291,32354291
4042,996,1797300,1,8,59,15,287,32355287
4043,943,1797500,2,8,59,16,230,32356230
4044,754,1797500,1,8,59,16,984,32356984
4045,1112,1797400,1,8,59,18,96,32358096
4046,990,1797300,1,8,59,19,86,32359086
4047,333,1797300,1,8,59,19,419,32359419
4048,20,1797300,1,8,59,19,439,32359439
4049,98,1797400,1,8,59,19,537,32359537
4050,627,1797500,1,8,59,20,164,32360164
4051,54,1797400,1,8,59,20,218,32360218
4052,399,1797500,5,8,59,20,617,32360617
4053,0,1797500,5,8,59,20,617,32360617
4055,3,1797800,1,8,59,20,620,32360620
4056,0,1797800,1,8,59,20,620,32360620
4057,0,1797800,1,8,59,20,620,32360620
4058,0,1797800,5,8,59,20,620,32360620
4059,1,1797800,1,8,59,20,621,32360621
4060,1,1797900,5,8,59,20,622,32360622
4061,24,1798000,2,8,59,20,646,32360646
4062,1,1798000,1,8,59,20,647,32360647
4063,8,1798000,3,8,59,20,655,32360655
4064,0,1798100,2,8,59,20,655,32360655
4065,107,1798000,1,8,59,20,762,32360762
4066,0,1798000,1,8,59,20,762,32360762
4067,45,1798100,4,8,59,20,807,32360807
4068,52,1798100,1,8,59,20,859,32360859
4069,1,1798000,3,8,59,20,860,32360860
4070,126,1798000,1,8,59,20,986,32360986
4071,308,1798000,1,8,59,21,294,32361294
4072,309,1798200,1,8,59,21,603,32361603
4073,190,1798000,1,8,59,21,793,32361793
4074,125,1798000,1,8,59,21,918,32361918
4075,1110,1798100,1,8,59,23,28,32363028
4076,92,1798100,2,8,59,23,120,32363120
4077,43,1798200,1,8,59,23,163,32363163
4078,37,1798200,1,8,59,23,200,32363200
4079,16,1798200,1,8,59,23,216,32363216
4080,155,1798200,1,8,59,23,371,32363371
4081,43,1798200,1,8,59,23,414,32363414
4082,74,1798200,1,8,59,23,488,32363488
4083,70,1798200,1,8,59,23,558,32363558
4084,0,1798200,3,8,59,23,558,32363558
4085,12,1798200,1,8,59,23,570,32363570
4086,456,1798100,1,8,59,24,26,32364026
4087,27,1798300,1,8,59,24,53,32364053
4088,790,1798100,1,8,59,24,843,32364843
4089,957,1798100,1,8,59,25,800,32365800
4090,925,1798200,1,8,59,26,725,32366725
4091,30,1798200,1,8,59,26,755,32366755
4092,181,1798100,1,8,59,26,936,32366936
4093,149,1798300,1,8,59,27,85,32367085
4094,550,1798100,1,8,59,27,635,32367635
4095,752,1798100,1,8,59,28,387,32368387
4096,563,1798100,1,8,59,28,950,32368950
4097,179,1798100,1,8,59,29,129,32369129
4098,34,1798100,1,8,59,29,163,32369163
4099,325,1798200,1,8,59,29,488,32369488
4100,338,1798000,2,8,59,29,826,32369826
4102,116,1798000,1,8,59,29,942,32369942
4103,77,1798000,1,8,59,30,19,32370019
4104,905,1798100,1,8,59,30,924,32370924
4105,451,1798000,1,8,59,31,375,32371375
4106,452,1798100,2,8,59,31,827,32371827
4107,3531,1798000,1,8,59,35,358,32375358
4108,18,1798100,1,8,59,35,376,32375376
4109,822,1798100,1,8,59,36,198,32376198
4110,576,1798000,1,8,59,36,774,32376774
4111,1141,1798100,1,8,59,37,915,32377915
4112,384,1798000,1,8,59,38,299,32378299
4113,98,1798100,1,8,59,38,397,32378397
4114,863,1798100,1,8,59,39,260,32379260
4115,530,1798000,2,8,59,39,790,32379790
4116,0,1798000,6,8,59,39,790,32379790
4117,180,1798100,5,8,59,39,970,32379970
4118,608,1797900,6,8,59,40,578,32380578
4120,457,1797800,1,8,59,41,35,32381035
4121,1158,1797800,2,8,59,42,193,32382193
4122,180,1798000,3,8,59,42,373,32382373
4123,359,1797800,2,8,59,42,732,32382732
4124,511,1797800,1,8,59,43,243,32383243
4125,545,1797800,1,8,59,43,788,32383788
4126,471,1797800,2,8,59,44,259,32384259
4127,910,1797800,2,8,59,45,169,32385169
4128,985,1797700,1,8,59,46,154,32386154
4129,108,1797800,1,8,59,46,262,32386262
4130,29,1797700,10,8,59,46,291,32386291
4131,1,1797700,1,8,59,46,292,32386292
4132,0,1797700,1,8,59,46,292,32386292
4133,194,1797600,1,8,59,46,486,32386486
4134,17,1797600,1,8,59,46,503,32386503
4135,100,1797800,1,8,59,46,603,32386603
4136,544,1797700,4,8,59,47,147,32387147
4138,142,1797600,2,8,59,47,289,32387289
4139,205,1797800,1,8,59,47,494,32387494
4140,216,1797600,4,8,59,47,710,32387710
4141,0,1797600,4,8,59,47,710,32387710
4143,353,1797400,1,8,59,48,63,32388063
4144,300,1797400,1,8,59,48,363,32388363
4145,963,1797400,3,8,59,49,326,32389326
4147,42,1797500,1,8,59,49,368,32389368
4148,0,1797500,1,8,59,49,368,32389368
4149,461,1797700,1,8,59,49,829,32389829
4150,377,1797500,1,8,59,50,206,32390206
4151,44,1797500,1,8,59,50,250,32390250
4152,71,1797400,10,8,59,50,321,32390321
4153,38,1797300,10,8,59,50,359,32390359
4154,770,1797200,5,8,59,51,129,32391129
4155,6,1797200,1,8,59,51,135,32391135
4156,944,1797400,1,8,59,52,79,32392079
4157,263,1797300,2,8,59,52,342,32392342
4158,59,1797300,1,8,59,52,401,32392401
4159,741,1797200,1,8,59,53,142,32393142
4160,210,1797300,1,8,59,53,352,32393352
4161,122,1797300,2,8,59,53,474,32393474
4162,2,1797300,10,8,59,53,476,32393476
4164,359,1797200,1,8,59,53,835,32393835
4165,184,1797200,1,8,59,54,19,32394019
4166,192,1797200,5,8,59,54,211,32394211
4167,51,1797300,3,8,59,54,262,32394262
4168,210,1797200,3,8,59,54,472,32394472
4169,1,1797200,2,8,59,54,473,32394473
4170,861,1797100,2,8,59,55,334,32395334
4171,166,1797100,1,8,59,55,500,32395500
4172,1063,1797200,1,8,59,56,563,32396563
4173,224,1797100,1,8,59,56,787,32396787
4174,185,1797100,1,8,59,56,972,32396972
4175,52,1797100,1,8,59,57,24,32397024
4176,270,1797200,1,8,59,57,294,32397294
4177,24,1797100,10,8,59,57,318,32397318
4178,529,1797200,1,8,59,57,847,32397847
4179,79,1797200,3,8,59,57,926,32397926
4180,112,1797300,3,8,59,58,38,32398038
4181,10,1797300,1,8,59,58,48,32398048
4182,221,1797300,1,8,59,58,269,32398269
4183,122,1797400,1,8,59,58,391,32398391
4184,159,1797400,1,8,59,58,550,32398550
4185,380,1797400,2,8,59,58,930,32398930
4186,28,1797500,1,8,59,58,958,32398958
4188,540,1797500,3,8,59,59,498,32399498
4190,305,1797600,1,8,59,59,803,32399803
4191,0,1797600,3,8,59,59,803,32399803
4192,208,1797700,1,9,0,0,11,32400011
4193,61,1797600,1,9,0,0,72,32400072
4194,31,1797700,5,9,0,0,103,32400103
4195,0,1797700,1,9,0,0,103,32400103
4196,0,1797800,2,9,0,0,103,32400103
4197,0,1797800,2,9,0,0,103,32400103
4198,0,1797800,1,9,0,0,103,32400103
4199,0,1797800,1,9,0,0,103,32400103
4200,1,1797800,1,9,0,0,104,32400104
4201,1,1797800,1,9,0,0,105,32400105
4202,2,1797800,1,9,0,0,107,32400107
4203,7,1797900,1,9,0,0,114,32400114
4204,17,1797900,1,9,0,0,131,32400131
4205,1,1797900,1,9,0,0,132,32400132
4206,1,1797900,1,9,0,0,133,32400133
4207,13,1797900,10,9,0,0,146,32400146
4208,30,1797900,3,9,0,0,176,32400176
4209,38,1797800,1,9,0,0,214,32400214
4210,4,1797800,1,9,0,0,218,32400218
4211,37,1797900,1,9,0,0,255,32400255
4212,86,1797700,5,9,0,0,341,32400341
4213,43,1797900,1,9,0,0,384,32400384
4214,1,1797700,1,9,0,0,385,32400385
4215,9,1797800,1,9,0,0,394,32400394
4216,0,1797800,1,9,0,0,394,32400394
4217,9,1797800,1,9,0,0,403,32400403
4218,1,1797900,1,9,0,0,404,32400404
4219,13,1797900,1,9,0,0,417,32400417
4220,19,1797900,5,9,0,0,436,32400436
4222,50,1797900,1,9,0,0,486,32400486
4223,33,1797900,1,9,0,0,519,32400519
4224,1,1797800,5,9,0,0,520,32400520
4225,20,1797900,1,9,0,0,540,32400540
4226,127,1797900,1,9,0,0,667,32400667
4227,1,1798000,1,9,0,0,668,32400668
4228,7,1798000,1,9,0,0,675,32400675
4229,7,1798000,1,9,0,0,682,32400682
4230,1,1798000,1,9,0,0,683,32400683
4231,9,1798000,1,9,0,0,692,32400692
4232,26,1798000,1,9,0,0,718,32400718
4233,64,1797900,1,9,0,0,782,32400782
4234,24,1797900,1,9,0,0,806,32400806
4235,29,1797900,1,9,0,0,835,32400835
4236,28,1797800,2,9,0,0,863,32400863
4238,22,1797900,1,9,0,0,885,32400885
4239,59,1797900,2,9,0,0,944,32400944
4240,18,1798000,1,9,0,0,962,32400962
4241,135,1798000,1,9,0,1,97,32401097
4242,3,1798000,1,9,0,1,100,32401100
4243,1,1798000,1,9,0,1,101,32401101
4244,130,1797900,1,9,0,1,231,32401231
4245,4,1798000,1,9,0,1,235,32401235
4246,46,1798000,1,9,0,1,281,32401281
4247,21,1798000,1,9,0,1,302,32401302
4248,37,1798000,4,9,0,1,339,32401339
4249,61,1798100,1,9,0,1,400,32401400
4250,141,1798000,1,9,0,1,541,32401541
4251,29,1798100,1,9,0,1,570,32401570
4252,66,1798100,1,9,0,1,636,32401636
4253,40,1798100,5,9,0,1,676,32401676
4254,84,1798100,1,9,0,1,760,32401760
4255,40,1798100,1,9,0,1,800,32401800
4256,0,1798100,3,9,0,1,800,32401800
4257,51,1798100,1,9,0,1,851,32401851
4258,258,1797900,1,9,0,2,109,32402109
4259,7,1798000,1,9,0,2,116,32402116
4260,1,1797900,5,9,0,2,117,32402117
4261,33,1798000,1,9,0,2,150,32402150
4262,17,1798000,1,9,0,2,167,32402167
4263,12,1798000,2,9,0,2,179,32402179
4264,163,1798000,6,9,0,2,342,32402342
4266,2,1798000,1,9,0,2,344,32402344
4267,247,1797900,1,9,0,2,591,32402591
4268,78,1798000,1,9,0,2,669,32402669
4269,15,1798000,1,9,0,2,684,32402684
4270,264,1797800,4,9,0,2,948,32402948
4271,16,1797800,1,9,0,2,964,32402964
4272,87,1797900,4,9,0,3,51,32403051
4274,77,1798000,1,9,0,3,128,32403128
4275,63,1798000,1,9,0,3,191,32403191
4276,410,1798100,1,9,0,3,601,32403601
4277,235,1798000,1,9,0,3,836,32403836
4278,127,1798100,1,9,0,3,963,32403963
4280,128,1798200,1,9,0,4,91,32404091
4281,14,1798200,8,9,0,4,105,32404105
4283,94,1798300,1,9,0,4,199,32404199
4284,129,1798200,1,9,0,4,328,32404328
4285,42,1798300,1,9,0,4,370,32404370
4286,43,1798300,1,9,0,4,413,32404413
4287,0,1798300,1,9,0,4,413,32404413
4288,88,1798300,1,9,0,4,501,32404501
4289,21,1798300,1,9,0,4,522,32404522
4290,51,1798100,1,9,0,4,573,32404573
4291,189,1798300,1,9,0,4,762,32404762
4292,0,1798300,1,9,0,4,762,32404762
4293,0,1798300,1,9,0,4,762,32404762
4294,0,1798300,1,9,0,4,762,32404762
4295,1,1798300,1,9,0,4,763,32404763
4296,0,1798300,1,9,0,4,763,32404763
4297,0,1798300,2,9,0,4,763,32404763
4298,9,1798400,10,9,0,4,772,32404772
4299,1,1798400,1,9,0,4,773,32404773
4300,0,1798400,14,9,0,4,773,32404773
4301,202,1798400,3,9,0,4,975,32404975
4302,3,1798300,10,9,0,4,978,32404978
4303,60,1798400,1,9,0,5,38,32405038
4304,18,1798200,1,9,0,5,56,32405056
4305,134,1798200,1,9,0,5,190,32405190
4306,4,1798200,1,9,0,5,194,32405194
4307,2,1798200,1,9,0,5,196,32405196
4308,1,1798200,4,9,0,5,197,32405197
4309,4,1798100,1,9,0,5,201,32405201
4310,3,1798100,1,9,0,5,204,32405204
4311,1,1798100,1,9,0,5,205,32405205
4312,10,1797900,4,9,0,5,215,32405215
4313,5,1798100,1,9,0,5,220,32405220
4314,5,1797900,1,9,0,5,225,32405225
4315,68,1798000,1,9,0,5,293,32405293
4316,1,1798000,2,9,0,5,294,32405294
4317,40,1797900,2,9,0,5,334,32405334
4318,36,1797900,2,9,0,5,370,32405370
4320,104,1798100,2,9,0,5,474,32405474
4321,28,1798000,2,9,0,5,502,32405502
4322,0,1798000,1,9,0,5,502,32405502
4323,1,1797900,2,9,0,5,503,32405503
4324,2,1798000,1,9,0,5,505,32405505
4325,6,1798000,1,9,0,5,511,32405511
4326,10,1797900,2,9,0,5,521,32405521
4327,123,1798000,1,9,0,5,644,32405644
4328,7,1797900,1,9,0,5,651,32405651
4329,34,1797900,1,9,0,5,685,32405685
4330,0,1797900,1,9,0,5,685,32405685
4331,2,1797900,1,9,0,5,687,32405687
4332,0,1797800,1,9,0,5,687,32405687
4333,1,1797800,1,9,0,5,688,32405688
4334,2,1797700,1,9,0,5,690,32405690
4335,3,1797700,1,9,0,5,693,32405693
4336,7,1797700,1,9,0,5,700,32405700
4337,2,1797700,1,9,0,5,702,32405702
4338,2,1797800,1,9,0,5,704,32405704
4339,0,1797700,1,9,0,5,704,32405704
4340,4,1797800,1,9,0,5,708,32405708
4341,4,1797700,1,9,0,5,712,32405712
4342,9,1797700,1,9,0,5,721,32405721
4343,33,1797700,2,9,0,5,754,32405754
4344,101,1797800,1,9,0,5,855,32405855
4345,153,1797800,1,9,0,6,8,32406008
4346,29,1797800,3,9,0,6,37,32406037
4347,27,1797700,2,9,0,6,64,32406064
4348,32,1797800,1,9,0,6,96,32406096
4349,0,1797800,1,9,0,6,96,32406096
4351,46,1798000,1,9,0,6,142,32406142
4353,50,1798100,1,9,0,6,192,32406192
4354,26,1798200,3,9,0,6,218,32406218
4356,13,1798400,2,9,0,6,231,32406231
4357,22,1798400,2,9,0,6,253,32406253
4358,6,1798300,1,9,0,6,259,32406259
4359,38,1798400,4,9,0,6,297,32406297
4361,11,1798300,1,9,0,6,308,32406308
4362,46,1798400,1,9,0,6,354,32406354
4363,20,1798400,1,9,0,6,374,32406374
4364,42,1798400,1,9,0,6,416,32406416
4366,53,1798500,1,9,0,6,469,32406469
4367,15,1798500,1,9,0,6,484,32406484
4368,44,1798300,2,9,0,6,528,32406528
4369,104,1798400,1,9,0,6,632,32406632
4370,55,1798400,1,9,0,6,687,32406687
4371,205,1798300,1,9,0,6,892,32406892
4372,81,1798200,1,9,0,6,973,32406973
4373,3,1798400,1,9,0,6,976,32406976
4374,35,1798400,1,9,0,7,11,32407011
4375,90,1798400,1,9,0,7,101,32407101
4376,0,1798400,1,9,0,7,101,32407101
4377,0,1798400,1,9,0,7,101,32407101
4378,0,1798400,1,9,0,7,101,32407101
4379,0,1798400,1,9,0,7,101,32407101
4380,0,1798400,1,9,0,7,101,32407101
4381,127,1798500,2,9,0,7,228,32407228
4382,185,1798500,1,9,0,7,413,32407413
4383,161,1798300,2,9,0,7,574,32407574
4385,177,1798300,1,9,0,7,751,32407751
4386,78,1798300,1,9,0,7,829,32407829
4388,25,1798400,1,9,0,7,854,32407854
4389,16,1798400,2,9,0,7,870,32407870
4390,32,1798200,1,9,0,7,902,32407902
4391,71,1798100,1,9,0,7,973,32407973
4392,94,1798200,1,9,0,8,67,32408067
4393,249,1798000,1,9,0,8,316,32408316
4394,368,1798000,1,9,0,8,684,32408684
4395,219,1797800,1,9,0,8,903,32408903
4396,19,1797900,1,9,0,8,922,32408922
4397,28,1797900,1,9,0,8,950,32408950
4399,96,1797800,1,9,0,9,46,32409046
4400,155,1797900,1,9,0,9,201,32409201
4402,475,1797800,1,9,0,9,676,32409676
4403,47,1797800,1,9,0,9,723,32409723
4404,61,1798100,1,9,0,9,784,32409784
4405,180,1798100,1,9,0,9,964,32409964
4406,410,1798100,2,9,0,10,374,32410374
4407,146,1797900,1,9,0,10,520,32410520
4408,185,1798000,1,9,0,10,705,32410705
4409,7,1798100,1,9,0,10,712,32410712
4410,219,1798000,1,9,0,10,931,32410931
4411,0,1797900,1,9,0,10,931,32410931
4412,81,1797900,1,9,0,11,12,32411012
4413,29,1797900,1,9,0,11,41,32411041
4414,53,1797800,3,9,0,11,94,32411094
4415,49,1797900,1,9,0,11,143,32411143
4416,78,1797800,1,9,0,11,221,32411221
4417,75,1797800,1,9,0,11,296,32411296
4418,72,1797800,2,9,0,11,368,32411368
4419,1,1797900,1,9,0,11,369,32411369
4420,40,1798000,1,9,0,11,409,32411409
4421,13,1797800,1,9,0,11,422,32411422
4422,52,1797900,3,9,0,11,474,32411474
4423,37,1798000,1,9,0,11,511,32411511
4424,21,1798000,1,9,0,11,532,32411532
4425,80,1797900,1,9,0,11,612,32411612
4426,147,1797900,1,9,0,11,759,32411759
4427,91,1798000,1,9,0,11,850,32411850
4429,142,1798000,1,9,0,11,992,32411992
4430,16,1798100,1,9,0,12,8,32412008
4431,157,1798000,2,9,0,12,165,32412165
4432,48,1798200,1,9,0,12,213,32412213
4433,1,1798100,1,9,0,12,214,32412214
4434,33,1798100,1,9,0,12,247,32412247
4435,140,1798100,1,9,0,12,387,32412387
4436,69,1798100,1,9,0,12,456,32412456
4437,53,1798200,1,9,0,12,509,32412509
4438,68,1798100,4,9,0,12,577,32412577
4440,82,1798100,2,9,0,12,659,32412659
4441,127,1798000,1,9,0,12,786,32412786
4442,163,1798200,1,9,0,12,949,32412949
4443,0,1798200,1,9,0,12,949,32412949
4444,1,1798200,4,9,0,12,950,32412950
4445,59,1798300,1,9,0,13,9,32413009
4446,12,1798300,2,9,0,13,21,32413021
4447,2,1798300,1,9,0,13,23,32413023
4448,60,1798200,1,9,0,13,83,32413083
4449,246,1798200,2,9,0,13,329,32413329
4450,29,1798100,1,9,0,13,358,32413358
4451,69,1798100,1,9,0,13,427,32413427
4452,47,1798100,1,9,0,13,474,32413474
4453,36,1798300,1,9,0,13,510,32413510
4454,129,1798300,1,9,0,13,639,32413639
4455,69,1798200,1,9,0,13,708,32413708
4456,4,1798300,2,9,0,13,712,32413712
4457,263,1798300,1,9,0,13,975,32413975
4458,34,1798300,1,9,0,14,9,32414009
4459,145,1798300,2,9,0,14,154,32414154
4460,185,1798400,1,9,0,14,339,32414339
4461,4,1798200,1,9,0,14,343,32414343
4462,51,1798100,2,9,0,14,394,32414394
4463,115,1798300,1,9,0,14,509,32414509
4464,13,1798100,1,9,0,14,522,32414522
4465,200,1798100,1,9,0,14,722,32414722
4466,5,1798300,2,9,0,14,727,32414727
4467,124,1798200,1,9,0,14,851,32414851
4468,107,1798100,1,9,0,14,958,32414958
4469,0,1798100,1,9,0,14,958,32414958
4470,51,1798200,1,9,0,15,9,32415009
4471,168,1798000,1,9,0,15,177,32415177
4473,239,1797900,2,9,0,15,416,32415416
4474,0,1797800,4,9,0,15,416,32415416
4475,1,1797800,3,9,0,15,417,32415417
4476,93,1797900,1,9,0,15,510,32415510
4477,140,1797800,1,9,0,15,650,32415650
4478,97,1797900,1,9,0,15,747,32415747
4480,262,1798000,1,9,0,16,9,32416009
4481,141,1798000,3,9,0,16,150,32416150
4483,25,1798100,4,9,0,16,175,32416175
4484,21,1798100,2,9,0,16,196,32416196
4485,242,1798100,2,9,0,16,438,32416438
4486,71,1798100,1,9,0,16,509,32416509
4487,45,1797900,2,9,0,16,554,32416554
4489,103,1798000,3,9,0,16,657,32416657
4490,94,1797800,2,9,0,16,751,32416751
4491,43,1797800,3,9,0,16,794,32416794
4492,21,1797900,2,9,0,16,815,32416815
4493,152,1797700,1,9,0,16,967,32416967
4494,1,1797700,1,9,0,16,968,32416968
4495,0,1797700,1,9,0,16,968,32416968
4496,41,1797700,1,9,0,17,9,32417009
4497,48,1797600,1,9,0,17,57,32417057
4498,43,1797700,1,9,0,17,100,32417100
4499,0,1797700,1,9,0,17,100,32417100
4500,1,1797700,1,9,0,17,101,32417101
4501,0,1797700,1,9,0,17,101,32417101
4502,0,1797800,1,9,0,17,101,32417101
4503,0,1797800,1,9,0,17,101,32417101
4504,0,1797800,1,9,0,17,101,32417101
4505,0,1797800,1,9,0,17,101,32417101
4506,0,1797800,1,9,0,17,101,32417101
4507,1,1797800,1,9,0,17,102,32417102
4508,0,1797900,1,9,0,17,102,32417102
4509,0,1797900,1,9,0,17,102,32417102
4510,0,1797900,1,9,0,17,102,32417102
4511,0,1797900,1,9,0,17,102,32417102
4512,56,1797800,1,9,0,17,158,32417158
4513,3,1797700,1,9,0,17,161,32417161
4514,56,1797600,2,9,0,17,217,32417217
4515,162,1797600,1,9,0,17,379,32417379
4516,36,1797800,6,9,0,17,415,32417415
4517,42,1797600,4,9,0,17,457,32417457
4518,52,1797800,1,9,0,17,509,32417509
4519,501,1797900,1,9,0,18,10,32418010
4520,653,1798100,3,9,0,18,663,32418663
4521,44,1798100,1,9,0,18,707,32418707
4522,137,1798200,2,9,0,18,844,32418844
4523,5,1798200,4,9,0,18,849,32418849
4524,76,1798300,5,9,0,18,925,32418925
4525,179,1798400,2,9,0,19,104,32419104
4526,151,1798400,1,9,0,19,255,32419255
4527,3,1798400,2,9,0,19,258,32419258
4528,254,1798500,1,9,0,19,512,32419512
4529,59,1798500,2,9,0,19,571,32419571
4530,87,1798600,2,9,0,19,658,32419658
4531,8,1798500,1,9,0,19,666,32419666
4532,74,1798500,1,9,0,19,740,32419740
4533,45,1798600,3,9,0,19,785,32419785
4534,118,1798600,1,9,0,19,903,32419903
4535,131,1798600,1,9,0,20,34,32420034
4536,29,1798600,3,9,0,20,63,32420063
4537,43,1798600,1,9,0,20,106,32420106
4538,144,1798700,2,9,0,20,250,32420250
4539,21,1798500,1,9,0,20,271,32420271
4540,219,1798600,1,9,0,20,490,32420490
4541,10,1798500,1,9,0,20,500,32420500
4542,104,1798400,1,9,0,20,604,32420604
4543,45,1798500,1,9,0,20,649,32420649
4545,166,1798500,1,9,0,20,815,32420815
4546,39,1798700,1,9,0,20,854,32420854
4547,57,1798700,3,9,0,20,911,32420911
4548,54,1798700,1,9,0,20,965,32420965
4549,0,1798700,1,9,0,20,965,32420965
4550,371,1798500,1,9,0,21,336,32421336
4551,137,1798700,3,9,0,21,473,32421473
4552,470,1798600,1,9,0,21,943,32421943
4554,0,1798500,2,9,0,21,943,32421943
4555,34,1798600,1,9,0,21,977,32421977
4556,75,1798600,1,9,0,22,52,32422052
4557,592,1798500,1,9,0,22,644,32422644
4558,224,1798700,1,9,0,22,868,32422868
4559,256,1798700,1,9,0,23,124,32423124
4560,111,1798600,1,9,0,23,235,32423235
4561,5,1798600,1,9,0,23,240,32423240
4562,96,1798800,1,9,0,23,336,32423336
4563,94,1798600,1,9,0,23,430,32423430
4564,27,1798600,1,9,0,23,457,32423457
4565,31,1798800,1,9,0,23,488,32423488
4566,518,1798800,2,9,0,24,6,32424006
4567,60,1798600,1,9,0,24,66,32424066
4568,127,1798600,1,9,0,24,193,32424193
4569,2,1798700,1,9,0,24,195,32424195
4570,62,1798600,1,9,0,24,257,32424257
4571,190,1798700,1,9,0,24,447,32424447
4572,72,1798700,5,9,0,24,519,32424519
4574,56,1798700,1,9,0,24,575,32424575
4576,163,1798600,1,9,0,24,738,32424738
4577,104,1798800,1,9,0,24,842,32424842
4578,155,1798600,1,9,0,24,997,32424997
4579,42,1798600,1,9,0,25,39,32425039
4580,11,1798800,1,9,0,25,50,32425050
4581,142,1798900,1,9,0,25,192,32425192
4582,5,1798700,1,9,0,25,197,32425197
4583,39,1798800,1,9,0,25,236,32425236
4584,0,1798700,1,9,0,25,236,32425236
4585,9,1798900,1,9,0,25,245,32425245
4586,0,1798900,1,9,0,25,245,32425245
4587,31,1798700,1,9,0,25,276,32425276
4588,24,1798900,1,9,0,25,300,32425300
4589,8,1798900,2,9,0,25,308,32425308
4590,6,1798900,4,9,0,25,314,32425314
4591,78,1798900,1,9,0,25,392,32425392
4592,18,1798900,1,9,0,25,410,32425410
4593,5,1799000,1,9,0,25,415,32425415
4594,2,1799000,1,9,0,25,417,32425417
4595,13,1799000,1,9,0,25,430,32425430
4596,0,1799000,1,9,0,25,430,32425430
4597,16,1799000,1,9,0,25,446,32425446
4598,16,1799000,1,9,0,25,462,32425462
4599,1,1799000,1,9,0,25,463,32425463
4600,7,1799000,1,9,0,25,470,32425470
4601,3,1799000,1,9,0,25,473,32425473
4602,3,1799000,1,9,0,25,476,32425476
4603,2,1799000,1,9,0,25,478,32425478
4604,0,1799000,1,9,0,25,478,32425478
4605,0,1799000,1,9,0,25,478,32425478
4606,0,1799000,4,9,0,25,478,32425478
4607,29,1799100,1,9,0,25,507,32425507
4608,8,1799100,3,9,0,25,515,32425515
4610,15,1799300,3,9,0,25,530,32425530
4611,1,1799300,1,9,0,25,531,32425531
4612,10,1799300,1,9,0,25,541,32425541
4613,1,1799300,1,9,0,25,542,32425542
4614,28,1799300,1,9,0,25,570,32425570
4615,6,1799300,1,9,0,25,576,32425576
4616,14,1799300,1,9,0,25,590,32425590
4617,6,1799300,1,9,0,25,596,32425596
4618,9,1799400,2,9,0,25,605,32425605
4619,2,1799400,2,9,0,25,607,32425607
4620,14,1799400,2,9,0,25,621,32425621
4621,5,1799300,1,9,0,25,626,32425626
4623,16,1799300,1,9,0,25,642,32425642
4624,24,1799400,2,9,0,25,666,32425666
4625,6,1799400,2,9,0,25,672,32425672
4626,10,1799400,1,9,0,25,682,32425682
4627,23,1799400,1,9,0,25,705,32425705
4628,8,1799400,1,9,0,25,713,32425713
4629,35,1799200,1,9,0,25,748,32425748
4630,10,1799400,1,9,0,25,758,32425758
4631,1,1799400,1,9,0,25,759,32425759
4632,26,1799200,1,9,0,25,785,32425785
4633,16,1799400,2,9,0,25,801,32425801
4635,6,1799400,1,9,0,25,807,32425807
4636,49,1799500,1,9,0,25,856,32425856
4637,23,1799400,1,9,0,25,879,32425879
4638,13,1799400,1,9,0,25,892,32425892
4639,13,1799500,1,9,0,25,905,32425905
4640,22,1799500,2,9,0,25,927,32425927
4641,0,1799500,1,9,0,25,927,32425927
4642,1,1799500,1,9,0,25,928,32425928
4643,10,1799500,1,9,0,25,938,32425938
4644,6,1799600,2,9,0,25,944,32425944
4645,10,1799400,1,9,0,25,954,32425954
4646,58,1799500,2,9,0,26,12,32426012
4647,12,1799500,1,9,0,26,24,32426024
4648,5,1799500,1,9,0,26,29,32426029
4649,78,1799500,5,9,0,26,107,32426107
4650,109,1799300,9,9,0,26,216,32426216
4651,46,1799300,1,9,0,26,262,32426262
4652,42,1799300,1,9,0,26,304,32426304
4653,74,1799300,1,9,0,26,378,32426378
4654,25,1799100,1,9,0,26,403,32426403
4655,37,1799100,1,9,0,26,440,32426440
4656,11,1799100,1,9,0,26,451,32426451
4657,4,1799200,1,9,0,26,455,32426455
4658,24,1799200,1,9,0,26,479,32426479
4659,296,1799200,1,9,0,26,775,32426775
4660,56,1799100,3,9,0,26,831,32426831
4661,166,1799100,1,9,0,26,997,32426997
4662,300,1799300,1,9,0,27,297,32427297
4663,53,1799300,1,9,0,27,350,32427350
4664,0,1799400,1,9,0,27,350,32427350
4665,1,1799400,1,9,0,27,351,32427351
4666,0,1799400,1,9,0,27,351,32427351
4667,0,1799400,1,9,0,27,351,32427351
4668,77,1799400,5,9,0,27,428,32427428
4669,194,1799400,3,9,0,27,622,32427622
4670,32,1799300,3,9,0,27,654,32427654
4671,49,1799400,1,9,0,27,703,32427703
4672,69,1799300,1,9,0,27,772,32427772
4673,137,1799300,2,9,0,27,909,32427909
4674,114,1799400,2,9,0,28,23,32428023
4675,66,1799400,2,9,0,28,89,32428089
4676,55,1799400,1,9,0,28,144,32428144
4678,35,1799300,4,9,0,28,179,32428179
4680,118,1799400,3,9,0,28,297,32428297
4681,63,1799300,1,9,0,28,360,32428360
4682,43,1799300,1,9,0,28,403,32428403
4683,61,1799400,5,9,0,28,464,32428464
4685,38,1799500,1,9,0,28,502,32428502
4686,38,1799500,1,9,0,28,540,32428540
4687,108,1799400,1,9,0,28,648,32428648
4689,41,1799500,1,9,0,28,689,32428689
4690,4,1799500,1,9,0,28,693,32428693
4691,106,1799500,2,9,0,28,799,32428799
4693,78,1799500,1,9,0,28,877,32428877
4694,21,1799500,2,9,0,28,898,32428898
4695,21,1799500,1,9,0,28,919,32428919
4696,269,1799400,3,9,0,29,188,32429188
4698,6,1799500,1,9,0,29,194,32429194
4699,82,1799500,2,9,0,29,276,32429276
4700,57,1799500,1,9,0,29,333,32429333
4701,0,1799500,2,9,0,29,333,32429333
4702,54,1799400,1,9,0,29,387,32429387
4704,112,1799500,2,9,0,29,499,32429499
4705,19,1799500,1,9,0,29,518,32429518
4706,5,1799500,1,9,0,29,523,32429523
4707,9,1799500,1,9,0,29,532,32429532
4708,29,1799500,4,9,0,29,561,32429561
4709,87,1799500,1,9,0,29,648,32429648
4711,82,1799600,1,9,0,29,730,32429730
4712,63,1799600,15,9,0,29,793,32429793
4714,104,1799700,2,9,0,29,897,32429897
4715,8,1799700,2,9,0,29,905,32429905
4716,7,1799700,2,9,0,29,912,32429912
4717,5,1799700,1,9,0,29,917,32429917
4718,24,1799600,1,9,0,29,941,32429941
4719,72,1799700,1,9,0,30,13,32430013
4720,6,1799700,2,9,0,30,19,32430019
4721,7,1799700,1,9,0,30,26,32430026
4723,44,1799700,1,9,0,30,70,32430070
4724,2,1799700,1,9,0,30,72,32430072
4725,42,1799800,2,9,0,30,114,32430114
4726,146,1799800,2,9,0,30,260,32430260
4727,8,1799800,2,9,0,30,268,32430268
4728,129,1799700,1,9,0,30,397,32430397
4729,307,1799800,1,9,0,30,704,32430704
4730,523,1799700,1,9,0,31,227,32431227
4731,141,1799700,1,9,0,31,368,32431368
4732,0,1799600,6,9,0,31,368,32431368
4733,2,1799500,2,9,0,31,370,32431370
4734,27,1799600,1,9,0,31,397,32431397
4735,24,1799500,1,9,0,31,421,32431421
4736,1,1799400,1,9,0,31,422,32431422
4737,8,1799600,1,9,0,31,430,32431430
4738,90,1799400,1,9,0,31,520,32431520
4739,12,1799600,1,9,0,31,532,32431532
4740,48,1799400,2,9,0,31,580,32431580
4741,2,1799600,1,9,0,31,582,32431582
4742,59,1799600,1,9,0,31,641,32431641
4743,75,1799500,1,9,0,31,716,32431716
4744,21,1799600,1,9,0,31,737,32431737
4745,57,1799600,1,9,0,31,794,32431794
4746,31,1799400,1,9,0,31,825,32431825
4747,17,1799500,1,9,0,31,842,32431842
4748,1,1799400,3,9,0,31,843,32431843
4749,30,1799500,2,9,0,31,873,32431873
4750,8,1799500,2,9,0,31,881,32431881
4751,3,1799400,1,9,0,31,884,32431884
4752,7,1799500,2,9,0,31,891,32431891
4753,213,1799300,1,9,0,32,104,32432104
4754,1,1799300,5,9,0,32,105,32432105
4755,101,1799200,2,9,0,32,206,32432206
4756,8,1799300,1,9,0,32,214,32432214
4757,53,1799300,2,9,0,32,267,32432267
4758,9,1799300,2,9,0,32,276,32432276
4759,12,1799300,2,9,0,32,288,32432288
4760,8,1799400,2,9,0,32,296,32432296
4761,9,1799400,2,9,0,32,305,32432305
4762,8,1799400,1,9,0,32,313,32432313
4764,9,1799500,2,9,0,32,322,32432322
4765,72,1799200,5,9,0,32,394,32432394
4766,165,1799300,1,9,0,32,559,32432559
4767,63,1799200,1,9,0,32,622,32432622
4768,0,1799100,8,9,0,32,622,32432622
4769,12,1799200,3,9,0,32,634,32432634
4771,50,1799300,7,9,0,32,684,32432684
4773,2,1799300,1,9,0,32,686,32432686
4774,88,1799400,2,9,0,32,774,32432774
4775,9,1799400,1,9,0,32,783,32432783
4776,0,1799400,1,9,0,32,783,32432783
4777,16,1799400,2,9,0,32,799,32432799
4778,10,1799400,2,9,0,32,809,32432809
4779,106,1799500,5,9,0,32,915,32432915
4780,579,1799400,1,9,0,33,494,32433494
4781,148,1799400,2,9,0,33,642,32433642
4782,47,1799500,1,9,0,33,689,32433689
4783,0,1799500,1,9,0,33,689,32433689
4784,5,1799500,1,9,0,33,694,32433694
4785,0,1799500,1,9,0,33,694,32433694
4786,4,1799400,3,9,0,33,698,32433698
4787,15,1799500,1,9,0,33,713,32433713
4788,32,1799400,2,9,0,33,745,32433745
4789,12,1799500,1,9,0,33,757,32433757
4790,22,1799400,1,9,0,33,779,32433779
4791,54,1799500,1,9,0,33,833,32433833
4792,168,1799300,11,9,0,34,1,32434001
4793,11,1799300,1,9,0,34,12,32434012
4794,51,1799200,2,9,0,34,63,32434063
4795,454,1799100,1,9,0,34,517,32434517
4796,129,1799200,1,9,0,34,646,32434646
4797,249,1799100,1,9,0,34,895,32434895
4798,51,1799200,1,9,0,34,946,32434946
4799,53,1799200,1,9,0,34,999,32434999
4800,344,1799200,1,9,0,35,343,32435343
4801,17,1799100,1,9,0,35,360,32435360
4802,146,1799100,1,9,0,35,506,32435506
4803,33,1799300,2,9,0,35,539,32435539
4804,16,1799300,1,9,0,35,555,32435555
4805,318,1799400,1,9,0,35,873,32435873
4806,249,1799400,1,9,0,36,122,32436122
4807,458,1799300,1,9,0,36,580,32436580
4808,163,1799500,1,9,0,36,743,32436743
4809,579,1799300,1,9,0,37,322,32437322
4810,10,1799400,1,9,0,37,332,32437332
4811,18,1799500,1,9,0,37,350,32437350
4812,1,1799500,1,9,0,37,351,32437351
4813,498,1799500,2,9,0,37,849,32437849
4814,53,1799500,3,9,0,37,902,32437902
4816,24,1799500,1,9,0,37,926,32437926
4817,357,1799500,1,9,0,38,283,32438283
4818,274,1799400,1,9,0,38,557,32438557
4819,1,1799400,1,9,0,38,558,32438558
4820,184,1799400,1,9,0,38,742,32438742
4821,122,1799400,1,9,0,38,864,32438864
4822,47,1799200,1,9,0,38,911,32438911
4823,28,1799200,2,9,0,38,939,32438939
4824,273,1799200,5,9,0,39,212,32439212
4826,571,1799300,1,9,0,39,783,32439783
4827,331,1799300,3,9,0,40,114,32440114
4828,235,1799100,1,9,0,40,349,32440349
4829,0,1799100,3,9,0,40,349,32440349
4830,0,1799100,2,9,0,40,349,32440349
4831,0,1799100,1,9,0,40,349,32440349
4832,0,1799100,1,9,0,40,349,32440349
4833,79,1799100,1,9,0,40,428,32440428
4834,39,1799100,1,9,0,40,467,32440467
4835,110,1799000,4,9,0,40,577,32440577
4836,6,1798900,12,9,0,40,583,32440583
4837,1,1798800,4,9,0,40,584,32440584
4838,0,1798800,3,9,0,40,584,32440584
4839,8,1798900,3,9,0,40,592,32440592
4841,89,1798800,1,9,0,40,681,32440681
4842,875,1798700,1,9,0,41,556,32441556
4843,0,1798600,1,9,0,41,556,32441556
4844,70,1798600,5,9,0,41,626,32441626
4845,0,1798600,5,9,0,41,626,32441626
4847,30,1798500,1,9,0,41,656,32441656
4848,39,1798500,1,9,0,41,695,32441695
4849,66,1798500,1,9,0,41,761,32441761
4850,473,1798400,1,9,0,42,234,32442234
4851,49,1798600,1,9,0,42,283,32442283
4852,388,1798600,3,9,0,42,671,32442671
4853,110,1798600,1,9,0,42,781,32442781
4854,7,1798600,2,9,0,42,788,32442788
4855,155,1798600,1,9,0,42,943,32442943
4856,58,1798600,1,9,0,43,1,32443001
4857,569,1798600,1,9,0,43,570,32443570
4858,8,1798700,1,9,0,43,578,32443578
4859,46,1798800,6,9,0,43,624,32443624
4860,318,1798800,1,9,0,43,942,32443942
4861,413,1798800,5,9,0,44,355,32444355
4862,609,1798800,2,9,0,44,964,32444964
4863,292,1799000,1,9,0,45,256,32445256
4864,383,1798800,1,9,0,45,639,32445639
4865,110,1798900,1,9,0,45,749,32445749
4866,625,1799000,1,9,0,46,374,32446374
4867,200,1799000,2,9,0,46,574,32446574
4868,0,1799000,3,9,0,46,574,32446574
4869,0,1799000,1,9,0,46,574,32446574
4870,378,1799100,1,9,0,46,952,32446952
4871,10,1799100,1,9,0,46,962,32446962
4872,5,1798900,1,9,0,46,967,32446967
4873,26,1799100,1,9,0,46,993,32446993
4874,122,1798900,1,9,0,47,115,32447115
4875,110,1799100,1,9,0,47,225,32447225
4876,1,1799100,1,9,0,47,226,32447226
4877,378,1799000,2,9,0,47,604,32447604
4878,500,1799100,3,9,0,48,104,32448104
4879,1,1799100,2,9,0,48,105,32448105
4880,666,1799100,1,9,0,48,771,32448771
4881,660,1799100,1,9,0,49,431,32449431
4882,1093,1799100,1,9,0,50,524,32450524
4883,200,1799200,4,9,0,50,724,32450724
4884,376,1799300,1,9,0,51,100,32451100
4885,37,1799300,5,9,0,51,137,32451137
4886,25,1799200,1,9,0,51,162,32451162
4887,253,1799400,1,9,0,51,415,32451415
4888,286,1799300,1,9,0,51,701,32451701
4889,1,1799300,1,9,0,51,702,32451702
4890,223,1799200,1,9,0,51,925,32451925
4891,702,1799300,2,9,0,52,627,32452627
4892,135,1799200,1,9,0,52,762,32452762
4893,0,1799200,5,9,0,52,762,32452762
4894,164,1799300,2,9,0,52,926,32452926
4895,810,1799300,1,9,0,53,736,32453736
4896,527,1799400,1,9,0,54,263,32454263
4897,0,1799400,1,9,0,54,263,32454263
4898,104,1799500,4,9,0,54,367,32454367
4899,0,1799500,4,9,0,54,367,32454367
4900,0,1799500,1,9,0,54,367,32454367
4901,0,1799500,3,9,0,54,367,32454367
4902,0,1799500,1,9,0,54,367,32454367
4903,0,1799500,12,9,0,54,367,32454367
4904,150,1799500,1,9,0,54,517,32454517
4905,291,1799600,2,9,0,54,808,32454808
4906,242,1799600,1,9,0,55,50,32455050
4907,225,1799500,2,9,0,55,275,32455275
4908,91,1799500,1,9,0,55,366,32455366
4909,73,1799300,1,9,0,55,439,32455439
4910,107,1799400,1,9,0,55,546,32455546
4911,32,1799500,1,9,0,55,578,32455578
4912,13,1799400,1,9,0,55,591,32455591
4913,43,1799400,3,9,0,55,634,32455634
4914,34,1799500,1,9,0,55,668,32455668
4915,86,1799600,8,9,0,55,754,32455754
4916,34,1799600,1,9,0,55,788,32455788
4917,154,1799700,1,9,0,55,942,32455942
4918,103,1799700,1,9,0,56,45,32456045
4919,74,1799600,2,9,0,56,119,32456119
4920,36,1799600,1,9,0,56,155,32456155
4921,187,1799700,3,9,0,56,342,32456342
4922,1,1799700,1,9,0,56,343,32456343
4923,79,1799800,1,9,0,56,422,32456422
4924,532,1799800,1,9,0,56,954,32456954
4925,0,1799800,5,9,0,56,954,32456954
4926,70,1799800,1,9,0,57,24,32457024
4927,77,1799800,1,9,0,57,101,32457101
4928,211,1799800,11,9,0,57,312,32457312
4929,376,1799900,1,9,0,57,688,32457688
4930,1,1799900,1,9,0,57,689,32457689
4931,67,1799900,1,9,0,57,756,32457756
4932,29,1799900,1,9,0,57,785,32457785
4933,296,1799900,4,9,0,58,81,32458081
4934,92,1799900,1,9,0,58,173,32458173
4935,302,1799800,1,9,0,58,475,32458475
4936,33,1799900,1,9,0,58,508,32458508
4937,37,1799900,1,9,0,58,545,32458545
4938,214,1799900,1,9,0,58,759,32458759
4939,10,1799900,1,9,0,58,769,32458769
4940,122,1799900,1,9,0,58,891,32458891
4941,0,1799900,1,9,0,58,891,32458891
4942,0,1799900,14,9,0,58,891,32458891
4943,1,1800000,2,9,0,58,892,32458892
4944,0,1800000,1,9,0,58,892,32458892
4945,0,1800000,5,9,0,58,892,32458892
4946,0,1800000,1,9,0,58,892,32458892
4947,0,1800000,2,9,0,58,892,32458892
4948,0,1800000,10,9,0,58,892,32458892
4949,1,1800000,1,9,0,58,893,32458893
4950,0,1800000,5,9,0,58,893,32458893
4951,0,1800000,1,9,0,58,893,32458893
4952,0,1800000,1,9,0,58,893,32458893
4953,0,1800000,1,9,0,58,893,32458893
4954,0,1800000,4,9,0,58,893,32458893
4955,0,1800000,1,9,0,58,893,32458893
4956,1,1800000,1,9,0,58,894,32458894
4957,0,1800000,1,9,0,58,894,32458894
4958,0,1800000,1,9,0,58,894,32458894
4959,102,1800000,1,9,0,58,996,32458996
4960,15,1800100,1,9,0,59,11,32459011
4961,15,1800100,2,9,0,59,26,32459026
4962,15,1800100,2,9,0,59,41,32459041
4963,21,1800100,1,9,0,59,62,32459062
4965,24,1800200,1,9,0,59,86,32459086
4966,12,1800200,3,9,0,59,98,32459098
4967,18,1800200,1,9,0,59,116,32459116
4968,9,1800100,1,9,0,59,125,32459125
4969,12,1800200,2,9,0,59,137,32459137
4970,4,1800200,1,9,0,59,141,32459141
4971,17,1800200,2,9,0,59,158,32459158
4972,16,1800200,2,9,0,59,174,32459174
4974,5,1800300,1,9,0,59,179,32459179
4975,51,1800300,1,9,0,59,230,32459230
4976,57,1800200,1,9,0,59,287,32459287
4977,7,1800100,1,9,0,59,294,32459294
4978,7,1800300,1,9,0,59,301,32459301
4979,11,1800100,1,9,0,59,312,32459312
4980,39,1800200,1,9,0,59,351,32459351
4981,2,1800300,1,9,0,59,353,32459353
4982,8,1800300,1,9,0,59,361,32459361
4983,51,1800300,2,9,0,59,412,32459412
4984,3,1800400,1,9,0,59,415,32459415
4985,1,1800300,2,9,0,59,416,32459416
4986,2,1800300,1,9,0,59,418,32459418
4987,9,1800400,1,9,0,59,427,32459427
4988,19,1800400,4,9,0,59,446,32459446
4989,0,1800400,2,9,0,59,446,32459446
4990,2,1800400,1,9,0,59,448,32459448
4991,0,1800400,1,9,0,59,448,32459448
4992,69,1800300,1,9,0,59,517,32459517
4993,2,1800300,1,9,0,59,519,32459519
4994,113,1800400,1,9,0,59,632,32459632
4995,13,1800500,1,9,0,59,645,32459645
4996,1,1800500,1,9,0,59,646,32459646
4997,13,1800500,1,9,0,59,659,32459659
4998,88,1800400,1,9,0,59,747,32459747
4999,9,1800400,1,9,0,59,756,32459756
5000,2,1800200,1,9,0,59,758,32459758
5001,1,1800200,1,9,0,59,759,32459759
5002,4,1800400,1,9,0,59,763,32459763
5003,4,1800400,6,9,0,59,767,32459767
5005,2,1800500,1,9,0,59,769,32459769
5006,8,1800400,1,9,0,59,777,32459777
5007,2,1800400,1,9,0,59,779,32459779
5008,0,1800500,1,9,0,59,779,32459779
5009,18,1800300,1,9,0,59,797,32459797
5010,4,1800500,2,9,0,59,801,32459801
5011,29,1800500,1,9,0,59,830,32459830
5012,50,1800400,1,9,0,59,880,32459880
5013,28,1800500,1,9,0,59,908,32459908
5014,75,1800400,1,9,0,59,983,32459983
5015,17,1800500,1,9,1,0,0,32460000
5016,101,1800500,1,9,1,0,101,32460101
5017,0,1800500,2,9,1,0,101,32460101
5018,0,1800500,1,9,1,0,101,32460101
5019,1,1800600,1,9,1,0,102,32460102
5020,0,1800600,2,9,1,0,102,32460102
5021,0,1800600,1,9,1,0,102,32460102
5022,1,1800600,1,9,1,0,103,32460103
5023,0,1800600,1,9,1,0,103,32460103
5024,6,1800400,3,9,1,0,109,32460109
5026,11,1800500,1,9,1,0,120,32460120
5027,34,1800500,1,9,1,0,154,32460154
5028,22,1800500,1,9,1,0,176,32460176
5029,57,1800500,7,9,1,0,233,32460233
5031,38,1800600,1,9,1,0,271,32460271
5032,10,1800600,1,9,1,0,281,32460281
5033,10,1800500,1,9,1,0,291,32460291
5034,2,1800600,2,9,1,0,293,32460293
5035,9,1800400,1,9,1,0,302,32460302
5036,5,1800400,1,9,1,0,307,32460307
5037,21,1800400,1,9,1,0,328,32460328
5038,1,1800600,3,9,1,0,329,32460329
5039,48,1800500,1,9,1,0,377,32460377
5040,5,1800500,1,9,1,0,382,32460382
5041,1,1800400,2,9,1,0,383,32460383
5043,37,1800400,1,9,1,0,420,32460420
5044,3,1800400,4,9,1,0,423,32460423
5045,37,1800500,1,9,1,0,460,32460460
5046,21,1800500,1,9,1,0,481,32460481
5047,44,1800400,1,9,1,0,525,32460525
5048,22,1800400,2,9,1,0,547,32460547
5049,8,1800200,1,9,1,0,555,32460555
5050,35,1800400,1,9,1,0,590,32460590
5051,4,1800400,1,9,1,0,594,32460594
5052,26,1800400,1,9,1,0,620,32460620
5053,1,1800200,5,9,1,0,621,32460621
5054,6,1800300,1,9,1,0,627,32460627
5056,73,1800300,1,9,1,0,700,32460700
5057,9,1800400,1,9,1,0,709,32460709
5058,1,1800400,4,9,1,0,710,32460710
5059,4,1800500,4,9,1,0,714,32460714
5060,53,1800500,2,9,1,0,767,32460767
5061,34,1800500,1,9,1,0,801,32460801
5062,0,1800500,1,9,1,0,801,32460801
5063,19,1800600,4,9,1,0,820,32460820
5064,43,1800600,1,9,1,0,863,32460863
5065,7,1800700,2,9,1,0,870,32460870
5066,8,1800700,1,9,1,0,878,32460878
5067,26,1800700,1,9,1,0,904,32460904
5068,2,1800700,1,9,1,0,906,32460906
5070,33,1800600,1,9,1,0,939,32460939
5071,62,1800600,1,9,1,1,1,32461001
5072,26,1800600,1,9,1,1,27,32461027
5073,14,1800600,1,9,1,1,41,32461041
5075,8,1800700,2,9,1,1,49,32461049
5076,119,1800700,1,9,1,1,168,32461168
5077,0,1800700,1,9,1,1,168,32461168
5078,73,1800800,1,9,1,1,241,32461241
5079,76,1800800,1,9,1,1,317,32461317
5080,11,1800700,1,9,1,1,328,32461328
5081,12,1800600,1,9,1,1,340,32461340
5082,20,1800800,3,9,1,1,360,32461360
5083,24,1800800,5,9,1,1,384,32461384
5084,69,1800800,2,9,1,1,453,32461453
5085,81,1800700,4,9,1,1,534,32461534
5086,51,1800500,1,9,1,1,585,32461585
5087,35,1800300,1,9,1,1,620,32461620
5088,21,1800400,1,9,1,1,641,32461641
5089,60,1800400,3,9,1,1,701,32461701
5091,1,1800300,2,9,1,1,702,32461702
5092,46,1800400,2,9,1,1,748,32461748
5093,29,1800300,2,9,1,1,777,32461777
5094,169,1800500,2,9,1,1,946,32461946
5095,50,1800500,1,9,1,1,996,32461996
5096,7,1800300,1,9,1,2,3,32462003
5097,67,1800500,2,9,1,2,70,32462070
5099,13,1800700,1,9,1,2,83,32462083
5100,114,1800500,1,9,1,2,197,32462197
5101,21,1800700,1,9,1,2,218,32462218
5102,24,1800500,1,9,1,2,242,32462242
5103,127,1800500,2,9,1,2,369,32462369
5104,189,1800300,1,9,1,2,558,32462558
5105,10,1800300,2,9,1,2,568,32462568
5106,121,1800400,1,9,1,2,689,32462689
5107,160,1800400,1,9,1,2,849,32462849
5108,143,1800200,1,9,1,2,992,32462992
5109,76,1800200,1,9,1,3,68,32463068
5110,57,1800300,3,9,1,3,125,32463125
5111,41,1800200,3,9,1,3,166,32463166
5112,312,1800300,1,9,1,3,478,32463478
5113,0,1800300,1,9,1,3,478,32463478
5114,0,1800300,1,9,1,3,478,32463478
5115,1,1800300,1,9,1,3,479,32463479
5116,0,1800300,1,9,1,3,479,32463479
5117,2,1800300,1,9,1,3,481,32463481
5118,62,1800300,1,9,1,3,543,32463543
5119,50,1800300,1,9,1,3,593,32463593
5120,1,1800300,4,9,1,3,594,32463594
5121,12,1800200,3,9,1,3,606,32463606
5122,161,1800300,1,9,1,3,767,32463767
5123,54,1800400,1,9,1,3,821,32463821
5124,172,1800400,1,9,1,3,993,32463993
5125,6,1800300,3,9,1,3,999,32463999
5126,88,1800400,1,9,1,4,87,32464087
5127,91,1800200,1,9,1,4,178,32464178
5128,24,1800100,1,9,1,4,202,32464202
5129,89,1800200,1,9,1,4,291,32464291
5130,48,1800300,1,9,1,4,339,32464339
5131,136,1800200,1,9,1,4,475,32464475
5132,369,1800300,1,9,1,4,844,32464844
5133,121,1800300,1,9,1,4,965,32464965
5134,223,1800200,3,9,1,5,188,32465188
5135,186,1800300,1,9,1,5,374,32465374
5136,238,1800200,2,9,1,5,612,32465612
5137,239,1800200,2,9,1,5,851,32465851
5138,182,1800200,1,9,1,6,33,32466033
5139,448,1800200,1,9,1,6,481,32466481
5141,35,1800100,2,9,1,6,516,32466516
5142,76,1800100,1,9,1,6,592,32466592
5143,148,1800100,1,9,1,6,740,32466740
5144,66,1800200,1,9,1,6,806,32466806
5145,21,1800100,2,9,1,6,827,32466827
5146,42,1800100,2,9,1,6,869,32466869
5147,105,1800000,1,9,1,6,974,32466974
5148,387,1800100,1,9,1,7,361,32467361
5150,25,1800100,2,9,1,7,386,32467386
5152,89,1800200,1,9,1,7,475,32467475
5153,0,1800200,1,9,1,7,475,32467475
5154,0,1800200,1,9,1,7,475,32467475
5155,1,1800200,1,9,1,7,476,32467476
5156,102,1800000,3,9,1,7,578,32467578
5157,106,1800200,4,9,1,7,684,32467684
5158,170,1800100,1,9,1,7,854,32467854
5159,33,1800200,1,9,1,7,887,32467887
5160,118,1800100,1,9,1,8,5,32468005
5161,64,1800000,2,9,1,8,69,32468069
5162,56,1800100,1,9,1,8,125,32468125
5163,86,1800100,1,9,1,8,211,32468211
5164,92,1799900,1,9,1,8,303,32468303
5166,55,1800000,1,9,1,8,358,32468358
5167,0,1800000,1,9,1,8,358,32468358
5168,57,1799800,1,9,1,8,415,32468415
5169,184,1799900,1,9,1,8,599,32468599
5170,103,1799800,1,9,1,8,702,32468702
5171,69,1799800,1,9,1,8,771,32468771
5172,0,1799800,1,9,1,8,771,32468771
5173,8,1799900,1,9,1,8,779,32468779
5174,91,1799800,1,9,1,8,870,32468870
5175,130,1799800,1,9,1,9,0,32469000
5176,277,1799700,1,9,1,9,277,32469277
5177,19,1799700,4,9,1,9,296,32469296
5178,10,1799600,2,9,1,9,306,32469306
5179,1,1799600,1,9,1,9,307,32469307
5180,0,1799600,2,9,1,9,307,32469307
5181,4,1799500,2,9,1,9,311,32469311
5182,0,1799600,1,9,1,9,311,32469311
5183,2,1799500,1,9,1,9,313,32469313
5184,152,1799500,1,9,1,9,465,32469465
5185,82,1799500,1,9,1,9,547,32469547
5186,30,1799400,1,9,1,9,577,32469577
5187,7,1799500,3,9,1,9,584,32469584
5188,106,1799500,1,9,1,9,690,32469690
5189,180,1799400,2,9,1,9,870,32469870
5190,46,1799400,1,9,1,9,916,32469916
5191,109,1799400,1,9,1,10,25,32470025
5192,299,1799300,1,9,1,10,324,32470324
5193,180,1799500,1,9,1,10,504,32470504
5194,100,1799500,11,9,1,10,604,32470604
5195,140,1799600,1,9,1,10,744,32470744
5196,195,1799600,1,9,1,10,939,32470939
5198,1,1799600,1,9,1,10,940,32470940
5199,637,1799700,1,9,1,11,577,32471577
5200,200,1799600,1,9,1,11,777,32471777
5201,106,1799600,2,9,1,11,883,32471883
5202,61,1799500,1,9,1,11,944,32471944
5203,145,1799500,2,9,1,12,89,32472089
5204,312,1799500,1,9,1,12,401,32472401
5205,59,1799600,1,9,1,12,460,32472460
5206,149,1799600,2,9,1,12,609,32472609
5208,382,1799500,2,9,1,12,991,32472991
5209,58,1799400,1,9,1,13,49,32473049
5210,118,1799600,3,9,1,13,167,32473167
5212,173,1799600,1,9,1,13,340,32473340
5213,14,1799500,2,9,1,13,354,32473354
5215,64,1799500,1,9,1,13,418,32473418
5216,72,1799400,3,9,1,13,490,32473490
5217,190,1799400,1,9,1,13,680,32473680
5218,547,1799400,3,9,1,14,227,32474227
5219,335,1799500,1,9,1,14,562,32474562
5220,200,1799600,1,9,1,14,762,32474762
5221,12,1799500,1,9,1,14,774,32474774
5222,52,1799400,4,9,1,14,826,32474826
5223,1,1799300,6,9,1,14,827,32474827
5224,0,1799300,1,9,1,14,827,32474827
5225,1,1799300,3,9,1,14,828,32474828
5226,0,1799300,1,9,1,14,828,32474828
5227,1,1799200,1,9,1,14,829,32474829
5228,1,1799200,3,9,1,14,830,32474830
5229,0,1799200,1,9,1,14,830,32474830
5230,11,1799100,3,9,1,14,841,32474841
5231,11,1799200,1,9,1,14,852,32474852
5232,41,1799100,1,9,1,14,893,32474893
5233,4,1799200,1,9,1,14,897,32474897
5234,37,1799300,1,9,1,14,934,32474934
5235,80,1799300,1,9,1,15,14,32475014
5236,9,1799300,1,9,1,15,23,32475023
5237,1,1799300,1,9,1,15,24,32475024
5238,136,1799300,1,9,1,15,160,32475160
5239,49,1799400,1,9,1,15,209,32475209
5240,302,1799300,1,9,1,15,511,32475511
5241,325,1799500,1,9,1,15,836,32475836
5242,92,1799400,1,9,1,15,928,32475928
5243,95,1799400,1,9,1,16,23,32476023
5244,0,1799400,1,9,1,16,23,32476023
5246,2,1799600,1,9,1,16,25,32476025
5247,87,1799500,2,9,1,16,112,32476112
5249,181,1799600,1,9,1,16,293,32476293
5250,126,1799500,1,9,1,16,419,32476419
5251,577,1799400,1,9,1,16,996,32476996
5252,498,1799300,1,9,1,17,494,32477494
5253,107,1799400,1,9,1,17,601,32477601
5254,0,1799500,1,9,1,17,601,32477601
5255,240,1799400,1,9,1,17,841,32477841
5256,532,1799300,1,9,1,18,373,32478373
5257,187,1799300,1,9,1,18,560,32478560
5258,67,1799300,1,9,1,18,627,32478627
5259,61,1799300,2,9,1,18,688,32478688
5260,38,1799400,6,9,1,18,726,32478726
5261,303,1799500,3,9,1,19,29,32479029
5262,206,1799400,2,9,1,19,235,32479235
5263,178,1799200,1,9,1,19,413,32479413
5264,33,1799200,6,9,1,19,446,32479446
5265,188,1799400,1,9,1,19,634,32479634
5266,423,1799300,2,9,1,20,57,32480057
5268,1,1799200,1,9,1,20,58,32480058
5269,135,1799100,8,9,1,20,193,32480193
5271,3,1799000,1,9,1,20,196,32480196
5272,1,1799000,33,9,1,20,197,32480197
5273,5,1799000,1,9,1,20,202,32480202
5275,211,1799000,2,9,1,20,413,32480413
5276,19,1799100,1,9,1,20,432,32480432
5277,88,1798900,3,9,1,20,520,32480520
5278,133,1799000,5,9,1,20,653,32480653
5279,178,1799100,1,9,1,20,831,32480831
5280,110,1798900,1,9,1,20,941,32480941
5281,4,1799000,1,9,1,20,945,32480945
5282,127,1799000,1,9,1,21,72,32481072
5283,90,1798900,1,9,1,21,162,32481162
5284,83,1799000,1,9,1,21,245,32481245
5285,152,1798900,3,9,1,21,397,32481397
5286,247,1799000,1,9,1,21,644,32481644
5287,36,1799000,3,9,1,21,680,32481680
5288,28,1798900,1,9,1,21,708,32481708
5289,154,1799000,3,9,1,21,862,32481862
5290,428,1799000,2,9,1,22,290,32482290
5291,0,1799000,2,9,1,22,290,32482290
5293,308,1798900,1,9,1,22,598,32482598
5294,27,1798900,1,9,1,22,625,32482625
5295,133,1798900,1,9,1,22,758,32482758
5296,543,1799000,1,9,1,23,301,32483301
5297,5,1799000,1,9,1,23,306,32483306
5298,16,1799000,1,9,1,23,322,32483322
5299,14,1799000,1,9,1,23,336,32483336
5300,18,1799000,4,9,1,23,354,32483354
5301,2,1799000,6,9,1,23,356,32483356
5302,54,1798900,1,9,1,23,410,32483410
5303,315,1799100,1,9,1,23,725,32483725
5304,186,1799100,1,9,1,23,911,32483911
5305,601,1799200,1,9,1,24,512,32484512
5307,254,1799200,2,9,1,24,766,32484766
5308,141,1799100,1,9,1,24,907,32484907
5309,150,1799200,1,9,1,25,57,32485057
5310,900,1799100,2,9,1,25,957,32485957
5311,10,1799000,5,9,1,25,967,32485967
5312,34,1799000,2,9,1,26,1,32486001
5313,46,1798900,3,9,1,26,47,32486047
5314,56,1798800,8,9,1,26,103,32486103
5315,1,1798700,3,9,1,26,104,32486104
5316,85,1798600,1,9,1,26,189,32486189
5317,23,1798500,1,9,1,26,212,32486212
5318,84,1798800,1,9,1,26,296,32486296
5319,43,1798800,1,9,1,26,339,32486339
5320,77,1798600,3,9,1,26,416,32486416
5321,73,1798800,1,9,1,26,489,32486489
5322,49,1798600,1,9,1,26,538,32486538
5323,13,1798600,1,9,1,26,551,32486551
5324,70,1798600,1,9,1,26,621,32486621
5325,177,1798800,1,9,1,26,798,32486798
5326,84,1798800,1,9,1,26,882,32486882
5327,75,1798800,1,9,1,26,957,32486957
5328,141,1798900,1,9,1,27,98,32487098
5329,44,1798700,1,9,1,27,142,32487142
5330,83,1798800,1,9,1,27,225,32487225
5331,0,1798800,1,9,1,27,225,32487225
5332,0,1798800,1,9,1,27,225,32487225
5333,0,1798800,1,9,1,27,225,32487225
5334,0,1798900,1,9,1,27,225,32487225
5335,0,1798900,1,9,1,27,225,32487225
5336,0,1798900,1,9,1,27,225,32487225
5337,0,1798900,1,9,1,27,225,32487225
5338,1,1798900,1,9,1,27,226,32487226
5339,0,1798900,1,9,1,27,226,32487226
5340,1,1799000,1,9,1,27,227,32487227
5341,0,1799000,1,9,1,27,227,32487227
5342,12,1798900,1,9,1,27,239,32487239
5343,132,1798800,4,9,1,27,371,32487371
5345,463,1798700,1,9,1,27,834,32487834
5346,487,1798700,1,9,1,28,321,32488321
5347,76,1798800,1,9,1,28,397,32488397
5348,46,1798600,5,9,1,28,443,32488443
5349,0,1798600,5,9,1,28,443,32488443
5351,111,1798400,1,9,1,28,554,32488554
5352,105,1798500,1,9,1,28,659,32488659
5353,20,1798300,2,9,1,28,679,32488679
5354,91,1798400,1,9,1,28,770,32488770
5355,156,1798400,3,9,1,28,926,32488926
5356,291,1798500,4,9,1,29,217,32489217
5358,261,1798300,1,9,1,29,478,32489478
5359,186,1798500,1,9,1,29,664,32489664
5360,304,1798500,1,9,1,29,968,32489968
5361,73,1798400,2,9,1,30,41,32490041
5362,98,1798500,3,9,1,30,139,32490139
5363,60,1798500,1,9,1,30,199,32490199
5364,118,1798500,1,9,1,30,317,32490317
5365,40,1798600,1,9,1,30,357,32490357
5366,482,1798600,1,9,1,30,839,32490839
5368,305,1798700,1,9,1,31,144,32491144
5369,65,1798700,1,9,1,31,209,32491209
5370,184,1798600,3,9,1,31,393,32491393
5371,644,1798800,1,9,1,32,37,32492037
5372,164,1798600,1,9,1,32,201,32492201
5373,59,1798700,2,9,1,32,260,32492260
5374,255,1798800,3,9,1,32,515,32492515
5375,744,1798800,1,9,1,33,259,32493259
5376,59,1798700,1,9,1,33,318,32493318
5377,79,1798900,1,9,1,33,397,32493397
5378,153,1798700,1,9,1,33,550,32493550
5379,483,1798700,8,9,1,34,33,32494033
5380,1,1798600,1,9,1,34,34,32494034
5381,2,1798600,1,9,1,34,36,32494036
5382,343,1798800,1,9,1,34,379,32494379
5383,809,1798800,1,9,1,35,188,32495188
5384,112,1798600,2,9,1,35,300,32495300
5385,0,1798600,2,9,1,35,300,32495300
5386,55,1798700,1,9,1,35,355,32495355
5387,179,1798600,1,9,1,35,534,32495534
5388,12,1798700,1,9,1,35,546,32495546
5389,306,1798700,1,9,1,35,852,32495852
5390,1,1798700,3,9,1,35,853,32495853
5391,327,1798700,2,9,1,36,180,32496180
5392,378,1798600,1,9,1,36,558,32496558
5394,115,1798600,2,9,1,36,673,32496673
5395,734,1798700,1,9,1,37,407,32497407
5396,68,1798700,1,9,1,37,475,32497475
5397,146,1798500,5,9,1,37,621,32497621
5398,230,1798700,2,9,1,37,851,32497851
5399,998,1798800,1,9,1,38,849,32498849
5400,1,1798800,2,9,1,38,850,32498850
5401,209,1798900,2,9,1,39,59,32499059
5402,51,1798900,1,9,1,39,110,32499110
5404,205,1799000,1,9,1,39,315,32499315
5405,13,1799100,3,9,1,39,328,32499328
5406,28,1799000,3,9,1,39,356,32499356
5407,79,1799000,1,9,1,39,435,32499435
5408,282,1799100,1,9,1,39,717,32499717
5409,28,1799000,1,9,1,39,745,32499745
5410,107,1798900,2,9,1,39,852,32499852
5411,54,1799000,1,9,1,39,906,32499906
5412,275,1799000,1,9,1,40,181,32500181
5413,255,1798800,3,9,1,40,436,32500436
5414,93,1798900,1,9,1,40,529,32500529
5415,533,1798700,4,9,1,41,62,32501062
5417,390,1798600,6,9,1,41,452,32501452
5419,3,1798500,45,9,1,41,455,32501455
5420,85,1798600,1,9,1,41,540,32501540
5421,863,1798400,3,9,1,42,403,32502403
5422,104,1798300,7,9,1,42,507,32502507
5423,1,1798200,2,9,1,42,508,32502508
5424,0,1798200,2,9,1,42,508,32502508
5425,18,1798300,3,9,1,42,526,32502526
5427,19,1798400,1,9,1,42,545,32502545
5428,166,1798200,1,9,1,42,711,32502711
5429,283,1798300,1,9,1,42,994,32502994
5430,253,1798200,1,9,1,43,247,32503247
5431,83,1798300,1,9,1,43,330,32503330
5432,154,1798300,4,9,1,43,484,32503484
5433,326,1798500,1,9,1,43,810,32503810
5434,60,1798400,1,9,1,43,870,32503870
5435,277,1798600,1,9,1,44,147,32504147
5436,96,1798400,1,9,1,44,243,32504243
5437,16,1798500,1,9,1,44,259,32504259
5438,232,1798500,1,9,1,44,491,32504491
5439,140,1798400,2,9,1,44,631,32504631
5440,285,1798500,1,9,1,44,916,32504916
5442,248,1798600,1,9,1,45,164,32505164
5443,482,1798600,1,9,1,45,646,32505646
5444,25,1798700,5,9,1,45,671,32505671
5445,10,1798800,1,9,1,45,681,32505681
5446,1209,1798800,2,9,1,46,890,32506890
5447,51,1798700,1,9,1,46,941,32506941
5448,207,1798800,1,9,1,47,148,32507148
5449,9,1798800,1,9,1,47,157,32507157
5450,69,1798900,1,9,1,47,226,32507226
5451,689,1798600,1,9,1,47,915,32507915
5452,835,1798700,3,9,1,48,750,32508750
5454,6,1798800,4,9,1,48,756,32508756
5456,635,1798900,1,9,1,49,391,32509391
5457,717,1798800,1,9,1,50,108,32510108
5459,302,1798700,1,9,1,50,410,32510410
5460,336,1798900,2,9,1,50,746,32510746
5461,0,1798900,1,9,1,50,746,32510746
5462,0,1798900,1,9,1,50,746,32510746
5463,204,1798800,1,9,1,50,950,32510950
5464,62,1798800,2,9,1,51,12,32511012
5465,768,1799000,2,9,1,51,780,32511780
5466,957,1799000,2,9,1,52,737,32512737
5467,250,1799000,2,9,1,52,987,32512987
5468,341,1799100,1,9,1,53,328,32513328
5469,0,1799100,1,9,1,53,328,32513328
5470,0,1799100,1,9,1,53,328,32513328
5471,0,1799100,1,9,1,53,328,32513328
5472,1,1799100,1,9,1,53,329,32513329
5473,39,1799100,1,9,1,53,368,32513368
5474,45,1799000,1,9,1,53,413,32513413
5475,385,1799100,1,9,1,53,798,32513798
5477,26,1799200,1,9,1,53,824,32513824
5478,644,1799200,1,9,1,54,468,32514468
5479,1251,1799200,2,9,1,55,719,32515719
5480,1,1799200,2,9,1,55,720,32515720
5481,312,1799300,3,9,1,56,32,32516032
5482,48,1799300,1,9,1,56,80,32516080
5483,958,1799500,1,9,1,57,38,32517038
5484,130,1799400,1,9,1,57,168,32517168
5485,72,1799400,1,9,1,57,240,32517240
5486,106,1799500,1,9,1,57,346,32517346
5487,206,1799400,1,9,1,57,552,32517552
5488,78,1799400,1,9,1,57,630,32517630
5489,0,1799300,1,9,1,57,630,32517630
5490,316,1799400,1,9,1,57,946,32517946
5491,1163,1799400,1,9,1,59,109,32519109
5492,223,1799400,1,9,1,59,332,32519332
5493,1047,1799500,3,9,2,0,379,32520379
5494,97,1799500,1,9,2,0,476,32520476
5495,0,1799600,3,9,2,0,476,32520476
5496,1,1799600,1,9,2,0,477,32520477
5497,77,1799600,2,9,2,0,554,32520554
5498,0,1799600,2,9,2,0,554,32520554
5500,186,1799500,3,9,2,0,740,32520740
5501,510,1799500,1,9,2,1,250,32521250
5502,36,1799400,7,9,2,1,286,32521286
5504,5,1799600,1,9,2,1,291,32521291
5505,59,1799600,1,9,2,1,350,32521350
5506,0,1799600,1,9,2,1,350,32521350
5507,1002,1799700,2,9,2,2,352,32522352
5508,100,1799500,1,9,2,2,452,32522452
5509,248,1799500,2,9,2,2,700,32522700
5511,260,1799500,1,9,2,2,960,32522960
5512,8,1799500,1,9,2,2,968,32522968
5513,465,1799400,5,9,2,3,433,32523433
5514,195,1799300,1,9,2,3,628,32523628
5515,142,1799400,1,9,2,3,770,32523770
5516,1134,1799400,1,9,2,4,904,32524904
5517,1,1799400,1,9,2,4,905,32524905
5518,321,1799300,1,9,2,5,226,32525226
5519,1,1799300,4,9,2,5,227,32525227
5520,414,1799200,1,9,2,5,641,32525641
5521,55,1799200,1,9,2,5,696,32525696
5522,548,1799300,1,9,2,6,244,32526244
5523,124,1799300,1,9,2,6,368,32526368
5524,495,1799400,1,9,2,6,863,32526863
5525,142,1799300,1,9,2,7,5,32527005
5526,22,1799300,1,9,2,7,27,32527027
5527,67,1799400,1,9,2,7,94,32527094
5528,6,1799400,1,9,2,7,100,32527100
5529,1,1799400,1,9,2,7,101,32527101
5530,1,1799400,1,9,2,7,102,32527102
5531,342,1799500,4,9,2,7,444,32527444
5532,1,1799500,2,9,2,7,445,32527445
5533,390,1799400,1,9,2,7,835,32527835
5534,76,1799400,1,9,2,7,911,32527911
5535,81,1799300,3,9,2,7,992,32527992
5536,0,1799300,1,9,2,7,992,32527992
5537,0,1799300,2,9,2,7,992,32527992
5538,27,1799300,1,9,2,8,19,32528019
5539,107,1799200,2,9,2,8,126,32528126
5540,107,1799100,1,9,2,8,233,32528233
5541,1031,1799100,1,9,2,9,264,32529264
5542,307,1799100,1,9,2,9,571,32529571
5543,0,1799100,1,9,2,9,571,32529571
5544,200,1799200,1,9,2,9,771,32529771
5545,22,1799200,5,9,2,9,793,32529793
5546,1124,1799300,4,9,2,10,917,32530917
5547,562,1799400,1,9,2,11,479,32531479
5548,263,1799400,3,9,2,11,742,32531742
5549,191,1799400,1,9,2,11,933,32531933
5550,11,1799300,1,9,2,11,944,32531944
5551,134,1799300,1,9,2,12,78,32532078
5553,812,1799200,1,9,2,12,890,32532890
5554,202,1799200,3,9,2,13,92,32533092
5555,938,1799200,1,9,2,14,30,32534030
5556,1492,1799300,1,9,2,15,522,32535522
5557,446,1799400,1,9,2,15,968,32535968
5558,0,1799400,1,9,2,15,968,32535968
5559,3,1799400,1,9,2,15,971,32535971
5560,557,1799300,1,9,2,16,528,32536528
5561,225,1799400,1,9,2,16,753,32536753
5562,364,1799500,1,9,2,17,117,32537117
5563,807,1799300,1,9,2,17,924,32537924
5564,623,1799200,2,9,2,18,547,32538547
5565,2,1799100,4,9,2,18,549,32538549
5566,0,1799100,1,9,2,18,549,32538549
5567,1,1799100,1,9,2,18,550,32538550
5568,0,1799000,4,9,2,18,550,32538550
5569,1,1799000,6,9,2,18,551,32538551
5570,21,1799100,1,9,2,18,572,32538572
5571,53,1798900,1,9,2,18,625,32538625
5572,6,1798900,2,9,2,18,631,32538631
5573,41,1799000,1,9,2,18,672,32538672
5574,30,1798900,1,9,2,18,702,32538702
5575,114,1799000,1,9,2,18,816,32538816
5576,8,1798900,1,9,2,18,824,32538824
5577,291,1799000,2,9,2,19,115,32539115
5578,449,1798900,1,9,2,19,564,32539564
5579,88,1799200,2,9,2,19,652,32539652
5580,89,1799200,1,9,2,19,741,32539741
5581,486,1799100,1,9,2,20,227,32540227
5582,12,1799100,1,9,2,20,239,32540239
5583,233,1798900,1,9,2,20,472,32540472
5584,19,1798900,1,9,2,20,491,32540491
5585,32,1798900,1,9,2,20,523,32540523
5586,685,1799000,1,9,2,21,208,32541208
5587,146,1799000,1,9,2,21,354,32541354
5588,17,1798800,1,9,2,21,371,32541371
5589,20,1798800,1,9,2,21,391,32541391
5590,742,1799000,1,9,2,22,133,32542133
5591,162,1798800,1,9,2,22,295,32542295
5592,95,1798900,1,9,2,22,390,32542390
5593,109,1798800,1,9,2,22,499,32542499
5594,5,1798800,3,9,2,22,504,32542504
5595,604,1799000,1,9,2,23,108,32543108
5596,0,1799000,1,9,2,23,108,32543108
5597,3,1798900,1,9,2,23,111,32543111
5598,450,1799200,2,9,2,23,561,32543561
5599,472,1799100,1,9,2,24,33,32544033
5600,692,1799200,1,9,2,24,725,32544725
5602,569,1799000,3,9,2,25,294,32545294
5603,0,1799000,3,9,2,25,294,32545294
5604,0,1799000,3,9,2,25,294,32545294
5605,0,1799000,3,9,2,25,294,32545294
5607,4,1798700,1,9,2,25,298,32545298
5608,2,1798800,1,9,2,25,300,32545300
5609,402,1798800,2,9,2,25,702,32545702
5610,1,1798800,2,9,2,25,703,32545703
5611,0,1798800,3,9,2,25,703,32545703
5612,251,1799100,1,9,2,25,954,32545954
5613,26,1798900,1,9,2,25,980,32545980
5614,308,1799000,1,9,2,26,288,32546288
5615,459,1798900,1,9,2,26,747,32546747
5616,98,1799000,7,9,2,26,845,32546845
5617,761,1799100,2,9,2,27,606,32547606
5618,1,1799100,1,9,2,27,607,32547607
5619,119,1799200,1,9,2,27,726,32547726
5620,314,1799300,4,9,2,28,40,32548040
5621,306,1799200,1,9,2,28,346,32548346
5622,54,1799100,1,9,2,28,400,32548400
5623,23,1799100,1,9,2,28,423,32548423
5624,148,1799100,1,9,2,28,571,32548571
5625,620,1799000,1,9,2,29,191,32549191
5626,13,1799000,1,9,2,29,204,32549204
5627,59,1799000,1,9,2,29,263,32549263
5628,40,1798900,1,9,2,29,303,32549303
5629,406,1798900,2,9,2,29,709,32549709
5630,157,1798800,1,9,2,29,866,32549866
5631,227,1798900,1,9,2,30,93,32550093
5632,0,1798900,1,9,2,30,93,32550093
5634,91,1798900,8,9,2,30,184,32550184
5635,0,1798900,8,9,2,30,184,32550184
5636,0,1798900,8,9,2,30,184,32550184
5637,0,1798900,8,9,2,30,184,32550184
5639,6,1798700,2,9,2,30,190,32550190
5640,12,1798800,1,9,2,30,202,32550202
5641,16,1798700,2,9,2,30,218,32550218
5643,9,1798600,1,9,2,30,227,32550227
5644,0,1798600,1,9,2,30,227,32550227
5645,0,1798600,1,9,2,30,227,32550227
5646,6,1798500,1,9,2,30,233,32550233
5647,61,1798600,1,9,2,30,294,32550294
5648,0,1798500,4,9,2,30,294,32550294
5649,0,1798500,3,9,2,30,294,32550294
5650,17,1798600,1,9,2,30,311,32550311
5651,38,1798700,1,9,2,30,349,32550349
5652,91,1798700,1,9,2,30,440,32550440
5653,261,1798700,1,9,2,30,701,32550701
5654,145,1798600,5,9,2,30,846,32550846
5655,13,1798600,1,9,2,30,859,32550859
5656,18,1798600,5,9,2,30,877,32550877
5657,3,1798500,4,9,2,30,880,32550880
5658,0,1798500,1,9,2,30,880,32550880
5659,1,1798500,1,9,2,30,881,32550881
5660,1,1798400,1,9,2,30,882,32550882
5661,0,1798400,1,9,2,30,882,32550882
5662,30,1798600,6,9,2,30,912,32550912
5664,78,1798400,2,9,2,30,990,32550990
5665,264,1798400,1,9,2,31,254,32551254
5666,78,1798500,1,9,2,31,332,32551332
5667,32,1798600,3,9,2,31,364,32551364
5669,53,1798600,1,9,2,31,417,32551417
5670,40,1798800,7,9,2,31,457,32551457
5672,42,1798700,1,9,2,31,499,32551499
5673,7,1798600,1,9,2,31,506,32551506
5674,25,1798800,1,9,2,31,531,32551531
5675,45,1798700,1,9,2,31,576,32551576
5676,57,1798800,1,9,2,31,633,32551633
5678,106,1798600,1,9,2,31,739,32551739
5679,126,1798500,1,9,2,31,865,32551865
5680,124,1798600,1,9,2,31,989,32551989
5681,198,1798400,7,9,2,32,187,32552187
5682,65,1798300,1,9,2,32,252,32552252
5683,19,1798300,1,9,2,32,271,32552271
5684,33,1798300,1,9,2,32,304,32552304
5685,44,1798300,1,9,2,32,348,32552348
5686,27,1798300,1,9,2,32,375,32552375
5687,57,1798400,1,9,2,32,432,32552432
5688,222,1798300,1,9,2,32,654,32552654
5689,70,1798300,4,9,2,32,724,32552724
5690,0,1798300,2,9,2,32,724,32552724
5691,0,1798300,2,9,2,32,724,32552724
5692,0,1798300,4,9,2,32,724,32552724
5693,0,1798300,1,9,2,32,724,32552724
5694,0,1798300,1,9,2,32,724,32552724
5695,96,1798300,2,9,2,32,820,32552820
5697,133,1798400,1,9,2,32,953,32552953
5698,152,1798400,8,9,2,33,105,32553105
5699,1,1798400,4,9,2,33,106,32553106
5700,0,1798400,2,9,2,33,106,32553106
5701,0,1798400,8,9,2,33,106,32553106
5702,49,1798400,1,9,2,33,155,32553155
5703,20,1798400,1,9,2,33,175,32553175
5704,8,1798400,5,9,2,33,183,32553183
5705,165,1798400,1,9,2,33,348,32553348
5706,359,1798500,1,9,2,33,707,32553707
5707,342,1798500,1,9,2,34,49,32554049
5708,207,1798500,1,9,2,34,256,32554256
5709,76,1798600,1,9,2,34,332,32554332
5710,148,1798500,1,9,2,34,480,32554480
5711,1025,1798500,1,9,2,35,505,32555505
5712,120,1798500,1,9,2,35,625,32555625
5713,0,1798500,1,9,2,35,625,32555625
5714,53,1798600,1,9,2,35,678,32555678
5715,193,1798400,1,9,2,35,871,32555871
5716,285,1798400,1,9,2,36,156,32556156
5717,339,1798500,1,9,2,36,495,32556495
5718,108,1798400,1,9,2,36,603,32556603
5719,300,1798600,1,9,2,36,903,32556903
5720,117,1798600,1,9,2,37,20,32557020
5721,18,1798800,1,9,2,37,38,32557038
5722,426,1798700,1,9,2,37,464,32557464
5723,71,1798700,1,9,2,37,535,32557535
5724,20,1798700,1,9,2,37,555,32557555
5725,56,1798600,1,9,2,37,611,32557611
5726,257,1798600,1,9,2,37,868,32557868
5727,30,1798800,6,9,2,37,898,32557898
5729,424,1798900,5,9,2,38,322,32558322
5730,34,1798800,1,9,2,38,356,32558356
5731,659,1798800,1,9,2,39,15,32559015
5732,16,1798900,1,9,2,39,31,32559031
5733,24,1798900,1,9,2,39,55,32559055
5734,225,1798800,1,9,2,39,280,32559280
5735,19,1798800,1,9,2,39,299,32559299
5736,1,1798900,1,9,2,39,300,32559300
5737,113,1798900,1,9,2,39,413,32559413
5738,416,1799000,1,9,2,39,829,32559829
5739,462,1798800,1,9,2,40,291,32560291
5740,86,1799000,6,9,2,40,377,32560377
5741,51,1799100,1,9,2,40,428,32560428
5742,198,1799400,2,9,2,40,626,32560626
5743,158,1799400,1,9,2,40,784,32560784
5744,79,1799200,1,9,2,40,863,32560863
5745,56,1799100,1,9,2,40,919,32560919
5746,385,1799300,1,9,2,41,304,32561304
5747,125,1799200,1,9,2,41,429,32561429
5748,512,1799300,1,9,2,41,941,32561941
5749,7,1799300,1,9,2,41,948,32561948
5750,0,1799200,5,9,2,41,948,32561948
5751,0,1799200,1,9,2,41,948,32561948
5752,23,1799300,1,9,2,41,971,32561971
5753,183,1799300,2,9,2,42,154,32562154
5754,5,1799400,3,9,2,42,159,32562159
5755,14,1799400,1,9,2,42,173,32562173
5757,49,1799400,1,9,2,42,222,32562222
5758,273,1799400,1,9,2,42,495,32562495
5759,0,1799400,1,9,2,42,495,32562495
5760,0,1799400,1,9,2,42,495,32562495
5761,0,1799400,1,9,2,42,495,32562495
5762,0,1799400,1,9,2,42,495,32562495
5764,6,1799000,1,9,2,42,501,32562501
5765,0,1799000,2,9,2,42,501,32562501
5767,3,1799000,4,9,2,42,504,32562504
5769,6,1799100,1,9,2,42,510,32562510
5770,11,1799100,2,9,2,42,521,32562521
5771,10,1799100,1,9,2,42,531,32562531
5772,1,1799100,1,9,2,42,532,32562532
5773,10,1799100,2,9,2,42,542,32562542
5774,47,1799000,2,9,2,42,589,32562589
5775,5,1799100,6,9,2,42,594,32562594
5776,8,1799100,1,9,2,42,602,32562602
5777,12,1799100,1,9,2,42,614,32562614
5778,79,1799100,1,9,2,42,693,32562693
5779,17,1799200,2,9,2,42,710,32562710
5780,8,1799200,2,9,2,42,718,32562718
5781,50,1799200,1,9,2,42,768,32562768
5782,214,1799100,1,9,2,42,982,32562982
5783,4,1799100,1,9,2,42,986,32562986
5784,704,1799200,4,9,2,43,690,32563690
5785,18,1799100,1,9,2,43,708,32563708
5786,188,1799300,1,9,2,43,896,32563896
5787,263,1799200,1,9,2,44,159,32564159
5788,146,1799200,1,9,2,44,305,32564305
5790,177,1799000,1,9,2,44,482,32564482
5791,44,1799100,1,9,2,44,526,32564526
5792,11,1799100,1,9,2,44,537,32564537
5793,4,1799100,1,9,2,44,541,32564541
5794,281,1799200,1,9,2,44,822,32564822
5795,344,1799100,3,9,2,45,166,32565166
5796,0,1799100,3,9,2,45,166,32565166
5797,0,1799100,3,9,2,45,166,32565166
5798,0,1799100,3,9,2,45,166,32565166
5800,5,1798800,1,9,2,45,171,32565171
5801,24,1798800,1,9,2,45,195,32565195
5802,31,1798800,1,9,2,45,226,32565226
5803,2,1798900,1,9,2,45,228,32565228
5804,7,1798800,1,9,2,45,235,32565235
5805,640,1798800,1,9,2,45,875,32565875
5806,279,1798800,2,9,2,46,154,32566154
5807,1,1798800,2,9,2,46,155,32566155
5808,4,1798900,1,9,2,46,159,32566159
5809,357,1798800,1,9,2,46,516,32566516
5810,388,1798800,1,9,2,46,904,32566904
5811,112,1799000,1,9,2,47,16,32567016
5812,252,1798900,1,9,2,47,268,32567268
5813,652,1799000,2,9,2,47,920,32567920
5814,19,1798900,1,9,2,47,939,32567939
5815,48,1799100,1,9,2,47,987,32567987
5816,34,1798900,5,9,2,48,21,32568021
5817,0,1798900,5,9,2,48,21,32568021
5818,0,1798900,5,9,2,48,21,32568021
5820,31,1798700,1,9,2,48,52,32568052
5821,13,1798700,1,9,2,48,65,32568065
5822,170,1798600,1,9,2,48,235,32568235
5823,15,1798600,1,9,2,48,250,32568250
5824,229,1798500,1,9,2,48,479,32568479
5825,3,1798600,1,9,2,48,482,32568482
5826,479,1798700,1,9,2,48,961,32568961
5827,418,1798500,1,9,2,49,379,32569379
5828,708,1798500,2,9,2,50,87,32570087
5829,1,1798500,3,9,2,50,88,32570088
5830,4,1798500,7,9,2,50,92,32570092
5831,61,1798600,1,9,2,50,153,32570153
5832,2,1798600,1,9,2,50,155,32570155
5834,69,1798500,1,9,2,50,224,32570224
5835,1112,1798400,1,9,2,51,336,32571336
5836,597,1798500,1,9,2,51,933,32571933
5837,75,1798500,1,9,2,52,8,32572008
5838,48,1798400,1,9,2,52,56,32572056
5839,847,1798600,1,9,2,52,903,32572903
5840,0,1798600,1,9,2,52,903,32572903
5841,15,1798500,1,9,2,52,918,32572918
5842,1892,1798600,1,9,2,54,810,32574810
5843,273,1798600,1,9,2,55,83,32575083
5845,130,1798500,2,9,2,55,213,32575213
5846,77,1798500,1,9,2,55,290,32575290
5847,799,1798500,1,9,2,56,89,32576089
5848,411,1798600,1,9,2,56,500,32576500
5849,41,1798700,1,9,2,56,541,32576541
5850,234,1798600,1,9,2,56,775,32576775
5851,15,1798500,1,9,2,56,790,32576790
5852,220,1798600,1,9,2,57,10,32577010
5854,1,1798700,18,9,2,57,11,32577011
5855,1,1798700,1,9,2,57,12,32577012
5856,293,1798500,2,9,2,57,305,32577305
5857,166,1798500,1,9,2,57,471,32577471
5858,190,1798500,1,9,2,57,661,32577661
5859,840,1798600,1,9,2,58,501,32578501
5860,0,1798600,1,9,2,58,501,32578501
5861,543,1798600,1,9,2,59,44,32579044
5862,679,1798700,2,9,2,59,723,32579723
5863,71,1798700,1,9,2,59,794,32579794
5864,207,1798700,1,9,3,0,1,32580001
5865,39,1798600,1,9,3,0,40,32580040
5866,59,1798700,2,9,3,0,99,32580099
5867,1,1798800,8,9,3,0,100,32580100
5868,0,1798800,3,9,3,0,100,32580100
5869,1,1798800,4,9,3,0,101,32580101
5870,1,1798700,1,9,3,0,102,32580102
5871,0,1798700,3,9,3,0,102,32580102
5872,0,1798700,1,9,3,0,102,32580102
5873,4,1798800,1,9,3,0,106,32580106
5874,39,1798900,2,9,3,0,145,32580145
5875,2,1798900,1,9,3,0,147,32580147
5876,41,1799000,1,9,3,0,188,32580188
5877,1,1799000,3,9,3,0,189,32580189
5878,13,1799100,4,9,3,0,202,32580202
5879,97,1799100,1,9,3,0,299,32580299
5880,0,1799100,1,9,3,0,299,32580299
5881,15,1799200,2,9,3,0,314,32580314
5882,4,1799200,1,9,3,0,318,32580318
5883,6,1799200,4,9,3,0,324,32580324
5884,15,1799200,1,9,3,0,339,32580339
5885,7,1799200,1,9,3,0,346,32580346
5886,92,1799200,2,9,3,0,438,32580438
5888,22,1799300,1,9,3,0,460,32580460
5889,27,1799300,1,9,3,0,487,32580487
5890,20,1799100,1,9,3,0,507,32580507
5891,25,1799300,1,9,3,0,532,32580532
5892,6,1799300,1,9,3,0,538,32580538
5893,173,1799300,1,9,3,0,711,32580711
5894,4,1799300,1,9,3,0,715,32580715
5895,326,1799300,5,9,3,1,41,32581041
5896,59,1799200,1,9,3,1,100,32581100
5897,41,1799200,1,9,3,1,141,32581141
5898,52,1799400,1,9,3,1,193,32581193
5899,276,1799300,4,9,3,1,469,32581469
5900,39,1799200,1,9,3,1,508,32581508
5901,0,1799200,1,9,3,1,508,32581508
5902,165,1799300,1,9,3,1,673,32581673
5903,128,1799300,1,9,3,1,801,32581801
5904,93,1799200,1,9,3,1,894,32581894
5905,1,1799200,11,9,3,1,895,32581895
5906,864,1799300,1,9,3,2,759,32582759
5907,114,1799200,1,9,3,2,873,32582873
5908,72,1799100,1,9,3,2,945,32582945
5909,316,1799200,1,9,3,3,261,32583261
5910,690,1799100,1,9,3,3,951,32583951
5911,79,1799100,1,9,3,4,30,32584030
5912,397,1799300,1,9,3,4,427,32584427
5913,28,1799300,6,9,3,4,455,32584455
5914,462,1799300,1,9,3,4,917,32584917
5915,149,1799300,2,9,3,5,66,32585066
5916,95,1799200,1,9,3,5,161,32585161
5917,105,1799200,1,9,3,5,266,32585266
5918,895,1799300,1,9,3,6,161,32586161
5919,1319,1799300,5,9,3,7,480,32587480
5920,48,1799300,5,9,3,7,528,32587528
5921,72,1799300,1,9,3,7,600,32587600
5922,0,1799200,1,9,3,7,600,32587600
5923,0,1799200,1,9,3,7,600,32587600
5924,1,1799200,1,9,3,7,601,32587601
5925,0,1799200,1,9,3,7,601,32587601
5926,88,1799300,1,9,3,7,689,32587689
5927,74,1799300,1,9,3,7,763,32587763
5929,534,1799400,9,9,3,8,297,32588297
5930,116,1799500,1,9,3,8,413,32588413
5931,633,1799500,1,9,3,9,46,32589046
5932,1,1799500,16,9,3,9,47,32589047
5933,40,1799500,2,9,3,9,87,32589087
5934,24,1799600,1,9,3,9,111,32589111
5935,16,1799400,1,9,3,9,127,32589127
5936,12,1799400,1,9,3,9,139,32589139
5937,17,1799400,1,9,3,9,156,32589156
5938,4,1799500,1,9,3,9,160,32589160
5939,40,1799600,2,9,3,9,200,32589200
5940,34,1799400,1,9,3,9,234,32589234
5941,250,1799500,1,9,3,9,484,32589484
5942,16,1799600,2,9,3,9,500,32589500
5943,329,1799400,1,9,3,9,829,32589829
5944,73,1799500,1,9,3,9,902,32589902
5945,472,1799400,1,9,3,10,374,32590374
5946,143,1799400,1,9,3,10,517,32590517
5947,74,1799500,1,9,3,10,591,32590591
5949,2,1799500,1,9,3,10,593,32590593
5951,569,1799500,8,9,3,11,162,32591162
5952,969,1799500,1,9,3,12,131,32592131
5953,290,1799500,1,9,3,12,421,32592421
5955,748,1799500,1,9,3,13,169,32593169
5956,121,1799500,1,9,3,13,290,32593290
5957,53,1799500,1,9,3,13,343,32593343
5958,10,1799600,1,9,3,13,353,32593353
5959,142,1799500,1,9,3,13,495,32593495
5960,2,1799500,1,9,3,13,497,32593497
5961,610,1799600,1,9,3,14,107,32594107
5962,409,1799400,1,9,3,14,516,32594516
5963,703,1799400,1,9,3,15,219,32595219
5964,398,1799500,1,9,3,15,617,32595617
5965,21,1799500,1,9,3,15,638,32595638
5966,79,1799500,1,9,3,15,717,32595717
5967,174,1799600,3,9,3,15,891,32595891
5968,374,1799600,1,9,3,16,265,32596265
5969,123,1799500,1,9,3,16,388,32596388
5970,544,1799600,7,9,3,16,932,32596932
5972,365,1799700,1,9,3,17,297,32597297
5973,7,1799700,1,9,3,17,304,32597304
5974,23,1799700,1,9,3,17,327,32597327
5975,16,1799800,1,9,3,17,343,32597343
5976,7,1799500,1,9,3,17,350,32597350
5977,0,1799500,1,9,3,17,350,32597350
5978,0,1799500,1,9,3,17,350,32597350
5979,0,1799500,1,9,3,17,350,32597350
5980,0,1799500,1,9,3,17,350,32597350
5981,1,1799500,1,9,3,17,351,32597351
5982,0,1799500,1,9,3,17,351,32597351
5983,60,1799600,3,9,3,17,411,32597411
5984,8,1799600,1,9,3,17,419,32597419
5985,45,1799600,1,9,3,17,464,32597464
5986,1561,1799600,1,9,3,19,25,32599025
5987,621,1799600,6,9,3,19,646,32599646
5989,272,1799600,1,9,3,19,918,32599918
5990,35,1799600,1,9,3,19,953,32599953
5991,149,1799700,4,9,3,20,102,32600102
5992,26,1799600,1,9,3,20,128,32600128
5993,124,1799800,10,9,3,20,252,32600252
5994,154,1799800,1,9,3,20,406,32600406
5995,483,1799800,1,9,3,20,889,32600889
5996,501,1799800,8,9,3,21,390,32601390
5997,94,1799900,1,9,3,21,484,32601484
5998,55,1799900,1,9,3,21,539,32601539
5999,39,1799700,1,9,3,21,578,32601578
6000,61,1799700,1,9,3,21,639,32601639
6001,105,1799700,2,9,3,21,744,32601744
6002,52,1799700,1,9,3,21,796,32601796
6003,143,1799600,1,9,3,21,939,32601939
6004,5,1799700,1,9,3,21,944,32601944
6005,69,1799700,1,9,3,22,13,32602013
6006,125,1799700,1,9,3,22,138,32602138
6007,78,1799700,1,9,3,22,216,32602216
6008,130,1799700,1,9,3,22,346,32602346
6009,52,1799700,1,9,3,22,398,32602398
6010,278,1799700,1,9,3,22,676,32602676
6011,116,1799600,1,9,3,22,792,32602792
6012,11,1799600,1,9,3,22,803,32602803
6013,157,1799700,1,9,3,22,960,32602960
6014,23,1799500,1,9,3,22,983,32602983
6015,225,1799700,1,9,3,23,208,32603208
6016,111,1799700,1,9,3,23,319,32603319
6017,400,1799500,1,9,3,23,719,32603719
6018,12,1799500,1,9,3,23,731,32603731
6019,16,1799500,1,9,3,23,747,32603747
6020,163,1799600,1,9,3,23,910,32603910
6021,253,1799600,1,9,3,24,163,32604163
6022,156,1799700,1,9,3,24,319,32604319
6023,929,1799800,1,9,3,25,248,32605248
6024,28,1799700,1,9,3,25,276,32605276
6025,441,1799800,1,9,3,25,717,32605717
6026,384,1799800,1,9,3,26,101,32606101
6027,331,1799700,1,9,3,26,432,32606432
6028,390,1799800,5,9,3,26,822,32606822
6029,197,1799900,1,9,3,27,19,32607019
6030,82,1799800,1,9,3,27,101,32607101
6031,0,1799800,1,9,3,27,101,32607101
6032,0,1799800,1,9,3,27,101,32607101
6033,0,1799700,1,9,3,27,101,32607101
6034,0,1799700,1,9,3,27,101,32607101
6035,0,1799700,1,9,3,27,101,32607101
6036,1,1799700,1,9,3,27,102,32607102
6037,129,1799900,2,9,3,27,231,32607231
6038,462,1799900,1,9,3,27,693,32607693
6039,356,1799800,1,9,3,28,49,32608049
6040,195,1799900,1,9,3,28,244,32608244
6041,1769,1799900,2,9,3,30,13,32610013
6042,0,1799900,3,9,3,30,13,32610013
6043,678,1799900,1,9,3,30,691,32610691
6044,278,1799900,1,9,3,30,969,32610969
6045,34,1799900,1,9,3,31,3,32611003
6046,118,1799900,1,9,3,31,121,32611121
6047,42,1799900,1,9,3,31,163,32611163
6048,241,1799900,1,9,3,31,404,32611404
6049,40,1799900,1,9,3,31,444,32611444
6050,112,1800000,1,9,3,31,556,32611556
6051,40,1800000,1,9,3,31,596,32611596
6052,92,1799800,1,9,3,31,688,32611688
6053,9,1800000,1,9,3,31,697,32611697
6054,0,1800000,1,9,3,31,697,32611697
6055,82,1799800,2,9,3,31,779,32611779
6057,20,1799800,1,9,3,31,799,32611799
6058,148,1799900,1,9,3,31,947,32611947
6059,501,1799700,1,9,3,32,448,32612448
6060,557,1799900,1,9,3,33,5,32613005
6061,8,1799900,2,9,3,33,13,32613013
6063,129,1799800,1,9,3,33,142,32613142
6064,1072,1799700,1,9,3,34,214,32614214
6065,419,1799700,1,9,3,34,633,32614633
6066,130,1799600,1,9,3,34,763,32614763
6067,356,1799500,1,9,3,35,119,32615119
6068,8,1799500,1,9,3,35,127,32615127
6069,0,1799500,2,9,3,35,127,32615127
6070,8,1799500,1,9,3,35,135,32615135
6071,22,1799600,1,9,3,35,157,32615157
6072,92,1799400,1,9,3,35,249,32615249
6073,1401,1799500,2,9,3,36,650,32616650
6074,1251,1799400,1,9,3,37,901,32617901
6075,8,1799600,1,9,3,37,909,32617909
6076,1161,1799400,6,9,3,39,70,32619070
6077,14,1799400,1,9,3,39,84,32619084
6078,57,1799500,1,9,3,39,141,32619141
6079,1154,1799500,2,9,3,40,295,32620295
6080,380,1799500,2,9,3,40,675,32620675
6081,603,1799500,1,9,3,41,278,32621278
6082,225,1799500,1,9,3,41,503,32621503
6083,1213,1799500,1,9,3,42,716,32622716
6084,85,1799500,1,9,3,42,801,32622801
6085,565,1799600,1,9,3,43,366,32623366
6086,0,1799600,2,9,3,43,366,32623366
6087,0,1799600,1,9,3,43,366,32623366
6088,1377,1799600,1,9,3,44,743,32624743
6089,90,1799700,2,9,3,44,833,32624833
6091,53,1799600,2,9,3,44,886,32624886
6092,1156,1799600,1,9,3,46,42,32626042
6093,472,1799700,3,9,3,46,514,32626514
6094,869,1799600,1,9,3,47,383,32627383
6095,1,1799600,2,9,3,47,384,32627384
6096,54,1799600,2,9,3,47,438,32627438
6097,873,1799600,1,9,3,48,311,32628311
6098,16,1799600,1,9,3,48,327,32628327
6099,29,1799500,5,9,3,48,356,32628356
6100,42,1799700,1,9,3,48,398,32628398
6101,401,1799500,2,9,3,48,799,32628799
6102,605,1799500,1,9,3,49,404,32629404
6103,157,1799500,1,9,3,49,561,32629561
6105,791,1799400,1,9,3,50,352,32630352
6106,63,1799400,1,9,3,50,415,32630415
6107,37,1799400,1,9,3,50,452,32630452
6108,541,1799600,1,9,3,50,993,32630993
6109,483,1799600,1,9,3,51,476,32631476
6110,35,1799500,2,9,3,51,511,32631511
6111,685,1799400,1,9,3,52,196,32632196
6112,47,1799400,1,9,3,52,243,32632243
6113,20,1799400,1,9,3,52,263,32632263
6114,216,1799500,2,9,3,52,479,32632479
6115,1,1799500,2,9,3,52,480,32632480
6116,163,1799500,1,9,3,52,643,32632643
6118,104,1799400,2,9,3,52,747,32632747
6119,152,1799400,1,9,3,52,899,32632899
6120,88,1799400,1,9,3,52,987,32632987
6121,68,1799400,1,9,3,53,55,32633055
6122,237,1799400,1,9,3,53,292,32633292
6123,121,1799400,1,9,3,53,413,32633413
6124,622,1799300,1,9,3,54,35,32634035
6125,202,1799500,1,9,3,54,237,32634237
6126,272,1799400,1,9,3,54,509,32634509
6127,1121,1799600,1,9,3,55,630,32635630
6128,82,1799600,1,9,3,55,712,32635712
6129,934,1799600,2,9,3,56,646,32636646
6130,21,1799600,1,9,3,56,667,32636667
6131,1,1799600,2,9,3,56,668,32636668
6132,212,1799600,1,9,3,56,880,32636880
6133,494,1799600,1,9,3,57,374,32637374
6134,1373,1799500,2,9,3,58,747,32638747
6135,639,1799400,2,9,3,59,386,32639386
6136,0,1799400,2,9,3,59,386,32639386
6137,651,1799300,1,9,4,0,37,32640037
6138,53,1799400,1,9,4,0,90,32640090
6139,109,1799500,1,9,4,0,199,32640199
6140,396,1799400,1,9,4,0,595,32640595
6142,558,1799300,1,9,4,1,153,32641153
6143,0,1799300,1,9,4,1,153,32641153
6144,179,1799300,1,9,4,1,332,32641332
6145,346,1799300,1,9,4,1,678,32641678
6146,193,1799400,1,9,4,1,871,32641871
6147,190,1799300,3,9,4,2,61,32642061
6148,53,1799400,1,9,4,2,114,32642114
6149,1120,1799300,1,9,4,3,234,32643234
6150,23,1799200,1,9,4,3,257,32643257
6151,0,1799300,1,9,4,3,257,32643257
6152,0,1799200,2,9,4,3,257,32643257
6153,145,1799200,2,9,4,3,402,32643402
6154,20,1799100,4,9,4,3,422,32643422
6155,0,1799100,2,9,4,3,422,32643422
6156,0,1799100,4,9,4,3,422,32643422
6157,0,1799100,6,9,4,3,422,32643422
6158,0,1799100,1,9,4,3,422,32643422
6159,0,1799100,2,9,4,3,422,32643422
6160,1,1799100,1,9,4,3,423,32643423
6161,0,1799100,1,9,4,3,423,32643423
6162,0,1799100,1,9,4,3,423,32643423
6163,0,1799100,6,9,4,3,423,32643423
6164,0,1799100,2,9,4,3,423,32643423
6165,0,1799100,3,9,4,3,423,32643423
6166,29,1799100,1,9,4,3,452,32643452
6167,4,1799200,1,9,4,3,456,32643456
6168,163,1799200,1,9,4,3,619,32643619
6169,133,1799200,1,9,4,3,752,32643752
6170,211,1799000,5,9,4,3,963,32643963
6171,30,1799000,1,9,4,3,993,32643993
6172,69,1799000,1,9,4,4,62,32644062
6173,190,1799000,1,9,4,4,252,32644252
6174,372,1798800,1,9,4,4,624,32644624
6175,207,1799000,1,9,4,4,831,32644831
6176,86,1798900,1,9,4,4,917,32644917
6177,150,1798800,1,9,4,5,67,32645067
6178,12,1798800,1,9,4,5,79,32645079
6179,20,1798800,1,9,4,5,99,32645099
6180,191,1798900,2,9,4,5,290,32645290
6182,1,1798900,1,9,4,5,291,32645291
6183,1007,1799100,1,9,4,6,298,32646298
6184,494,1799000,1,9,4,6,792,32646792
6185,154,1799000,3,9,4,6,946,32646946
6187,253,1798900,1,9,4,7,199,32647199
6188,621,1799000,1,9,4,7,820,32647820
6189,323,1799000,1,9,4,8,143,32648143
6190,521,1798900,1,9,4,8,664,32648664
6191,180,1798900,1,9,4,8,844,32648844
6192,35,1798900,1,9,4,8,879,32648879
6194,184,1799000,1,9,4,9,63,32649063
6195,288,1798900,1,9,4,9,351,32649351
6196,321,1798800,5,9,4,9,672,32649672
6197,1304,1799000,4,9,4,10,976,32650976
6198,217,1799200,3,9,4,11,193,32651193
6199,99,1799000,1,9,4,11,292,32651292
6200,0,1799000,2,9,4,11,292,32651292
6201,342,1799000,5,9,4,11,634,32651634
6202,1,1799000,2,9,4,11,635,32651635
6203,0,1799000,4,9,4,11,635,32651635
6204,0,1799000,2,9,4,11,635,32651635
6205,833,1799000,1,9,4,12,468,32652468
6206,655,1798900,1,9,4,13,123,32653123
6207,1903,1799100,1,9,4,15,26,32655026
6208,190,1799100,1,9,4,15,216,32655216
6209,43,1799000,1,9,4,15,259,32655259
6210,9,1799000,1,9,4,15,268,32655268
6211,31,1799000,2,9,4,15,299,32655299
6212,118,1799100,1,9,4,15,417,32655417
6213,807,1799200,1,9,4,16,224,32656224
6214,2149,1799100,2,9,4,18,373,32658373
6215,448,1799200,1,9,4,18,821,32658821
6216,1738,1799200,1,9,4,20,559,32660559
6217,596,1799200,8,9,4,21,155,32661155
6218,560,1799300,2,9,4,21,715,32661715
6219,803,1799400,5,9,4,22,518,32662518
6220,225,1799500,3,9,4,22,743,32662743
6221,137,1799400,1,9,4,22,880,32662880
6222,11,1799400,1,9,4,22,891,32662891
6223,34,1799400,1,9,4,22,925,32662925
6224,474,1799400,1,9,4,23,399,32663399
6225,25,1799400,1,9,4,23,424,32663424
6226,913,1799500,1,9,4,24,337,32664337
6227,399,1799600,2,9,4,24,736,32664736
6228,344,1799600,1,9,4,25,80,32665080
6229,9,1799600,1,9,4,25,89,32665089
6230,306,1799600,2,9,4,25,395,32665395
6231,1,1799600,1,9,4,25,396,32665396
6232,411,1799600,1,9,4,25,807,32665807
6233,249,1799400,1,9,4,26,56,32666056
6234,12,1799400,1,9,4,26,68,32666068
6235,564,1799400,1,9,4,26,632,32666632
6236,239,1799400,1,9,4,26,871,32666871
6237,16,1799400,1,9,4,26,887,32666887
6238,984,1799300,1,9,4,27,871,32667871
6239,172,1799300,1,9,4,28,43,32668043
6240,129,1799300,1,9,4,28,172,32668172
6241,0,1799300,1,9,4,28,172,32668172
6242,77,1799200,1,9,4,28,249,32668249
6243,89,1799000,1,9,4,28,338,32668338
6244,126,1798900,2,9,4,28,464,32668464
6245,537,1799100,1,9,4,29,1,32669001
6246,83,1799100,1,9,4,29,84,32669084
6247,217,1799000,1,9,4,29,301,32669301
6248,342,1799200,1,9,4,29,643,32669643
6249,712,1799200,1,9,4,30,355,32670355
6250,753,1799200,1,9,4,31,108,32671108
6251,254,1799100,1,9,4,31,362,32671362
6252,366,1799100,2,9,4,31,728,32671728
6253,323,1799100,1,9,4,32,51,32672051
6254,57,1799100,1,9,4,32,108,32672108
6255,323,1799100,1,9,4,32,431,32672431
6256,568,1799000,1,9,4,32,999,32672999
6257,975,1799000,1,9,4,33,974,32673974
6258,42,1799100,1,9,4,34,16,32674016
6259,311,1799200,2,9,4,34,327,32674327
6260,832,1799200,1,9,4,35,159,32675159
6261,1687,1799600,2,9,4,36,846,32676846
6262,49,1799400,1,9,4,36,895,32676895
6263,109,1799400,1,9,4,37,4,32677004
6264,509,1799400,1,9,4,37,513,32677513
6265,137,1799500,1,9,4,37,650,32677650
6266,403,1799400,1,9,4,38,53,32678053
6268,938,1799300,1,9,4,38,991,32678991
6269,36,1799300,1,9,4,39,27,32679027
6270,17,1799400,1,9,4,39,44,32679044
6271,19,1799300,1,9,4,39,63,32679063
6272,585,1799300,1,9,4,39,648,32679648
6273,1563,1799400,1,9,4,41,211,32681211
6274,1164,1799300,2,9,4,42,375,32682375
6276,891,1799200,1,9,4,43,266,32683266
6277,0,1799200,1,9,4,43,266,32683266
6279,465,1799200,1,9,4,43,731,32683731
6280,586,1799400,6,9,4,44,317,32684317
6282,536,1799300,1,9,4,44,853,32684853
6283,295,1799500,1,9,4,45,148,32685148
6284,419,1799500,1,9,4,45,567,32685567
6285,408,1799600,2,9,4,45,975,32685975
6286,0,1799600,5,9,4,45,975,32685975
6287,0,1799600,2,9,4,45,975,32685975
6288,1,1799600,10,9,4,45,976,32685976
6289,193,1799700,1,9,4,46,169,32686169
6290,32,1799700,1,9,4,46,201,32686201
6291,0,1799700,2,9,4,46,201,32686201
6292,191,1799600,1,9,4,46,392,32686392
6293,44,1799600,1,9,4,46,436,32686436
6294,36,1799600,1,9,4,46,472,32686472
6295,140,1799600,1,9,4,46,612,32686612
6296,34,1799800,1,9,4,46,646,32686646
6297,91,1799600,1,9,4,46,737,32686737
6298,41,1799800,1,9,4,46,778,32686778
6299,47,1799800,1,9,4,46,825,32686825
6300,12,1799500,1,9,4,46,837,32686837
6301,1509,1799600,1,9,4,48,346,32688346
6302,1460,1799700,5,9,4,49,806,32689806
6303,444,1799700,3,9,4,50,250,32690250
6304,3,1799600,1,9,4,50,253,32690253
6305,112,1799600,1,9,4,50,365,32690365
6306,653,1799700,1,9,4,51,18,32691018
6307,121,1799500,1,9,4,51,139,32691139
6308,442,1799500,2,9,4,51,581,32691581
6309,686,1799600,1,9,4,52,267,32692267
6310,81,1799500,1,9,4,52,348,32692348
6311,39,1799700,5,9,4,52,387,32692387
6312,703,1799600,1,9,4,53,90,32693090
6313,473,1799500,1,9,4,53,563,32693563
6314,1204,1799500,1,9,4,54,767,32694767
6315,325,1799700,1,9,4,55,92,32695092
6316,793,1799600,1,9,4,55,885,32695885
6317,35,1799400,1,9,4,55,920,32695920
6318,100,1799400,1,9,4,56,20,32696020
6319,84,1799400,3,9,4,56,104,32696104
6320,151,1799600,4,9,4,56,255,32696255
6322,191,1799500,1,9,4,56,446,32696446
6323,343,1799400,1,9,4,56,789,32696789
6324,0,1799400,1,9,4,56,789,32696789
6325,524,1799500,1,9,4,57,313,32697313
6326,156,1799300,2,9,4,57,469,32697469
6327,114,1799300,4,9,4,57,583,32697583
6329,96,1799200,4,9,4,57,679,32697679
6330,2,1799100,1,9,4,57,681,32697681
6331,0,1799100,2,9,4,57,681,32697681
6332,0,1799100,1,9,4,57,681,32697681
6333,2,1799000,1,9,4,57,683,32697683
6334,0,1799000,5,9,4,57,683,32697683
6335,3,1799000,1,9,4,57,686,32697686
6336,4,1798900,1,9,4,57,690,32697690
6337,152,1799000,1,9,4,57,842,32697842
6339,276,1798900,1,9,4,58,118,32698118
6340,0,1798900,3,9,4,58,118,32698118
6341,1,1798900,1,9,4,58,119,32698119
6342,80,1798900,3,9,4,58,199,32698199
6343,538,1798800,1,9,4,58,737,32698737
6344,137,1798800,1,9,4,58,874,32698874
6345,51,1798900,1,9,4,58,925,32698925
6346,288,1798900,1,9,4,59,213,32699213
6348,111,1798800,13,9,4,59,324,32699324
6349,0,1798800,13,9,4,59,324,32699324
6351,44,1798900,1,9,4,59,368,32699368
6352,45,1798800,1,9,4,59,413,32699413
6353,467,1799000,1,9,4,59,880,32699880
6354,825,1798600,3,9,5,0,705,32700705
6355,5,1798600,4,9,5,0,710,32700710
6356,17,1798700,5,9,5,0,727,32700727
6357,0,1798700,1,9,5,0,727,32700727
6358,0,1798700,2,9,5,0,727,32700727
6359,0,1798700,1,9,5,0,727,32700727
6360,1,1798700,1,9,5,0,728,32700728
6361,0,1798800,2,9,5,0,728,32700728
6362,0,1798800,1,9,5,0,728,32700728
6363,1,1798800,1,9,5,0,729,32700729
6364,0,1798800,1,9,5,0,729,32700729
6365,11,1798700,1,9,5,0,740,32700740
6366,68,1798600,1,9,5,0,808,32700808
6367,5,1798800,2,9,5,0,813,32700813
6368,0,1798800,2,9,5,0,813,32700813
6369,0,1798800,2,9,5,0,813,32700813
6371,4,1799000,1,9,5,0,817,32700817
6372,8,1798900,1,9,5,0,825,32700825
6373,5,1798900,4,9,5,0,830,32700830
6374,4,1798900,1,9,5,0,834,32700834
6375,4,1798900,1,9,5,0,838,32700838
6376,3,1798900,1,9,5,0,841,32700841
6377,15,1798900,2,9,5,0,856,32700856
6378,0,1798900,1,9,5,0,856,32700856
6379,35,1798900,1,9,5,0,891,32700891
6380,32,1799000,2,9,5,0,923,32700923
6381,25,1798800,1,9,5,0,948,32700948
6382,56,1798800,1,9,5,1,4,32701004
6383,5,1799000,2,9,5,1,9,32701009
6384,92,1799000,1,9,5,1,101,32701101
6385,0,1799000,1,9,5,1,101,32701101
6386,0,1799000,1,9,5,1,101,32701101
6387,0,1799100,1,9,5,1,101,32701101
6388,0,1799100,1,9,5,1,101,32701101
6389,0,1799100,1,9,5,1,101,32701101
6390,0,1799100,1,9,5,1,101,32701101
6391,0,1799100,1,9,5,1,101,32701101
6392,0,1799100,1,9,5,1,101,32701101
6393,0,1799100,1,9,5,1,101,32701101
6394,1,1799100,1,9,5,1,102,32701102
6395,0,1799100,1,9,5,1,102,32701102
6396,0,1799100,1,9,5,1,102,32701102
6397,8,1799000,1,9,5,1,110,32701110
6398,8,1799100,1,9,5,1,118,32701118
6399,55,1799100,1,9,5,1,173,32701173
6400,4,1799100,1,9,5,1,177,32701177
6401,7,1799000,1,9,5,1,184,32701184
6402,26,1798900,1,9,5,1,210,32701210
6403,1,1798900,1,9,5,1,211,32701211
6404,33,1798800,1,9,5,1,244,32701244
6405,12,1799000,4,9,5,1,256,32701256
6406,1,1798800,1,9,5,1,257,32701257
6407,0,1798800,3,9,5,1,257,32701257
6408,84,1798900,1,9,5,1,341,32701341
6409,52,1798900,1,9,5,1,393,32701393
6410,63,1798900,2,9,5,1,456,32701456
6412,141,1799000,1,9,5,1,597,32701597
6413,25,1799000,1,9,5,1,622,32701622
6414,73,1799000,1,9,5,1,695,32701695
6415,13,1799000,1,9,5,1,708,32701708
6416,77,1799100,1,9,5,1,785,32701785
6417,21,1799100,1,9,5,1,806,32701806
6418,84,1799100,3,9,5,1,890,32701890
6419,10,1799100,1,9,5,1,900,32701900
6420,6,1799100,1,9,5,1,906,32701906
6421,94,1798900,4,9,5,2,0,32702000
6422,4,1799000,1,9,5,2,4,32702004
6423,4,1799000,1,9,5,2,8,32702008
6424,0,1799000,1,9,5,2,8,32702008
6425,25,1799000,2,9,5,2,33,32702033
6426,170,1798900,2,9,5,2,203,32702203
6427,185,1799100,1,9,5,2,388,32702388
6428,203,1799000,3,9,5,2,591,32702591
6429,626,1798800,1,9,5,3,217,32703217
6430,1575,1798600,1,9,5,4,792,32704792
6431,20,1798700,1,9,5,4,812,32704812
6432,38,1798500,1,9,5,4,850,32704850
6433,212,1798500,1,9,5,5,62,32705062
6434,1,1798500,3,9,5,5,63,32705063
6435,0,1798500,2,9,5,5,63,32705063
6436,0,1798500,2,9,5,5,63,32705063
6437,25,1798400,2,9,5,5,88,32705088
6438,33,1798400,8,9,5,5,121,32705121
6439,11,1798500,1,9,5,5,132,32705132
6440,30,1798600,3,9,5,5,162,32705162
6441,588,1798600,1,9,5,5,750,32705750
6442,33,1798700,1,9,5,5,783,32705783
6443,6,1798500,1,9,5,5,789,32705789
6444,9,1798500,1,9,5,5,798,32705798
6445,127,1798500,2,9,5,5,925,32705925
6446,187,1798500,2,9,5,6,112,32706112
6447,21,1798500,1,9,5,6,133,32706133
6448,246,1798500,1,9,5,6,379,32706379
6449,35,1798500,1,9,5,6,414,32706414
6450,16,1798500,1,9,5,6,430,32706430
6451,119,1798500,2,9,5,6,549,32706549
6452,1,1798500,1,9,5,6,550,32706550
6453,295,1798400,3,9,5,6,845,32706845
6454,205,1798400,7,9,5,7,50,32707050
6455,50,1798600,1,9,5,7,100,32707100
6456,0,1798600,1,9,5,7,100,32707100
6457,0,1798600,1,9,5,7,100,32707100
6458,0,1798600,1,9,5,7,100,32707100
6459,0,1798600,1,9,5,7,100,32707100
6460,1,1798600,1,9,5,7,101,32707101
6461,0,1798700,1,9,5,7,101,32707101
6462,50,1798500,3,9,5,7,151,32707151
6463,1,1798500,1,9,5,7,152,32707152
6464,0,1798500,1,9,5,7,152,32707152
6465,316,1798500,1,9,5,7,468,32707468
6466,53,1798500,1,9,5,7,521,32707521
6467,121,1798500,1,9,5,7,642,32707642
6468,144,1798500,1,9,5,7,786,32707786
6469,171,1798500,1,9,5,7,957,32707957
6470,5,1798500,1,9,5,7,962,32707962
6471,2,1798500,1,9,5,7,964,32707964
6472,2,1798500,1,9,5,7,966,32707966
6473,5,1798400,1,9,5,7,971,32707971
6474,6,1798400,1,9,5,7,977,32707977
6475,101,1798600,1,9,5,8,78,32708078
6476,9,1798700,1,9,5,8,87,32708087
6477,133,1798400,1,9,5,8,220,32708220
6478,16,1798600,1,9,5,8,236,32708236
6479,49,1798500,2,9,5,8,285,32708285
6480,81,1798600,1,9,5,8,366,32708366
6481,68,1798400,2,9,5,8,434,32708434
6482,47,1798400,1,9,5,8,481,32708481
6483,150,1798600,3,9,5,8,631,32708631
6484,0,1798600,3,9,5,8,631,32708631
6486,305,1798500,1,9,5,8,936,32708936
6487,758,1798700,1,9,5,9,694,32709694
6488,0,1798700,1,9,5,9,694,32709694
6489,127,1798600,1,9,5,9,821,32709821
6490,231,1798600,1,9,5,10,52,32710052
6491,0,1798500,8,9,5,10,52,32710052
6492,579,1798600,1,9,5,10,631,32710631
6493,12,1798500,1,9,5,10,643,32710643
6494,170,1798600,2,9,5,10,813,32710813
6495,4,1798600,1,9,5,10,817,32710817
6496,43,1798700,1,9,5,10,860,32710860
6497,640,1798700,1,9,5,11,500,32711500
6498,264,1798700,1,9,5,11,764,32711764
6499,37,1798700,1,9,5,11,801,32711801
6501,123,1798600,2,9,5,11,924,32711924
6502,291,1798700,1,9,5,12,215,32712215
6503,838,1798500,2,9,5,13,53,32713053
6504,471,1798500,2,9,5,13,524,32713524
6505,0,1798500,2,9,5,13,524,32713524
6506,0,1798500,1,9,5,13,524,32713524
6507,0,1798500,3,9,5,13,524,32713524
6508,0,1798500,4,9,5,13,524,32713524
6509,1,1798500,6,9,5,13,525,32713525
6510,0,1798500,2,9,5,13,525,32713525
6511,0,1798500,43,9,5,13,525,32713525
6512,1,1798400,3,9,5,13,526,32713526
6513,0,1798400,1,9,5,13,526,32713526
6514,0,1798400,1,9,5,13,526,32713526
6515,1,1798400,1,9,5,13,527,32713527
6516,6,1798400,2,9,5,13,533,32713533
6517,66,1798300,8,9,5,13,599,32713599
6518,0,1798300,4,9,5,13,599,32713599
6519,15,1798400,1,9,5,13,614,32713614
6520,0,1798400,1,9,5,13,614,32713614
6521,5,1798400,1,9,5,13,619,32713619
6522,34,1798300,1,9,5,13,653,32713653
6523,32,1798200,4,9,5,13,685,32713685
6524,15,1798300,2,9,5,13,700,32713700
6525,2,1798300,1,9,5,13,702,32713702
6526,9,1798400,1,9,5,13,711,32713711
6527,98,1798400,1,9,5,13,809,32713809
6528,61,1798400,1,9,5,13,870,32713870
6529,251,1798500,3,9,5,14,121,32714121
6530,568,1798500,2,9,5,14,689,32714689
6532,427,1798600,1,9,5,15,116,32715116
6533,19,1798500,1,9,5,15,135,32715135
6534,373,1798500,1,9,5,15,508,32715508
6535,41,1798500,1,9,5,15,549,32715549
6536,118,1798400,1,9,5,15,667,32715667
6537,113,1798400,1,9,5,15,780,32715780
6538,1,1798400,1,9,5,15,781,32715781
6539,444,1798300,1,9,5,16,225,32716225
6540,463,1798300,1,9,5,16,688,32716688
6541,361,1798400,1,9,5,17,49,32717049
6542,51,1798500,1,9,5,17,100,32717100
6543,1,1798500,1,9,5,17,101,32717101
6544,0,1798500,1,9,5,17,101,32717101
6545,385,1798600,2,9,5,17,486,32717486
6546,58,1798600,1,9,5,17,544,32717544
6547,132,1798700,2,9,5,17,676,32717676
6548,1,1798700,3,9,5,17,677,32717677
6549,52,1798700,1,9,5,17,729,32717729
6550,23,1798600,1,9,5,17,752,32717752
6551,693,1798700,1,9,5,18,445,32718445
6552,96,1798700,1,9,5,18,541,32718541
6553,154,1798800,1,9,5,18,695,32718695
6555,0,1798600,2,9,5,18,695,32718695
6556,126,1798800,1,9,5,18,821,32718821
6557,479,1798900,1,9,5,19,300,32719300
6558,0,1798900,3,9,5,19,300,32719300
6559,4,1799000,1,9,5,19,304,32719304
6560,78,1799000,2,9,5,19,382,32719382
6561,121,1799100,1,9,5,19,503,32719503
6562,0,1799100,2,9,5,19,503,32719503
6563,7,1799200,1,9,5,19,510,32719510
6564,0,1799200,1,9,5,19,510,32719510
6565,1,1799200,5,9,5,19,511,32719511
6566,112,1799300,1,9,5,19,623,32719623
6567,58,1799300,1,9,5,19,681,32719681
6568,344,1799300,1,9,5,20,25,32720025
6569,498,1799300,1,9,5,20,523,32720523
6570,227,1799300,1,9,5,20,750,32720750
6571,75,1799300,1,9,5,20,825,32720825
6572,359,1799400,1,9,5,21,184,32721184
6573,1,1799400,4,9,5,21,185,32721185
6574,0,1799400,2,9,5,21,185,32721185
6575,3,1799500,1,9,5,21,188,32721188
6576,37,1799500,9,9,5,21,225,32721225
6577,328,1799200,1,9,5,21,553,32721553
6578,309,1799200,1,9,5,21,862,32721862
6579,0,1799200,1,9,5,21,862,32721862
6580,89,1799100,1,9,5,21,951,32721951
6581,97,1799200,1,9,5,22,48,32722048
6582,436,1799300,2,9,5,22,484,32722484
6583,462,1799200,1,9,5,22,946,32722946
6584,654,1799200,2,9,5,23,600,32723600
6585,659,1799200,2,9,5,24,259,32724259
6586,251,1799200,2,9,5,24,510,32724510
6587,1,1799200,1,9,5,24,511,32724511
6588,979,1799300,1,9,5,25,490,32725490
6589,190,1799400,2,9,5,25,680,32725680
6590,24,1799500,2,9,5,25,704,32725704
6591,233,1799400,1,9,5,25,937,32725937
6592,76,1799500,1,9,5,26,13,32726013
6593,119,1799400,1,9,5,26,132,32726132
6594,214,1799300,1,9,5,26,346,32726346
6595,10,1799300,1,9,5,26,356,32726356
6596,281,1799400,1,9,5,26,637,32726637
6597,5,1799400,1,9,5,26,642,32726642
6598,6,1799400,1,9,5,26,648,32726648
6599,6,1799400,1,9,5,26,654,32726654
6600,17,1799500,1,9,5,26,671,32726671
6601,369,1799500,1,9,5,27,40,32727040
6602,60,1799500,1,9,5,27,100,32727100
6603,0,1799500,1,9,5,27,100,32727100
6604,1,1799500,1,9,5,27,101,32727101
6605,0,1799500,1,9,5,27,101,32727101
6606,0,1799500,1,9,5,27,101,32727101
6607,1,1799500,1,9,5,27,102,32727102
6608,0,1799500,1,9,5,27,102,32727102
6609,0,1799600,1,9,5,27,102,32727102
6610,0,1799600,1,9,5,27,102,32727102
6611,194,1799400,1,9,5,27,296,32727296
6612,496,1799400,1,9,5,27,792,32727792
6613,73,1799300,1,9,5,27,865,32727865
6614,33,1799300,1,9,5,27,898,32727898
6615,541,1799500,2,9,5,28,439,32728439
6616,138,1799400,1,9,5,28,577,32728577
6617,526,1799500,3,9,5,29,103,32729103
6618,387,1799500,1,9,5,29,490,32729490
6619,746,1799500,1,9,5,30,236,32730236
6621,138,1799400,1,9,5,30,374,32730374
6622,1797,1799200,1,9,5,32,171,32732171
6623,470,1799300,1,9,5,32,641,32732641
6624,0,1799400,1,9,5,32,641,32732641
6625,322,1799200,1,9,5,32,963,32732963
6626,373,1799300,1,9,5,33,336,32733336
6627,443,1799200,1,9,5,33,779,32733779
6628,738,1799200,1,9,5,34,517,32734517
6629,1228,1799100,1,9,5,35,745,32735745
6630,336,1799300,1,9,5,36,81,32736081
6631,388,1799100,1,9,5,36,469,32736469
6632,340,1799100,1,9,5,36,809,32736809
6633,1837,1799300,3,9,5,38,646,32738646
6634,2,1799400,2,9,5,38,648,32738648
6635,77,1799500,1,9,5,38,725,32738725
6636,41,1799300,1,9,5,38,766,32738766
6637,0,1799500,6,9,5,38,766,32738766
6638,30,1799400,1,9,5,38,796,32738796
6639,1999,1799600,5,9,5,40,795,32740795
6640,0,1799600,1,9,5,40,795,32740795
6641,165,1799500,1,9,5,40,960,32740960
6642,196,1799500,1,9,5,41,156,32741156
6643,442,1799600,1,9,5,41,598,32741598
6645,1,1799700,1,9,5,41,599,32741599
6646,1,1799600,3,9,5,41,600,32741600
6647,362,1799700,1,9,5,41,962,32741962
6648,0,1799700,3,9,5,41,962,32741962
6649,110,1799600,1,9,5,42,72,32742072
6650,157,1799800,1,9,5,42,229,32742229
6651,147,1799800,5,9,5,42,376,32742376
6652,0,1799800,5,9,5,42,376,32742376
6653,2,1799900,14,9,5,42,378,32742378
6654,3,1800000,5,9,5,42,381,32742381
6655,0,1800000,1,9,5,42,381,32742381
6656,126,1800000,1,9,5,42,507,32742507
6657,16,1800000,1,9,5,42,523,32742523
6658,36,1800000,5,9,5,42,559,32742559
6659,9,1799900,1,9,5,42,568,32742568
6660,18,1799900,1,9,5,42,586,32742586
6661,0,1800000,1,9,5,42,586,32742586
6662,45,1799900,1,9,5,42,631,32742631
6663,199,1799900,1,9,5,42,830,32742830
6664,514,1799800,1,9,5,43,344,32743344
6665,3,1799900,3,9,5,43,347,32743347
6666,337,1799900,5,9,5,43,684,32743684
6667,73,1799700,1,9,5,43,757,32743757
6668,264,1799700,1,9,5,44,21,32744021
6669,178,1799900,1,9,5,44,199,32744199
6670,243,1799700,1,9,5,44,442,32744442
6671,0,1799800,1,9,5,44,442,32744442
6672,29,1799700,1,9,5,44,471,32744471
6673,345,1799800,1,9,5,44,816,32744816
6674,130,1799800,1,9,5,44,946,32744946
6675,169,1799900,1,9,5,45,115,32745115
6676,1566,1799800,1,9,5,46,681,32746681
6677,448,1799700,1,9,5,47,129,32747129
6678,1,1799700,1,9,5,47,130,32747130
6679,1868,1799600,3,9,5,48,998,32748998
6680,0,1799600,1,9,5,48,998,32748998
6681,2,1799600,1,9,5,49,0,32749000
6682,11,1799500,1,9,5,49,11,32749011
6683,216,1799700,8,9,5,49,227,32749227
6684,0,1799700,5,9,5,49,227,32749227
6685,1277,1799800,1,9,5,50,504,32750504
6686,0,1799800,3,9,5,50,504,32750504
6687,12,1799800,1,9,5,50,516,32750516
6688,87,1799900,1,9,5,50,603,32750603
6689,2,1799900,3,9,5,50,605,32750605
6690,0,1799800,2,9,5,50,605,32750605
6691,493,1799800,5,9,5,51,98,32751098
6692,512,1800000,2,9,5,51,610,32751610
6693,53,1800000,1,9,5,51,663,32751663
6694,160,1799800,1,9,5,51,823,32751823
6695,417,1800000,5,9,5,52,240,32752240
6696,146,1799800,2,9,5,52,386,32752386
6697,894,1799900,3,9,5,53,280,32753280
6698,1220,1799900,1,9,5,54,500,32754500
6699,101,1799900,1,9,5,54,601,32754601
6700,132,1799800,1,9,5,54,733,32754733
6701,58,1800000,1,9,5,54,791,32754791
6702,638,1799900,2,9,5,55,429,32755429
6703,312,1800000,1,9,5,55,741,32755741
6704,250,1800000,1,9,5,55,991,32755991
6705,189,1799900,1,9,5,56,180,32756180
6706,273,1800000,2,9,5,56,453,32756453
6707,868,1800100,15,9,5,57,321,32757321
6708,83,1800200,2,9,5,57,404,32757404
6709,198,1800000,1,9,5,57,602,32757602
6710,98,1800000,2,9,5,57,700,32757700
6711,81,1800200,1,9,5,57,781,32757781
6712,30,1800200,1,9,5,57,811,32757811
6713,74,1800200,10,9,5,57,885,32757885
6714,152,1800000,1,9,5,58,37,32758037
6715,333,1800000,2,9,5,58,370,32758370
6716,0,1800000,2,9,5,58,370,32758370
6717,1847,1799900,1,9,6,0,217,32760217
6718,1,1799900,1,9,6,0,218,32760218
6719,53,1799900,1,9,6,0,271,32760271
6720,0,1799900,1,9,6,0,271,32760271
6722,94,1799800,1,9,6,0,365,32760365
6723,204,1800000,1,9,6,0,569,32760569
6724,12,1799800,1,9,6,0,581,32760581
6725,46,1800000,1,9,6,0,627,32760627
6726,103,1800000,1,9,6,0,730,32760730
6727,155,1800000,1,9,6,0,885,32760885
6728,149,1799800,1,9,6,1,34,32761034
6729,246,1799900,1,9,6,1,280,32761280
6730,167,1799900,4,9,6,1,447,32761447
6731,80,1800000,1,9,6,1,527,32761527
6732,48,1800000,1,9,6,1,575,32761575
6733,169,1799900,1,9,6,1,744,32761744
6735,133,1800000,1,9,6,1,877,32761877
6736,16,1800000,1,9,6,1,893,32761893
6737,142,1799900,2,9,6,2,35,32762035
6738,75,1800000,1,9,6,2,110,32762110
6739,20,1800000,2,9,6,2,130,32762130
6741,580,1800000,1,9,6,2,710,32762710
6742,326,1800000,2,9,6,3,36,32763036
6744,123,1799900,1,9,6,3,159,32763159
6745,508,1800000,1,9,6,3,667,32763667
6746,433,1799900,1,9,6,4,100,32764100
6747,158,1800000,1,9,6,4,258,32764258
6748,966,1800000,1,9,6,5,224,32765224
6749,675,1800100,1,9,6,5,899,32765899
6750,0,1800100,1,9,6,5,899,32765899
6751,1,1800100,2,9,6,5,900,32765900
6752,100,1800200,1,9,6,6,0,32766000
6753,0,1800200,7,9,6,6,0,32766000
6754,1,1800200,1,9,6,6,1,32766001
6755,0,1800200,1,9,6,6,1,32766001
6756,272,1800200,1,9,6,6,273,32766273
6757,300,1800200,2,9,6,6,573,32766573
6758,172,1800200,1,9,6,6,745,32766745
6759,69,1800300,5,9,6,6,814,32766814
6760,0,1800300,2,9,6,6,814,32766814
6761,0,1800200,1,9,6,6,814,32766814
6762,124,1800400,3,9,6,6,938,32766938
6763,98,1800400,5,9,6,7,36,32767036
6764,12,1800300,2,9,6,7,48,32767048
6765,108,1800400,3,9,6,7,156,32767156
6766,3,1800400,1,9,6,7,159,32767159
6767,199,1800200,1,9,6,7,358,32767358
6768,372,1800200,1,9,6,7,730,32767730
6769,67,1800300,1,9,6,7,797,32767797
6770,11,1800300,1,9,6,7,808,32767808
6771,36,1800400,1,9,6,7,844,32767844
6772,171,1800300,1,9,6,8,15,32768015
6773,87,1800400,1,9,6,8,102,32768102
6774,29,1800400,1,9,6,8,131,32768131
6775,101,1800400,3,9,6,8,232,32768232
6776,155,1800200,2,9,6,8,387,32768387
6777,17,1800200,1,9,6,8,404,32768404
6778,715,1800100,1,9,6,9,119,32769119
6779,0,1800100,1,9,6,9,119,32769119
6780,6,1800100,2,9,6,9,125,32769125
6781,98,1800000,1,9,6,9,223,32769223
6782,17,1800200,1,9,6,9,240,32769240
6783,287,1800200,1,9,6,9,527,32769527
6784,387,1800000,2,9,6,9,914,32769914
6785,10,1800200,1,9,6,9,924,32769924
6786,135,1800200,7,9,6,10,59,32770059
6788,470,1800100,3,9,6,10,529,32770529
6789,106,1800100,1,9,6,10,635,32770635
6790,45,1800100,1,9,6,10,680,32770680
6791,4,1800000,1,9,6,10,684,32770684
6792,2,1800000,1,9,6,10,686,32770686
6793,12,1800100,1,9,6,10,698,32770698
6795,16,1800200,4,9,6,10,714,32770714
6796,1775,1800200,1,9,6,12,489,32772489
6797,717,1800200,3,9,6,13,206,32773206
6798,840,1800200,1,9,6,14,46,32774046
6799,22,1800000,1,9,6,14,68,32774068
6800,0,1800000,2,9,6,14,68,32774068
6801,309,1800000,1,9,6,14,377,32774377
6802,250,1799900,1,9,6,14,627,32774627
6803,42,1799800,1,9,6,14,669,32774669
6804,333,1799900,3,9,6,15,2,32775002
6805,88,1799700,1,9,6,15,90,32775090
6806,373,1799900,3,9,6,15,463,32775463
6807,191,1799900,3,9,6,15,654,32775654
6809,3,1800000,21,9,6,15,657,32775657
6810,0,1800000,1,9,6,15,657,32775657
6811,192,1800100,2,9,6,15,849,32775849
6812,232,1800200,1,9,6,16,81,32776081
6813,0,1800200,1,9,6,16,81,32776081
6814,41,1800200,1,9,6,16,122,32776122
6816,270,1800100,2,9,6,16,392,32776392
6817,731,1800200,1,9,6,17,123,32777123
6818,11,1800100,2,9,6,17,134,32777134
6819,410,1800100,2,9,6,17,544,32777544
6820,747,1800100,1,9,6,18,291,32778291
6821,10,1800100,2,9,6,18,301,32778301
6822,784,1800000,1,9,6,19,85,32779085
6823,980,1800100,3,9,6,20,65,32780065
6825,1204,1800000,1,9,6,21,269,32781269
6826,389,1800200,1,9,6,21,658,32781658
6827,86,1800200,1,9,6,21,744,32781744
6828,520,1800200,1,9,6,22,264,32782264
6830,651,1800300,2,9,6,22,915,32782915
6831,770,1800300,1,9,6,23,685,32783685
6832,47,1800300,2,9,6,23,732,32783732
6833,191,1800300,1,9,6,23,923,32783923
6834,376,1800300,1,9,6,24,299,32784299
6835,1,1800300,3,9,6,24,300,32784300
6836,291,1800300,1,9,6,24,591,32784591
6837,4,1800300,1,9,6,24,595,32784595
6838,740,1800300,1,9,6,25,335,32785335
6839,555,1800300,1,9,6,25,890,32785890
6840,258,1800300,1,9,6,26,148,32786148
6841,220,1800400,1,9,6,26,368,32786368
6842,425,1800300,2,9,6,26,793,32786793
6843,234,1800300,1,9,6,27,27,32787027
6844,907,1800400,1,9,6,27,934,32787934
6845,3,1800300,1,9,6,27,937,32787937
6846,46,1800300,1,9,6,27,983,32787983
6847,12,1800400,1,9,6,27,995,32787995
6848,571,1800300,1,9,6,28,566,32788566
6849,421,1800200,1,9,6,28,987,32788987
6850,556,1800200,1,9,6,29,543,32789543
6851,184,1800300,1,9,6,29,727,32789727
6852,610,1800300,1,9,6,30,337,32790337
6853,285,1800200,1,9,6,30,622,32790622
6854,105,1800300,1,9,6,30,727,32790727
6855,1115,1800300,1,9,6,31,842,32791842
6856,436,1800200,1,9,6,32,278,32792278
6857,191,1800300,3,9,6,32,469,32792469
6859,219,1800300,1,9,6,32,688,32792688
6860,325,1800300,1,9,6,33,13,32793013
6861,100,1800400,5,9,6,33,113,32793113
6862,263,1800300,2,9,6,33,376,32793376
6864,263,1800300,2,9,6,33,639,32793639
6865,1721,1800300,1,9,6,35,360,32795360
6866,427,1800400,3,9,6,35,787,32795787
6867,1,1800400,3,9,6,35,788,32795788
6868,372,1800400,3,9,6,36,160,32796160
6869,346,1800400,1,9,6,36,506,32796506
6870,2,1800400,1,9,6,36,508,32796508
6871,210,1800300,1,9,6,36,718,32796718
6872,200,1800400,1,9,6,36,918,32796918
6873,148,1800500,1,9,6,37,66,32797066
6874,76,1800500,40,9,6,37,142,32797142
6875,24,1800500,1,9,6,37,166,32797166
6876,7,1800600,2,9,6,37,173,32797173
6877,0,1800600,3,9,6,37,173,32797173
6878,42,1800600,1,9,6,37,215,32797215
6879,1,1800600,1,9,6,37,216,32797216
6880,0,1800600,2,9,6,37,216,32797216
6881,5,1800600,5,9,6,37,221,32797221
6882,9,1800500,1,9,6,37,230,32797230
6883,42,1800700,1,9,6,37,272,32797272
6884,31,1800700,2,9,6,37,303,32797303
6885,112,1800700,2,9,6,37,415,32797415
6886,5,1800700,1,9,6,37,420,32797420
6887,40,1800500,1,9,6,37,460,32797460
6888,21,1800500,1,9,6,37,481,32797481
6889,46,1800600,2,9,6,37,527,32797527
6890,243,1800400,1,9,6,37,770,32797770
6891,68,1800200,1,9,6,37,838,32797838
6892,271,1800400,5,9,6,38,109,32798109
6893,91,1800400,1,9,6,38,200,32798200
6894,143,1800400,1,9,6,38,343,32798343
6895,877,1800500,1,9,6,39,220,32799220
6896,731,1800200,1,9,6,39,951,32799951
6897,344,1800400,1,9,6,40,295,32800295
6898,54,1800400,1,9,6,40,349,32800349
6899,289,1800300,1,9,6,40,638,32800638
6900,88,1800300,5,9,6,40,726,32800726
6901,44,1800200,1,9,6,40,770,32800770
6902,1,1800200,4,9,6,40,771,32800771
6903,77,1800200,1,9,6,40,848,32800848
6904,124,1800200,1,9,6,40,972,32800972
6905,267,1800200,1,9,6,41,239,32801239
6906,24,1800200,1,9,6,41,263,32801263
6907,345,1800200,1,9,6,41,608,32801608
6908,386,1800200,4,9,6,41,994,32801994
6910,278,1800300,3,9,6,42,272,32802272
6911,1421,1800400,1,9,6,43,693,32803693
6912,515,1800200,1,9,6,44,208,32804208
6913,320,1800200,1,9,6,44,528,32804528
6914,1114,1800500,1,9,6,45,642,32805642
6915,43,1800400,1,9,6,45,685,32805685
6916,42,1800400,2,9,6,45,727,32805727
6917,397,1800400,1,9,6,46,124,32806124
6918,690,1800400,2,9,6,46,814,32806814
6919,34,1800400,1,9,6,46,848,32806848
6920,11,1800400,1,9,6,46,859,32806859
6921,124,1800500,1,9,6,46,983,32806983
6922,154,1800500,1,9,6,47,137,32807137
6923,122,1800300,3,9,6,47,259,32807259
6924,39,1800400,1,9,6,47,298,32807298
6926,266,1800500,5,9,6,47,564,32807564
6927,1381,1800400,1,9,6,48,945,32808945
6928,317,1800500,1,9,6,49,262,32809262
6929,343,1800400,1,9,6,49,605,32809605
6930,1072,1800300,1,9,6,50,677,32810677
6931,1,1800300,7,9,6,50,678,32810678
6932,0,1800300,13,9,6,50,678,32810678
6933,46,1800200,2,9,6,50,724,32810724
6934,231,1800100,4,9,6,50,955,32810955
6935,1,1800100,5,9,6,50,956,32810956
6936,0,1800100,2,9,6,50,956,32810956
6937,121,1800200,2,9,6,51,77,32811077
6938,173,1800200,3,9,6,51,250,32811250
6939,27,1800200,1,9,6,51,277,32811277
6940,363,1800200,2,9,6,51,640,32811640
6941,19,1800200,1,9,6,51,659,32811659
6942,278,1800200,1,9,6,51,937,32811937
6943,553,1800100,2,9,6,52,490,32812490
6944,46,1800200,4,9,6,52,536,32812536
6945,539,1800100,3,9,6,53,75,32813075
6946,1,1800100,2,9,6,53,76,32813076
6947,131,1800200,1,9,6,53,207,32813207
6948,344,1800200,1,9,6,53,551,32813551
6949,302,1800200,1,9,6,53,853,32813853
6950,149,1800100,1,9,6,54,2,32814002
6951,137,1800100,1,9,6,54,139,32814139
6952,41,1800300,2,9,6,54,180,32814180
6953,30,1800100,1,9,6,54,210,32814210
6954,595,1800300,2,9,6,54,805,32814805
6955,786,1800200,1,9,6,55,591,32815591
6956,455,1800200,4,9,6,56,46,32816046
6957,5,1800100,3,9,6,56,51,32816051
6958,613,1800000,5,9,6,56,664,32816664
6959,0,1800000,1,9,6,56,664,32816664
6960,1,1800000,1,9,6,56,665,32816665
6961,0,1800000,5,9,6,56,665,32816665
6962,153,1800000,2,9,6,56,818,32816818
6963,170,1800000,1,9,6,56,988,32816988
6964,156,1799900,1,9,6,57,144,32817144
6965,0,1799900,1,9,6,57,144,32817144
6966,0,1799900,1,9,6,57,144,32817144
6967,0,1799900,1,9,6,57,144,32817144
6968,0,1799900,2,9,6,57,144,32817144
6969,0,1799900,1,9,6,57,144,32817144
6970,117,1799900,2,9,6,57,261,32817261
6971,9,1799800,2,9,6,57,270,32817270
6972,146,1799900,1,9,6,57,416,32817416
6973,430,1799900,1,9,6,57,846,32817846
6974,724,1799800,1,9,6,58,570,32818570
6976,119,1799900,1,9,6,58,689,32818689
6977,4,1799900,1,9,6,58,693,32818693
6978,146,1799900,1,9,6,58,839,32818839
6979,197,1799900,1,9,6,59,36,32819036
6980,86,1800000,6,9,6,59,122,32819122
6981,42,1800100,1,9,6,59,164,32819164
6982,487,1800100,2,9,6,59,651,32819651
6983,427,1800100,1,9,7,0,78,32820078
6984,135,1800100,1,9,7,0,213,32820213
6985,461,1800100,1,9,7,0,674,32820674
6986,0,1800100,2,9,7,0,674,32820674
6987,1345,1800100,1,9,7,2,19,32822019
6988,402,1799900,3,9,7,2,421,32822421
6990,415,1799900,1,9,7,2,836,32822836
6991,420,1800000,2,9,7,3,256,32823256
6992,611,1799900,1,9,7,3,867,32823867
6994,757,1800000,9,9,7,4,624,32824624
6995,1,1800000,1,9,7,4,625,32824625
6996,277,1800000,2,9,7,4,902,32824902
6997,0,1800000,1,9,7,4,902,32824902
6998,1,1800000,1,9,7,4,903,32824903
6999,230,1799900,1,9,7,5,133,32825133
7000,165,1800000,1,9,7,5,298,32825298
7001,1265,1800100,1,9,7,6,563,32826563
7002,332,1800100,1,9,7,6,895,32826895
7003,21,1800200,1,9,7,6,916,32826916
7004,1771,1800000,1,9,7,8,687,32828687
7005,237,1800200,1,9,7,8,924,32828924
7006,232,1800200,1,9,7,9,156,32829156
7007,243,1800100,3,9,7,9,399,32829399
7008,1520,1800000,2,9,7,10,919,32830919
7009,0,1800000,2,9,7,10,919,32830919
7010,1,1800000,1,9,7,10,920,32830920
7011,1065,1800200,1,9,7,11,985,32831985
7012,89,1800300,2,9,7,12,74,32832074
7013,276,1800200,1,9,7,12,350,32832350
7014,700,1800200,1,9,7,13,50,32833050
7015,115,1800200,2,9,7,13,165,32833165
7016,129,1800200,1,9,7,13,294,32833294
7017,1632,1800100,1,9,7,14,926,32834926
7018,321,1800100,2,9,7,15,247,32835247
7019,1,1800100,8,9,7,15,248,32835248
7020,1028,1800100,1,9,7,16,276,32836276
7021,1319,1800000,1,9,7,17,595,32837595
7022,2074,1800000,1,9,7,19,669,32839669
7023,320,1800100,5,9,7,19,989,32839989
7025,809,1800200,1,9,7,20,798,32840798
7026,221,1800200,1,9,7,21,19,32841019
7027,471,1800300,7,9,7,21,490,32841490
7028,489,1800300,1,9,7,21,979,32841979
7029,143,1800300,1,9,7,22,122,32842122
7030,11,1800400,1,9,7,22,133,32842133
7031,158,1800400,1,9,7,22,291,32842291
7032,805,1800300,1,9,7,23,96,32843096
7033,445,1800400,5,9,7,23,541,32843541
7034,1,1800400,1,9,7,23,542,32843542
7035,744,1800300,1,9,7,24,286,32844286
7036,756,1800300,2,9,7,25,42,32845042
7037,992,1800100,1,9,7,26,34,32846034
7038,0,1800300,1,9,7,26,34,32846034
7039,823,1800300,1,9,7,26,857,32846857
7040,1170,1800200,1,9,7,28,27,32848027
7042,115,1800300,1,9,7,28,142,32848142
7043,364,1800300,1,9,7,28,506,32848506
7044,1499,1800300,1,9,7,30,5,32850005
7045,0,1800300,1,9,7,30,5,32850005
7046,97,1800400,1,9,7,30,102,32850102
7047,164,1800400,1,9,7,30,266,32850266
7049,20,1800300,1,9,7,30,286,32850286
7050,894,1800500,1,9,7,31,180,32851180
7051,587,1800300,1,9,7,31,767,32851767
7052,54,1800400,2,9,7,31,821,32851821
7053,195,1800300,1,9,7,32,16,32852016
7055,1513,1800400,4,9,7,33,529,32853529
7056,485,1800500,1,9,7,34,14,32854014
7057,406,1800500,2,9,7,34,420,32854420
7058,467,1800500,1,9,7,34,887,32854887
7059,213,1800500,3,9,7,35,100,32855100
7060,43,1800500,5,9,7,35,143,32855143
7061,2,1800500,2,9,7,35,145,32855145
7062,149,1800600,5,9,7,35,294,32855294
7063,184,1800600,5,9,7,35,478,32855478
7064,47,1800600,1,9,7,35,525,32855525
7065,19,1800600,1,9,7,35,544,32855544
7066,153,1800400,1,9,7,35,697,32855697
7067,25,1800500,1,9,7,35,722,32855722
7068,784,1800500,1,9,7,36,506,32856506
7069,644,1800500,1,9,7,37,150,32857150
7070,32,1800500,1,9,7,37,182,32857182
7071,53,1800600,1,9,7,37,235,32857235
7072,60,1800600,7,9,7,37,295,32857295
7074,315,1800500,1,9,7,37,610,32857610
7075,11,1800600,1,9,7,37,621,32857621
7076,179,1800700,1,9,7,37,800,32857800
7077,1292,1800500,1,9,7,39,92,32859092
7078,13,1800600,1,9,7,39,105,32859105
7079,406,1800600,1,9,7,39,511,32859511
7080,1661,1800600,1,9,7,41,172,32861172
7081,63,1800600,1,9,7,41,235,32861235
7082,424,1800600,6,9,7,41,659,32861659
7084,277,1800600,2,9,7,41,936,32861936
7085,590,1800500,2,9,7,42,526,32862526
7086,0,1800500,2,9,7,42,526,32862526
7087,0,1800500,6,9,7,42,526,32862526
7088,0,1800500,3,9,7,42,526,32862526
7089,0,1800500,1,9,7,42,526,32862526
7090,152,1800400,1,9,7,42,678,32862678
7091,0,1800300,2,9,7,42,678,32862678
7092,0,1800300,1,9,7,42,678,32862678
7093,193,1800400,1,9,7,42,871,32862871
7094,160,1800400,1,9,7,43,31,32863031
7095,104,1800400,1,9,7,43,135,32863135
7096,215,1800400,1,9,7,43,350,32863350
7097,1890,1800200,5,9,7,45,240,32865240
7099,1,1800100,1,9,7,45,241,32865241
7100,219,1800300,1,9,7,45,460,32865460
7101,12,1800100,1,9,7,45,472,32865472
7102,1,1800100,1,9,7,45,473,32865473
7103,0,1800100,3,9,7,45,473,32865473
7104,377,1800000,4,9,7,45,850,32865850
7105,8,1799900,2,9,7,45,858,32865858
7106,60,1799900,3,9,7,45,918,32865918
7107,151,1799800,1,9,7,46,69,32866069
7108,89,1799800,1,9,7,46,158,32866158
7109,0,1799800,1,9,7,46,158,32866158
7110,1,1799800,1,9,7,46,159,32866159
7111,21,1799800,1,9,7,46,180,32866180
7112,11,1799800,1,9,7,46,191,32866191
7113,88,1799700,8,9,7,46,279,32866279
7115,196,1799700,1,9,7,46,475,32866475
7116,225,1799600,1,9,7,46,700,32866700
7117,712,1799600,1,9,7,47,412,32867412
7118,0,1799600,2,9,7,47,412,32867412
7119,1,1799600,2,9,7,47,413,32867413
7120,108,1799600,1,9,7,47,521,32867521
7121,13,1799600,1,9,7,47,534,32867534
7122,109,1799500,5,9,7,47,643,32867643
7123,38,1799600,1,9,7,47,681,32867681
7124,24,1799600,1,9,7,47,705,32867705
7125,40,1799600,1,9,7,47,745,32867745
7126,0,1799600,1,9,7,47,745,32867745
7127,60,1799600,1,9,7,47,805,32867805
7128,139,1799600,1,9,7,47,944,32867944
7129,151,1799600,1,9,7,48,95,32868095
7130,806,1799600,3,9,7,48,901,32868901
7131,112,1799700,2,9,7,49,13,32869013
7132,52,1799700,1,9,7,49,65,32869065
7133,1125,1799800,2,9,7,50,190,32870190
7134,0,1799700,1,9,7,50,190,32870190
7135,605,1799900,3,9,7,50,795,32870795
7136,884,1799800,1,9,7,51,679,32871679
7137,224,1799900,2,9,7,51,903,32871903
7138,315,1799900,5,9,7,52,218,32872218
7139,259,1800000,1,9,7,52,477,32872477
7140,92,1800000,1,9,7,52,569,32872569
7141,10,1800000,3,9,7,52,579,32872579
7142,126,1800000,1,9,7,52,705,32872705
7143,327,1800000,2,9,7,53,32,32873032
7144,830,1799800,1,9,7,53,862,32873862
7145,0,1800000,1,9,7,53,862,32873862
7146,339,1799900,1,9,7,54,201,32874201
7147,0,1799900,1,9,7,54,201,32874201
7148,651,1799800,1,9,7,54,852,32874852
7149,382,1799800,1,9,7,55,234,32875234
7150,0,1799700,1,9,7,55,234,32875234
7151,436,1799900,1,9,7,55,670,32875670
7152,113,1799900,2,9,7,55,783,32875783
7153,817,1800000,1,9,7,56,600,32876600
7154,0,1800000,2,9,7,56,600,32876600
7155,0,1800000,3,9,7,56,600,32876600
7156,400,1800000,1,9,7,57,0,32877000
7157,5,1799900,1,9,7,57,5,32877005
7158,24,1800000,1,9,7,57,29,32877029
7159,533,1800000,1,9,7,57,562,32877562
7160,557,1800000,1,9,7,58,119,32878119
7161,841,1800000,1,9,7,58,960,32878960
7162,730,1800000,2,9,7,59,690,32879690
7163,214,1799800,5,9,7,59,904,32879904
7164,165,1799900,1,9,8,0,69,32880069
7165,217,1799800,1,9,8,0,286,32880286
7166,275,1799700,1,9,8,0,561,32880561
7167,33,1799700,1,9,8,0,594,32880594
7168,7,1799900,1,9,8,0,601,32880601
7169,256,1799800,1,9,8,0,857,32880857
7170,76,1800000,7,9,8,0,933,32880933
7171,513,1800000,1,9,8,1,446,32881446
7172,465,1800200,1,9,8,1,911,32881911
7173,11,1800200,1,9,8,1,922,32881922
7174,189,1800200,1,9,8,2,111,32882111
7175,2,1800100,1,9,8,2,113,32882113
7176,504,1800000,3,9,8,2,617,32882617
7177,1,1800000,3,9,8,2,618,32882618
7178,139,1800000,1,9,8,2,757,32882757
7179,505,1800100,1,9,8,3,262,32883262
7180,654,1800200,2,9,8,3,916,32883916
7181,168,1800100,1,9,8,4,84,32884084
7182,711,1800200,2,9,8,4,795,32884795
7183,586,1800100,5,9,8,5,381,32885381
7185,2,1800100,1,9,8,5,383,32885383
7186,224,1800100,3,9,8,5,607,32885607
7187,467,1800200,6,9,8,6,74,32886074
7189,162,1800100,1,9,8,6,236,32886236
7190,570,1800200,1,9,8,6,806,32886806
7191,503,1800100,5,9,8,7,309,32887309
7193,3,1800100,1,9,8,7,312,32887312
7194,847,1799900,1,9,8,8,159,32888159
7195,251,1800100,1,9,8,8,410,32888410
7196,1487,1799900,1,9,8,9,897,32889897
7197,0,1799800,1,9,8,9,897,32889897
7198,1,1799800,6,9,8,9,898,32889898
7199,0,1799800,1,9,8,9,898,32889898
7200,1,1799800,1,9,8,9,899,32889899
7201,54,1799800,2,9,8,9,953,32889953
7202,180,1799800,1,9,8,10,133,32890133
7203,95,1799900,1,9,8,10,228,32890228
7204,217,1799900,1,9,8,10,445,32890445
7205,1,1799900,2,9,8,10,446,32890446
7206,989,1799800,1,9,8,11,435,32891435
7207,148,1799700,3,9,8,11,583,32891583
7209,267,1799800,3,9,8,11,850,32891850
7210,31,1799800,1,9,8,11,881,32891881
7211,78,1799700,5,9,8,11,959,32891959
7212,392,1799600,6,9,8,12,351,32892351
7213,95,1799600,1,9,8,12,446,32892446
7214,290,1799500,1,9,8,12,736,32892736
7215,663,1799500,5,9,8,13,399,32893399
7216,253,1799500,1,9,8,13,652,32893652
7217,720,1799600,1,9,8,14,372,32894372
7218,197,1799600,1,9,8,14,569,32894569
7219,1,1799600,3,9,8,14,570,32894570
7220,7,1799500,1,9,8,14,577,32894577
7221,9,1799500,1,9,8,14,586,32894586
7222,167,1799600,1,9,8,14,753,32894753
7223,1277,1799700,1,9,8,16,30,32896030
7224,50,1799600,1,9,8,16,80,32896080
7225,444,1799600,1,9,8,16,524,32896524
7226,598,1799600,1,9,8,17,122,32897122
7227,0,1799600,1,9,8,17,122,32897122
7228,579,1799700,1,9,8,17,701,32897701
7229,7,1799700,4,9,8,17,708,32897708
7230,405,1799700,3,9,8,18,113,32898113
7231,522,1799600,1,9,8,18,635,32898635
7232,196,1799700,1,9,8,18,831,32898831
7233,764,1799600,1,9,8,19,595,32899595
7234,147,1799500,1,9,8,19,742,32899742
7235,1,1799500,1,9,8,19,743,32899743
7236,1446,1799400,3,9,8,21,189,32901189
7238,1,1799300,2,9,8,21,190,32901190
7239,1,1799300,1,9,8,21,191,32901191
7240,190,1799300,1,9,8,21,381,32901381
7241,0,1799200,1,9,8,21,381,32901381
7242,167,1799200,1,9,8,21,548,32901548
7243,5,1799300,1,9,8,21,553,32901553
7244,172,1799300,1,9,8,21,725,32901725
7245,30,1799200,2,9,8,21,755,32901755
7246,101,1799200,1,9,8,21,856,32901856
7247,189,1799300,1,9,8,22,45,32902045
7248,136,1799300,1,9,8,22,181,32902181
7249,55,1799200,1,9,8,22,236,32902236
7250,119,1799200,1,9,8,22,355,32902355
7251,295,1799300,1,9,8,22,650,32902650
7252,147,1799200,1,9,8,22,797,32902797
7253,98,1799300,1,9,8,22,895,32902895
7254,28,1799300,1,9,8,22,923,32902923
7255,305,1799200,1,9,8,23,228,32903228
7256,101,1799200,1,9,8,23,329,32903329
7257,102,1799300,1,9,8,23,431,32903431
7258,110,1799200,1,9,8,23,541,32903541
7259,318,1799200,1,9,8,23,859,32903859
7260,105,1799200,1,9,8,23,964,32903964
7261,294,1799300,1,9,8,24,258,32904258
7262,185,1799200,1,9,8,24,443,32904443
7263,147,1799300,1,9,8,24,590,32904590
7264,8,1799400,2,9,8,24,598,32904598
7265,1020,1799500,1,9,8,25,618,32905618
7266,168,1799300,1,9,8,25,786,32905786
7268,402,1799300,3,9,8,26,188,32906188
7269,505,1799300,1,9,8,26,693,32906693
7270,318,1799400,1,9,8,27,11,32907011
7271,92,1799400,2,9,8,27,103,32907103
7272,308,1799300,1,9,8,27,411,32907411
7273,644,1799400,1,9,8,28,55,32908055
7275,281,1799300,1,9,8,28,336,32908336
7276,34,1799400,2,9,8,28,370,32908370
7277,1091,1799400,1,9,8,29,461,32909461
7278,344,1799500,1,9,8,29,805,32909805
7279,90,1799400,3,9,8,29,895,32909895
7280,260,1799500,1,9,8,30,155,32910155
7281,240,1799400,1,9,8,30,395,32910395
7282,104,1799500,1,9,8,30,499,32910499
7283,686,1799300,1,9,8,31,185,32911185
7284,0,1799200,5,9,8,31,185,32911185
7285,1,1799200,2,9,8,31,186,32911186
7286,178,1799100,2,9,8,31,364,32911364
7287,0,1799100,7,9,8,31,364,32911364
7288,299,1799000,2,9,8,31,663,32911663
7289,1,1799000,7,9,8,31,664,32911664
7290,0,1799000,1,9,8,31,664,32911664
7291,0,1799000,1,9,8,31,664,32911664
7292,0,1799000,2,9,8,31,664,32911664
7293,0,1799000,1,9,8,31,664,32911664
7294,0,1799000,2,9,8,31,664,32911664
7295,135,1798900,1,9,8,31,799,32911799
7296,100,1798900,3,9,8,31,899,32911899
7297,39,1798900,2,9,8,31,938,32911938
7299,362,1798800,1,9,8,32,300,32912300
7300,0,1798800,8,9,8,32,300,32912300
7301,69,1798700,1,9,8,32,369,32912369
7302,26,1798700,1,9,8,32,395,32912395
7303,30,1798700,1,9,8,32,425,32912425
7304,31,1798700,1,9,8,32,456,32912456
7305,6,1798700,4,9,8,32,462,32912462
7306,40,1798600,1,9,8,32,502,32912502
7307,36,1798700,1,9,8,32,538,32912538
7308,650,1798600,1,9,8,33,188,32913188
7309,283,1798500,1,9,8,33,471,32913471
7310,84,1798500,1,9,8,33,555,32913555
7311,43,1798500,1,9,8,33,598,32913598
7312,1,1798500,6,9,8,33,599,32913599
7313,0,1798500,3,9,8,33,599,32913599
7314,86,1798400,4,9,8,33,685,32913685
7315,55,1798300,5,9,8,33,740,32913740
7316,0,1798300,2,9,8,33,740,32913740
7317,119,1798200,1,9,8,33,859,32913859
7318,16,1798400,1,9,8,33,875,32913875
7319,121,1798400,1,9,8,33,996,32913996
7320,15,1798500,1,9,8,34,11,32914011
7321,1,1798500,2,9,8,34,12,32914012
7322,18,1798400,1,9,8,34,30,32914030
7323,20,1798400,1,9,8,34,50,32914050
7324,26,1798400,1,9,8,34,76,32914076
7325,11,1798600,1,9,8,34,87,32914087
7326,251,1798400,1,9,8,34,338,32914338
7327,46,1798400,1,9,8,34,384,32914384
7328,112,1798400,1,9,8,34,496,32914496
7329,50,1798400,2,9,8,34,546,32914546
7330,26,1798400,1,9,8,34,572,32914572
7331,724,1798500,1,9,8,35,296,32915296
7332,198,1798600,1,9,8,35,494,32915494
7333,172,1798600,3,9,8,35,666,32915666
7334,79,1798500,1,9,8,35,745,32915745
7335,307,1798600,1,9,8,36,52,32916052
7336,11,1798600,2,9,8,36,63,32916063
7337,0,1798600,2,9,8,36,63,32916063
7339,25,1798700,1,9,8,36,88,32916088
7340,279,1798600,2,9,8,36,367,32916367
7341,78,1798800,3,9,8,36,445,32916445
7342,18,1798700,1,9,8,36,463,32916463
7343,78,1798800,1,9,8,36,541,32916541
7344,101,1798800,2,9,8,36,642,32916642
7345,928,1799000,1,9,8,37,570,32917570
7346,234,1799000,16,9,8,37,804,32917804
7347,487,1799100,1,9,8,38,291,32918291
7348,84,1799300,1,9,8,38,375,32918375
7349,469,1799300,1,9,8,38,844,32918844
7350,6,1799300,2,9,8,38,850,32918850
7351,1915,1799200,2,9,8,40,765,32920765
7353,12,1799100,1,9,8,40,777,32920777
7354,0,1799000,4,9,8,40,777,32920777
7355,99,1798900,1,9,8,40,876,32920876
7356,0,1798900,3,9,8,40,876,32920876
7357,304,1799100,1,9,8,41,180,32921180
7358,45,1799000,1,9,8,41,225,32921225
7359,9,1799100,1,9,8,41,234,32921234
7360,1667,1799100,2,9,8,42,901,32922901
7362,2,1799000,1,9,8,42,903,32922903
7363,65,1799200,1,9,8,42,968,32922968
7364,0,1799200,1,9,8,42,968,32922968
7365,0,1799200,1,9,8,42,968,32922968
7366,269,1799100,2,9,8,43,237,32923237
7367,407,1799100,2,9,8,43,644,32923644
7368,59,1799000,1,9,8,43,703,32923703
7369,22,1798900,3,9,8,43,725,32923725
7370,368,1798800,1,9,8,44,93,32924093
7371,0,1798800,2,9,8,44,93,32924093
7372,111,1798800,1,9,8,44,204,32924204
7373,3,1798800,2,9,8,44,207,32924207
7374,54,1798800,1,9,8,44,261,32924261
7375,261,1798900,1,9,8,44,522,32924522
7376,628,1798700,2,9,8,45,150,32925150
7377,0,1798700,1,9,8,45,150,32925150
7378,0,1798700,1,9,8,45,150,32925150
7379,407,1798700,1,9,8,45,557,32925557
7380,125,1798700,1,9,8,45,682,32925682
7381,813,1798700,1,9,8,46,495,32926495
7383,82,1798700,1,9,8,46,577,32926577
7384,192,1798700,1,9,8,46,769,32926769
7385,233,1798700,1,9,8,47,2,32927002
7386,632,1798700,4,9,8,47,634,32927634
7387,0,1798700,4,9,8,47,634,32927634
7388,0,1798700,4,9,8,47,634,32927634
7389,0,1798700,4,9,8,47,634,32927634
7391,3,1799100,1,9,8,47,637,32927637
7392,1,1799100,2,9,8,47,638,32927638
7393,0,1799100,34,9,8,47,638,32927638
7394,0,1799100,1,9,8,47,638,32927638
7395,0,1799100,1,9,8,47,638,32927638
7396,1,1799200,1,9,8,47,639,32927639
7397,0,1799100,1,9,8,47,639,32927639
7398,0,1799200,1,9,8,47,639,32927639
7399,0,1799200,2,9,8,47,639,32927639
7400,0,1799200,1,9,8,47,639,32927639
7401,0,1799200,1,9,8,47,639,32927639
7402,1,1799100,31,9,8,47,640,32927640
7403,0,1799100,2,9,8,47,640,32927640
7404,0,1799100,57,9,8,47,640,32927640
7405,1,1799200,1,9,8,47,641,32927641
7406,1,1799200,1,9,8,47,642,32927642
7407,1,1799000,1,9,8,47,643,32927643
7408,1,1799100,1,9,8,47,644,32927644
7409,0,1799000,1,9,8,47,644,32927644
7410,0,1799000,1,9,8,47,644,32927644
7411,0,1799000,1,9,8,47,644,32927644
7412,7,1799000,1,9,8,47,651,32927651
7413,0,1799000,1,9,8,47,651,32927651
7414,0,1799000,1,9,8,47,651,32927651
7416,1,1799000,2,9,8,47,652,32927652
7417,4,1799000,3,9,8,47,656,32927656
7418,1,1799000,1,9,8,47,657,32927657
7419,4,1799000,2,9,8,47,661,32927661
7420,10,1799100,3,9,8,47,671,32927671
7421,0,1799100,1,9,8,47,671,32927671
7422,0,1799100,1,9,8,47,671,32927671
7423,13,1799000,3,9,8,47,684,32927684
7424,26,1799100,3,9,8,47,710,32927710
7426,54,1799100,3,9,8,47,764,32927764
7428,2,1799200,1,9,8,47,766,32927766
7429,1,1799100,2,9,8,47,767,32927767
7430,93,1799100,1,9,8,47,860,32927860
7431,156,1799000,1,9,8,48,16,32928016
7432,1,1799000,1,9,8,48,17,32928017
7433,601,1798800,1,9,8,48,618,32928618
7434,35,1798800,1,9,8,48,653,32928653
7435,448,1798800,1,9,8,49,101,32929101
7436,270,1799000,4,9,8,49,371,32929371
7437,33,1798800,1,9,8,49,404,32929404
7438,421,1798900,1,9,8,49,825,32929825
7439,29,1798800,1,9,8,49,854,32929854
7440,1,1798800,1,9,8,49,855,32929855
7441,297,1798800,1,9,8,50,152,32930152
7442,75,1798800,1,9,8,50,227,32930227
7443,67,1798700,1,9,8,50,294,32930294
7444,555,1798900,4,9,8,50,849,32930849
7445,91,1799000,1,9,8,50,940,32930940
7446,50,1799000,1,9,8,50,990,32930990
7447,42,1798900,1,9,8,51,32,32931032
7448,136,1799100,1,9,8,51,168,32931168
7449,446,1799100,1,9,8,51,614,32931614
7450,91,1799100,2,9,8,51,705,32931705
7451,66,1799100,1,9,8,51,771,32931771
7452,82,1799100,1,9,8,51,853,32931853
7453,1072,1799100,1,9,8,52,925,32932925
7454,864,1799000,1,9,8,53,789,32933789
7455,143,1799100,1,9,8,53,932,32933932
7456,94,1799100,1,9,8,54,26,32934026
7457,202,1799100,1,9,8,54,228,32934228
7458,0,1799100,3,9,8,54,228,32934228
7459,102,1799100,1,9,8,54,330,32934330
7460,134,1799200,3,9,8,54,464,32934464
7462,113,1799200,1,9,8,54,577,32934577
7463,1004,1799200,1,9,8,55,581,32935581
7464,2232,1799200,3,9,8,57,813,32937813
7465,91,1799300,5,9,8,57,904,32937904
7466,0,1799300,6,9,8,57,904,32937904
7467,265,1799300,2,9,8,58,169,32938169
7468,500,1799300,3,9,8,58,669,32938669
7469,47,1799400,5,9,8,58,716,32938716
7470,0,1799400,1,9,8,58,716,32938716
7471,0,1799400,1,9,8,58,716,32938716
7472,0,1799400,1,9,8,58,716,32938716
7473,0,1799400,1,9,8,58,716,32938716
7474,693,1799300,1,9,8,59,409,32939409
7475,60,1799500,2,9,8,59,469,32939469
7476,1129,1799500,4,9,9,0,598,32940598
7478,340,1799500,1,9,9,0,938,32940938
7479,77,1799600,2,9,9,1,15,32941015
7480,428,1799500,1,9,9,1,443,32941443
7481,67,1799500,2,9,9,1,510,32941510
7483,60,1799600,1,9,9,1,570,32941570
7484,16,1799600,1,9,9,1,586,32941586
7485,256,1799600,1,9,9,1,842,32941842
7486,1109,1799500,1,9,9,2,951,32942951
7487,338,1799600,3,9,9,3,289,32943289
7488,281,1799500,1,9,9,3,570,32943570
7489,796,1799400,4,9,9,4,366,32944366
7491,464,1799500,3,9,9,4,830,32944830
7492,147,1799600,1,9,9,4,977,32944977
7493,346,1799500,1,9,9,5,323,32945323
7494,386,1799500,1,9,9,5,709,32945709
7495,155,1799600,1,9,9,5,864,32945864
7496,1610,1799400,1,9,9,7,474,32947474
7497,576,1799500,1,9,9,8,50,32948050
7498,397,1799500,3,9,9,8,447,32948447
7499,812,1799400,3,9,9,9,259,32949259
7500,1618,1799400,1,9,9,10,877,32950877
7501,20,1799500,1,9,9,10,897,32950897
7502,779,1799500,1,9,9,11,676,32951676
7503,276,1799600,9,9,9,11,952,32951952
7504,3,1799600,1,9,9,11,955,32951955
7505,1350,1799700,1,9,9,13,305,32953305
7506,172,1799700,5,9,9,13,477,32953477
7507,1,1799700,1,9,9,13,478,32953478
7508,305,1799700,1,9,9,13,783,32953783
7509,110,1799600,1,9,9,13,893,32953893
7510,139,1799600,1,9,9,14,32,32954032
7511,57,1799500,14,9,9,14,89,32954089
7512,42,1799400,1,9,9,14,131,32954131
7513,1,1799400,2,9,9,14,132,32954132
7514,0,1799400,2,9,9,14,132,32954132
7515,430,1799400,1,9,9,14,562,32954562
7517,432,1799300,3,9,9,14,994,32954994
7518,321,1799200,2,9,9,15,315,32955315
7519,246,1799100,2,9,9,15,561,32955561
7520,44,1799000,1,9,9,15,605,32955605
7521,0,1799000,2,9,9,15,605,32955605
7522,0,1799000,1,9,9,15,605,32955605
7523,127,1799000,1,9,9,15,732,32955732
7524,24,1798900,1,9,9,15,756,32955756
7525,274,1798900,1,9,9,16,30,32956030
7526,26,1798800,1,9,9,16,56,32956056
7527,19,1798800,1,9,9,16,75,32956075
7528,68,1798800,3,9,9,16,143,32956143
7529,91,1798800,1,9,9,16,234,32956234
7530,12,1798800,3,9,9,16,246,32956246
7531,167,1798700,2,9,9,16,413,32956413
7532,30,1798800,1,9,9,16,443,32956443
7533,99,1798700,1,9,9,16,542,32956542
7534,57,1798600,1,9,9,16,599,32956599
7535,21,1798800,3,9,9,16,620,32956620
7537,222,1798600,1,9,9,16,842,32956842
7538,138,1798700,1,9,9,16,980,32956980
7539,523,1798800,1,9,9,17,503,32957503
7540,37,1798800,1,9,9,17,540,32957540
7541,222,1798800,1,9,9,17,762,32957762
7542,350,1798800,2,9,9,18,112,32958112
7543,138,1798900,1,9,9,18,250,32958250
7545,241,1798800,1,9,9,18,491,32958491
7546,154,1798800,1,9,9,18,645,32958645
7547,10,1798800,1,9,9,18,655,32958655
7548,314,1798900,1,9,9,18,969,32958969
7549,160,1798800,1,9,9,19,129,32959129
7550,1379,1798900,3,9,9,20,508,32960508
7551,445,1798700,1,9,9,20,953,32960953
7552,39,1798800,2,9,9,20,992,32960992
7553,26,1798800,1,9,9,21,18,32961018
7554,212,1798800,1,9,9,21,230,32961230
7555,71,1798800,1,9,9,21,301,32961301
7556,57,1798800,1,9,9,21,358,32961358
7557,1264,1798800,1,9,9,22,622,32962622
7558,631,1798900,1,9,9,23,253,32963253
7559,174,1798900,1,9,9,23,427,32963427
7560,1607,1798900,1,9,9,25,34,32965034
7561,1429,1798900,1,9,9,26,463,32966463
7562,482,1799300,3,9,9,26,945,32966945
7564,331,1799400,1,9,9,27,276,32967276
7565,486,1799200,2,9,9,27,762,32967762
7566,384,1799400,3,9,9,28,146,32968146
7568,2,1799400,1,9,9,28,148,32968148
7569,10,1799300,1,9,9,28,158,32968158
7570,971,1799300,1,9,9,29,129,32969129
7571,935,1799400,2,9,9,30,64,32970064
7573,1007,1799400,1,9,9,31,71,32971071
7574,2885,1799400,1,9,9,33,956,32973956
7575,93,1799400,1,9,9,34,49,32974049
7576,162,1799500,1,9,9,34,211,32974211
7577,909,1799400,1,9,9,35,120,32975120
7578,10,1799400,1,9,9,35,130,32975130
7579,195,1799400,1,9,9,35,325,32975325
7580,150,1799300,1,9,9,35,475,32975475
7581,280,1799300,1,9,9,35,755,32975755
7582,190,1799300,3,9,9,35,945,32975945
7584,577,1799400,2,9,9,36,522,32976522
7585,16,1799500,2,9,9,36,538,32976538
7586,238,1799500,1,9,9,36,776,32976776
7587,730,1799600,1,9,9,37,506,32977506
7588,512,1799600,3,9,9,38,18,32978018
7589,3,1799500,1,9,9,38,21,32978021
7590,621,1799700,1,9,9,38,642,32978642
7591,0,1799700,1,9,9,38,642,32978642
7592,0,1799700,2,9,9,38,642,32978642
7593,359,1799700,1,9,9,39,1,32979001
7594,18,1799600,2,9,9,39,19,32979019
7595,224,1799600,1,9,9,39,243,32979243
7596,66,1799600,1,9,9,39,309,32979309
7597,633,1799700,2,9,9,39,942,32979942
7599,37,1799800,1,9,9,39,979,32979979
7600,32,1799600,1,9,9,40,11,32980011
7601,13,1799800,1,9,9,40,24,32980024
7602,73,1799800,1,9,9,40,97,32980097
7603,169,1799600,1,9,9,40,266,32980266
7604,291,1799700,1,9,9,40,557,32980557
7605,37,1799700,2,9,9,40,594,32980594
7606,296,1799700,1,9,9,40,890,32980890
7607,771,1799600,1,9,9,41,661,32981661
7608,0,1799500,3,9,9,41,661,32981661
7609,42,1799600,1,9,9,41,703,32981703
7610,118,1799600,1,9,9,41,821,32981821
7611,978,1799500,1,9,9,42,799,32982799
7612,2312,1799200,1,9,9,45,111,32985111
7613,834,1799400,1,9,9,45,945,32985945
7614,404,1799400,1,9,9,46,349,32986349
7615,547,1799300,1,9,9,46,896,32986896
7616,2501,1799400,1,9,9,49,397,32989397
7617,764,1799300,1,9,9,50,161,32990161
7618,1581,1799300,1,9,9,51,742,32991742
7619,413,1799400,1,9,9,52,155,32992155
7620,888,1799400,1,9,9,53,43,32993043
7621,1,1799400,6,9,9,53,44,32993044
7622,1,1799400,1,9,9,53,45,32993045
7623,2,1799500,5,9,9,53,47,32993047
7624,46,1799600,4,9,9,53,93,32993093
7625,68,1799600,3,9,9,53,161,32993161
7627,1380,1799700,4,9,9,54,541,32994541
7628,44,1799800,1,9,9,54,585,32994585
7629,0,1799800,1,9,9,54,585,32994585
7630,132,1799700,1,9,9,54,717,32994717
7631,132,1799800,7,9,9,54,849,32994849
7632,604,1799800,1,9,9,55,453,32995453
7633,75,1799900,1,9,9,55,528,32995528
7634,0,1799900,5,9,9,55,528,32995528
7635,1,1799900,2,9,9,55,529,32995529
7636,0,1799900,2,9,9,55,529,32995529
7637,160,1799900,1,9,9,55,689,32995689
7638,133,1800000,2,9,9,55,822,32995822
7639,0,1800000,3,9,9,55,822,32995822
7640,1,1800000,3,9,9,55,823,32995823
7641,0,1800000,1,9,9,55,823,32995823
7642,0,1800000,1,9,9,55,823,32995823
7643,0,1800000,1,9,9,55,823,32995823
7644,58,1800100,1,9,9,55,881,32995881
7645,0,1800100,1,9,9,55,881,32995881
7646,3,1800100,1,9,9,55,884,32995884
7647,11,1800100,1,9,9,55,895,32995895
7648,119,1800000,1,9,9,56,14,32996014
7649,31,1800100,2,9,9,56,45,32996045
7650,0,1800100,1,9,9,56,45,32996045
7651,96,1800000,1,9,9,56,141,32996141
7652,91,1800000,1,9,9,56,232,32996232
7653,17,1800000,1,9,9,56,249,32996249
7654,106,1800100,1,9,9,56,355,32996355
7655,386,1800000,2,9,9,56,741,32996741
7656,80,1799900,1,9,9,56,821,32996821
7657,299,1800000,1,9,9,57,120,32997120
7658,320,1799900,1,9,9,57,440,32997440
7660,70,1799900,1,9,9,57,510,32997510
7662,38,1799800,1,9,9,57,548,32997548
7663,206,1800000,3,9,9,57,754,32997754
7664,1,1800000,2,9,9,57,755,32997755
7665,248,1800000,1,9,9,58,3,32998003
7666,748,1799700,1,9,9,58,751,32998751
7667,906,1800000,5,9,9,59,657,32999657
7668,752,1800000,1,9,10,0,409,33000409
7669,1,1800000,4,9,10,0,410,33000410
7670,67,1800000,2,9,10,0,477,33000477
7672,1,1800100,1,9,10,0,478,33000478
7673,0,1800100,1,9,10,0,478,33000478
7674,0,1800100,1,9,10,0,478,33000478
7675,0,1800100,1,9,10,0,478,33000478
7676,137,1799900,1,9,10,0,615,33000615
7677,123,1800100,2,9,10,0,738,33000738
7678,149,1800000,1,9,10,0,887,33000887
7679,47,1800100,2,9,10,0,934,33000934
7680,122,1800100,2,9,10,1,56,33001056
7681,21,1800200,2,9,10,1,77,33001077
7682,45,1800200,2,9,10,1,122,33001122
7683,116,1800100,1,9,10,1,238,33001238
7684,1,1800100,1,9,10,1,239,33001239
7685,309,1800000,1,9,10,1,548,33001548
7686,43,1800100,1,9,10,1,591,33001591
7687,25,1800100,1,9,10,1,616,33001616
7688,40,1800100,1,9,10,1,656,33001656
7689,143,1800200,2,9,10,1,799,33001799
7690,54,1800000,2,9,10,1,853,33001853
7691,31,1800200,1,9,10,1,884,33001884
7692,117,1800000,1,9,10,2,1,33002001
7693,390,1800100,1,9,10,2,391,33002391
7694,385,1800200,1,9,10,2,776,33002776
7695,94,1800200,1,9,10,2,870,33002870
7696,67,1800200,1,9,10,2,937,33002937
7697,21,1800200,1,9,10,2,958,33002958
7698,2,1800200,6,9,10,2,960,33002960
7699,59,1800300,1,9,10,3,19,33003019
7700,172,1800300,1,9,10,3,191,33003191
7701,93,1800300,1,9,10,3,284,33003284
7702,23,1800300,1,9,10,3,307,33003307
7703,395,1800100,8,9,10,3,702,33003702
7705,27,1800200,1,9,10,3,729,33003729
7706,190,1799900,5,9,10,3,919,33003919
7707,87,1799900,2,9,10,4,6,33004006
7708,247,1800000,1,9,10,4,253,33004253
7709,434,1800000,1,9,10,4,687,33004687
7710,2643,1800000,2,9,10,7,330,33007330
7711,38,1799900,2,9,10,7,368,33007368
7712,0,1799900,2,9,10,7,368,33007368
7713,0,1799900,2,9,10,7,368,33007368
7714,0,1799900,2,9,10,7,368,33007368
7715,0,1799900,2,9,10,7,368,33007368
7717,4,1799400,1,9,10,7,372,33007372
7718,7,1799600,1,9,10,7,379,33007379
7719,22,1799600,1,9,10,7,401,33007401
7720,25,1799500,2,9,10,7,426,33007426
7721,3,1799600,1,9,10,7,429,33007429
7722,141,1799500,4,9,10,7,570,33007570
7723,95,1799500,1,9,10,7,665,33007665
7724,360,1799700,1,9,10,8,25,33008025
7725,75,1799700,1,9,10,8,100,33008100
7726,1,1799700,1,9,10,8,101,33008101
7727,0,1799700,1,9,10,8,101,33008101
7728,1,1799700,1,9,10,8,102,33008102
7729,105,1799500,1,9,10,8,207,33008207
7730,126,1799500,1,9,10,8,333,33008333
7731,208,1799600,1,9,10,8,541,33008541
7732,1,1799600,1,9,10,8,542,33008542
7733,370,1799600,1,9,10,8,912,33008912
7734,51,1799600,1,9,10,8,963,33008963
7735,24,1799600,1,9,10,8,987,33008987
7736,627,1799600,1,9,10,9,614,33009614
7737,1,1799600,7,9,10,9,615,33009615
7738,2,1799700,1,9,10,9,617,33009617
7739,22,1799500,1,9,10,9,639,33009639
7740,361,1799700,1,9,10,10,0,33010000
7741,432,1799600,1,9,10,10,432,33010432
7742,168,1799600,1,9,10,10,600,33010600
7743,832,1799600,1,9,10,11,432,33011432
7744,95,1799600,2,9,10,11,527,33011527
7745,1,1799500,2,9,10,11,528,33011528
7746,0,1799500,1,9,10,11,528,33011528
7747,9,1799600,1,9,10,11,537,33011537
7748,106,1799600,1,9,10,11,643,33011643
7749,302,1799700,2,9,10,11,945,33011945
7750,53,1799600,1,9,10,11,998,33011998
7751,135,1799800,1,9,10,12,133,33012133
7752,26,1799700,1,9,10,12,159,33012159
7753,62,1799700,1,9,10,12,221,33012221
7755,2005,1799700,1,9,10,14,226,33014226
7756,39,1799800,1,9,10,14,265,33014265
7757,201,1799900,1,9,10,14,466,33014466
7758,0,1799900,2,9,10,14,466,33014466
7759,143,1800000,3,9,10,14,609,33014609
7760,11,1800000,1,9,10,14,620,33014620
7761,1413,1800000,3,9,10,16,33,33016033
7762,146,1800000,1,9,10,16,179,33016179
7763,1,1800100,7,9,10,16,180,33016180
7764,158,1800100,1,9,10,16,338,33016338
7765,601,1800200,1,9,10,16,939,33016939
7766,166,1800100,1,9,10,17,105,33017105
7767,120,1800200,1,9,10,17,225,33017225
7768,0,1800200,1,9,10,17,225,33017225
7769,0,1800200,1,9,10,17,225,33017225
7770,0,1800300,1,9,10,17,225,33017225
7771,1,1800300,1,9,10,17,226,33017226
7772,0,1800300,1,9,10,17,226,33017226
7773,482,1800200,1,9,10,17,708,33017708
7774,1346,1800200,1,9,10,19,54,33019054
7775,50,1800200,1,9,10,19,104,33019104
7776,179,1800100,8,9,10,19,283,33019283
7777,1,1800300,9,9,10,19,284,33019284
7778,4,1800300,1,9,10,19,288,33019288
7779,96,1800100,1,9,10,19,384,33019384
7780,699,1800100,1,9,10,20,83,33020083
7781,53,1800100,1,9,10,20,136,33020136
7782,179,1800100,1,9,10,20,315,33020315
7783,625,1800000,1,9,10,20,940,33020940
7784,40,1800000,2,9,10,20,980,33020980
7785,47,1800100,1,9,10,21,27,33021027
7786,298,1800000,1,9,10,21,325,33021325
7787,1817,1800000,2,9,10,23,142,33023142
7788,612,1800000,1,9,10,23,754,33023754
7789,228,1800000,1,9,10,23,982,33023982
7790,985,1800000,3,9,10,24,967,33024967
7791,260,1799900,1,9,10,25,227,33025227
7792,2107,1799900,2,9,10,27,334,33027334
7793,957,1800000,2,9,10,28,291,33028291
7794,102,1800100,3,9,10,28,393,33028393
7795,957,1800200,15,9,10,29,350,33029350
7796,1,1800200,3,9,10,29,351,33029351
7797,43,1800300,3,9,10,29,394,33029394
7798,876,1800300,1,9,10,30,270,33030270
7799,696,1800200,1,9,10,30,966,33030966
7800,561,1800100,2,9,10,31,527,33031527
7801,1829,1800100,1,9,10,33,356,33033356
7802,28,1800100,1,9,10,33,384,33033384
7803,73,1800100,2,9,10,33,457,33033457
7804,43,1800000,1,9,10,33,500,33033500
7805,11,1800000,1,9,10,33,511,33033511
7806,210,1800000,2,9,10,33,721,33033721
7807,0,1800000,1,9,10,33,721,33033721
7808,0,1800000,2,9,10,33,721,33033721
7809,58,1799900,1,9,10,33,779,33033779
7810,20,1799900,1,9,10,33,799,33033799
7811,312,1799900,1,9,10,34,111,33034111
7812,128,1799800,1,9,10,34,239,33034239
7813,1,1799800,2,9,10,34,240,33034240
7814,903,1799700,1,9,10,35,143,33035143
7815,21,1799700,1,9,10,35,164,33035164
7816,180,1799700,1,9,10,35,344,33035344
7817,13,1799700,1,9,10,35,357,33035357
7818,609,1799600,2,9,10,35,966,33035966
7819,2,1799600,2,9,10,35,968,33035968
7820,108,1799500,1,9,10,36,76,33036076
7821,15,1799500,1,9,10,36,91,33036091
7822,116,1799700,1,9,10,36,207,33036207
7823,10,1799700,1,9,10,36,217,33036217
7824,553,1799700,2,9,10,36,770,33036770
7825,102,1799800,1,9,10,36,872,33036872
7826,70,1799700,1,9,10,36,942,33036942
7827,124,1799700,1,9,10,37,66,33037066
7828,34,1799900,1,9,10,37,100,33037100
7829,1421,1799900,4,9,10,38,521,33038521
7830,1125,1799800,1,9,10,39,646,33039646
7831,2472,1799900,3,9,10,42,118,33042118
7832,1421,1799900,1,9,10,43,539,33043539
7833,328,1799800,1,9,10,43,867,33043867
7834,1953,1799900,1,9,10,45,820,33045820
7835,136,1799700,1,9,10,45,956,33045956
7836,349,1799800,2,9,10,46,305,33046305
7837,106,1799700,1,9,10,46,411,33046411
7838,48,1799700,1,9,10,46,459,33046459
7839,337,1799700,1,9,10,46,796,33046796
7840,3399,1799700,1,9,10,50,195,33050195
7841,319,1799600,1,9,10,50,514,33050514
7842,95,1799600,1,9,10,50,609,33050609
7843,1,1799600,1,9,10,50,610,33050610
7844,1455,1799600,1,9,10,52,65,33052065
7845,95,1799600,2,9,10,52,160,33052160
7846,808,1799500,1,9,10,52,968,33052968
7847,187,1799600,1,9,10,53,155,33053155
7848,376,1799600,1,9,10,53,531,33053531
7849,283,1799600,1,9,10,53,814,33053814
7850,352,1799600,2,9,10,54,166,33054166
7851,543,1799500,4,9,10,54,709,33054709
7852,578,1799500,1,9,10,55,287,33055287
7853,146,1799500,2,9,10,55,433,33055433
7854,320,1799400,2,9,10,55,753,33055753
7855,0,1799400,5,9,10,55,753,33055753
7856,0,1799400,2,9,10,55,753,33055753
7857,1,1799400,1,9,10,55,754,33055754
7858,0,1799400,5,9,10,55,754,33055754
7859,0,1799400,1,9,10,55,754,33055754
7860,194,1799300,1,9,10,55,948,33055948
7861,106,1799300,1,9,10,56,54,33056054
7862,0,1799300,1,9,10,56,54,33056054
7863,0,1799300,1,9,10,56,54,33056054
7864,0,1799300,1,9,10,56,54,33056054
7865,184,1799400,1,9,10,56,238,33056238
7866,4104,1799300,1,9,11,0,342,33060342
7867,1,1799200,1,9,11,0,343,33060343
7868,515,1799200,1,9,11,0,858,33060858
7869,296,1799300,1,9,11,1,154,33061154
7870,698,1799200,2,9,11,1,852,33061852
7871,1188,1799300,4,9,11,3,40,33063040
7873,2,1799400,2,9,11,3,42,33063042
7874,70,1799400,1,9,11,3,112,33063112
7875,179,1799400,1,9,11,3,291,33063291
7876,4,1799400,1,9,11,3,295,33063295
7877,1059,1799400,1,9,11,4,354,33064354
7878,722,1799300,1,9,11,5,76,33065076
7879,1878,1799200,1,9,11,6,954,33066954
7880,50,1799200,3,9,11,7,4,33067004
7881,1,1799300,6,9,11,7,5,33067005
7882,0,1799300,1,9,11,7,5,33067005
7883,0,1799300,1,9,11,7,5,33067005
7884,0,1799400,1,9,11,7,5,33067005
7885,0,1799400,1,9,11,7,5,33067005
7886,0,1799400,6,9,11,7,5,33067005
7887,1,1799400,1,9,11,7,6,33067006
7888,54,1799400,1,9,11,7,60,33067060
7889,58,1799500,2,9,11,7,118,33067118
7890,135,1799500,1,9,11,7,253,33067253
7891,39,1799500,1,9,11,7,292,33067292
7892,90,1799500,2,9,11,7,382,33067382
7893,425,1799300,1,9,11,7,807,33067807
7894,462,1799300,1,9,11,8,269,33068269
7895,757,1799500,1,9,11,9,26,33069026
7896,363,1799500,1,9,11,9,389,33069389
7897,736,1799400,1,9,11,10,125,33070125
7898,1570,1799500,1,9,11,11,695,33071695
7899,194,1799600,1,9,11,11,889,33071889
7900,627,1799500,1,9,11,12,516,33072516
7901,13,1799600,1,9,11,12,529,33072529
7902,1735,1799600,1,9,11,14,264,33074264
7903,1139,1799600,1,9,11,15,403,33075403
7904,248,1799600,1,9,11,15,651,33075651
7905,10,1799600,1,9,11,15,661,33075661
7906,1181,1799500,1,9,11,16,842,33076842
7907,7,1799700,5,9,11,16,849,33076849
7908,1,1799700,1,9,11,16,850,33076850
7909,211,1799700,1,9,11,17,61,33077061
7910,587,1799600,1,9,11,17,648,33077648
7911,634,1799800,1,9,11,18,282,33078282
7912,144,1799800,1,9,11,18,426,33078426
7913,35,1799800,1,9,11,18,461,33078461
7914,1022,1799600,1,9,11,19,483,33079483
7915,1336,1799600,1,9,11,20,819,33080819
7916,32,1799600,1,9,11,20,851,33080851
7917,1,1799500,1,9,11,20,852,33080852
7918,294,1799500,1,9,11,21,146,33081146
7919,0,1799500,1,9,11,21,146,33081146
7920,32,1799500,1,9,11,21,178,33081178
7921,268,1799500,1,9,11,21,446,33081446
7922,59,1799500,1,9,11,21,505,33081505
7923,1636,1799500,1,9,11,23,141,33083141
7924,186,1799500,1,9,11,23,327,33083327
7925,397,1799400,1,9,11,23,724,33083724
7926,473,1799400,1,9,11,24,197,33084197
7927,42,1799400,1,9,11,24,239,33084239
7928,41,1799400,1,9,11,24,280,33084280
7929,23,1799400,1,9,11,24,303,33084303
7930,807,1799400,1,9,11,25,110,33085110
7931,232,1799300,5,9,11,25,342,33085342
7932,250,1799300,7,9,11,25,592,33085592
7934,250,1799400,1,9,11,25,842,33085842
7936,221,1799500,1,9,11,26,63,33086063
7937,403,1799600,1,9,11,26,466,33086466
7938,65,1799600,2,9,11,26,531,33086531
7939,273,1799600,1,9,11,26,804,33086804
7940,7,1799700,2,9,11,26,811,33086811
7941,0,1799700,2,9,11,26,811,33086811
7943,597,1799700,1,9,11,27,408,33087408
7944,11,1799700,2,9,11,27,419,33087419
7945,10,1799900,1,9,11,27,429,33087429
7946,614,1799700,1,9,11,28,43,33088043
7947,17,1799800,1,9,11,28,60,33088060
7948,1120,1799700,1,9,11,29,180,33089180
7949,180,1799700,1,9,11,29,360,33089360
7950,484,1799700,1,9,11,29,844,33089844
7951,151,1799700,1,9,11,29,995,33089995
7952,509,1799800,1,9,11,30,504,33090504
7953,0,1799800,1,9,11,30,504,33090504
7954,595,1799900,5,9,11,31,99,33091099
7955,3,1800000,4,9,11,31,102,33091102
7956,1,1800000,2,9,11,31,103,33091103
7957,513,1800000,1,9,11,31,616,33091616
7958,59,1800100,1,9,11,31,675,33091675
7959,237,1800000,1,9,11,31,912,33091912
7960,104,1800000,2,9,11,32,16,33092016
7962,10,1800100,2,9,11,32,26,33092026
7963,53,1800000,1,9,11,32,79,33092079
7964,40,1799900,1,9,11,32,119,33092119
7966,613,1800000,1,9,11,32,732,33092732
7967,624,1800000,3,9,11,33,356,33093356
7968,402,1799800,1,9,11,33,758,33093758
7969,756,1799800,1,9,11,34,514,33094514
7970,672,1799700,1,9,11,35,186,33095186
7971,396,1799700,1,9,11,35,582,33095582
7972,17,1799700,1,9,11,35,599,33095599
7973,4,1799700,2,9,11,35,603,33095603
7974,195,1799500,1,9,11,35,798,33095798
7975,35,1799500,1,9,11,35,833,33095833
7976,24,1799500,1,9,11,35,857,33095857
7977,464,1799500,1,9,11,36,321,33096321
7978,132,1799500,3,9,11,36,453,33096453
7979,1,1799500,3,9,11,36,454,33096454
7980,224,1799400,1,9,11,36,678,33096678
7981,20,1799400,1,9,11,36,698,33096698
7982,308,1799400,2,9,11,37,6,33097006
7983,903,1799400,1,9,11,37,909,33097909
7984,130,1799400,1,9,11,38,39,33098039
7985,288,1799400,1,9,11,38,327,33098327
7986,325,1799500,1,9,11,38,652,33098652
7987,191,1799400,1,9,11,38,843,33098843
7988,241,1799600,1,9,11,39,84,33099084
7989,93,1799600,1,9,11,39,177,33099177
7990,1195,1799500,1,9,11,40,372,33100372
7992,855,1799500,1,9,11,41,227,33101227
7993,2224,1799500,1,9,11,43,451,33103451
7994,62,1799400,1,9,11,43,513,33103513
7995,1598,1799500,1,9,11,45,111,33105111
7996,1712,1799400,1,9,11,46,823,33106823
7997,825,1799400,1,9,11,47,648,33107648
7998,0,1799400,3,9,11,47,648,33107648
7999,0,1799400,2,9,11,47,648,33107648
8000,1550,1799400,1,9,11,49,198,33109198
8001,178,1799400,1,9,11,49,376,33109376
8002,1501,1799400,1,9,11,50,877,33110877
8003,1,1799400,1,9,11,50,878,33110878
8004,917,1799400,1,9,11,51,795,33111795
8005,1029,1799500,7,9,11,52,824,33112824
8006,1030,1799500,1,9,11,53,854,33113854
8007,56,1799400,2,9,11,53,910,33113910
8008,1614,1799300,1,9,11,55,524,33115524
8009,103,1799400,1,9,11,55,627,33115627
8010,960,1799300,1,9,11,56,587,33116587
8011,1,1799300,3,9,11,56,588,33116588
8012,100,1799400,1,9,11,56,688,33116688
8013,502,1799400,1,9,11,57,190,33117190
8014,522,1799400,1,9,11,57,712,33117712
8015,48,1799500,2,9,11,57,760,33117760
8016,578,1799400,1,9,11,58,338,33118338
8017,1000,1799600,2,9,11,59,338,33119338
8018,37,1799500,1,9,11,59,375,33119375
8019,182,1799600,2,9,11,59,557,33119557
8020,248,1799600,1,9,11,59,805,33119805
8021,447,1799600,1,9,12,0,252,33120252
8022,175,1799700,4,9,12,0,427,33120427
8024,10,1799800,2,9,12,0,437,33120437
8025,54,1799900,1,9,12,0,491,33120491
8026,84,1799700,4,9,12,0,575,33120575
8027,59,1799700,1,9,12,0,634,33120634
8028,134,1799800,3,9,12,0,768,33120768
8029,59,1799800,5,9,12,0,827,33120827
8030,169,1799800,1,9,12,0,996,33120996
8031,916,1799800,1,9,12,1,912,33121912
8032,604,1799900,1,9,12,2,516,33122516
8033,1250,1799600,1,9,12,3,766,33123766
8034,262,1799500,1,9,12,4,28,33124028
8035,312,1799500,1,9,12,4,340,33124340
8036,592,1799500,1,9,12,4,932,33124932
8037,248,1799500,1,9,12,5,180,33125180
8038,136,1799500,1,9,12,5,316,33125316
8039,425,1799500,1,9,12,5,741,33125741
8040,613,1799700,1,9,12,6,354,33126354
8041,34,1799500,1,9,12,6,388,33126388
8042,273,1799600,1,9,12,6,661,33126661
8043,2271,1799500,1,9,12,8,932,33128932
8044,66,1799500,1,9,12,8,998,33128998
8045,2227,1799500,2,9,12,11,225,33131225
8046,266,1799600,5,9,12,11,491,33131491
8047,1349,1799400,1,9,12,12,840,33132840
8048,2276,1799500,1,9,12,15,116,33135116
8049,284,1799500,1,9,12,15,400,33135400
8050,101,1799600,1,9,12,15,501,33135501
8051,1384,1799600,1,9,12,16,885,33136885
8052,231,1799600,5,9,12,17,116,33137116
8053,13,1799700,1,9,12,17,129,33137129
8054,797,1799800,4,9,12,17,926,33137926
8055,13,1799900,6,9,12,17,939,33137939
8056,489,1799900,1,9,12,18,428,33138428
8057,148,1800000,11,9,12,18,576,33138576
8058,2,1800100,7,9,12,18,578,33138578
8059,1432,1800100,2,9,12,20,10,33140010
8060,1051,1800100,1,9,12,21,61,33141061
8061,575,1799900,1,9,12,21,636,33141636
8062,1210,1799900,1,9,12,22,846,33142846
8063,1566,1800000,1,9,12,24,412,33144412
8064,238,1800000,1,9,12,24,650,33144650
8065,332,1800000,3,9,12,24,982,33144982
8066,3,1800000,14,9,12,24,985,33144985
8067,1,1800100,4,9,12,24,986,33144986
8068,272,1800000,2,9,12,25,258,33145258
8069,0,1800000,2,9,12,25,258,33145258
8071,242,1800000,1,9,12,25,500,33145500
8072,1,1800100,3,9,12,25,501,33145501
8073,134,1800100,1,9,12,25,635,33145635
8074,634,1800000,1,9,12,26,269,33146269
8075,94,1799900,1,9,12,26,363,33146363
8076,410,1799900,1,9,12,26,773,33146773
8077,4317,1800100,3,9,12,31,90,33151090
8078,0,1800100,1,9,12,31,90,33151090
8079,93,1800000,1,9,12,31,183,33151183
8080,16,1800000,1,9,12,31,199,33151199
8081,526,1800100,1,9,12,31,725,33151725
8082,10,1800100,1,9,12,31,735,33151735
8083,326,1800100,1,9,12,32,61,33152061
8084,536,1800100,1,9,12,32,597,33152597
8085,260,1800100,2,9,12,32,857,33152857
8086,1,1800200,1,9,12,32,858,33152858
8087,225,1800100,1,9,12,33,83,33153083
8088,194,1800200,10,9,12,33,277,33153277
8089,0,1800200,1,9,12,33,277,33153277
8090,0,1800200,1,9,12,33,277,33153277
8091,0,1800200,9,9,12,33,277,33153277
8092,90,1800300,26,9,12,33,367,33153367
8093,61,1800300,1,9,12,33,428,33153428
8094,381,1800400,2,9,12,33,809,33153809
8095,87,1800400,2,9,12,33,896,33153896
8096,45,1800400,1,9,12,33,941,33153941
8097,623,1800400,5,9,12,34,564,33154564
8098,93,1800400,5,9,12,34,657,33154657
8099,175,1800500,1,9,12,34,832,33154832
8100,28,1800500,1,9,12,34,860,33154860
8101,60,1800400,1,9,12,34,920,33154920
8102,32,1800300,1,9,12,34,952,33154952
8103,8,1800500,1,9,12,34,960,33154960
8104,22,1800500,1,9,12,34,982,33154982
8105,26,1800500,1,9,12,35,8,33155008
8106,334,1800500,1,9,12,35,342,33155342
8107,142,1800400,1,9,12,35,484,33155484
8108,23,1800500,1,9,12,35,507,33155507
8109,44,1800400,1,9,12,35,551,33155551
8110,493,1800500,1,9,12,36,44,33156044
8111,11,1800400,1,9,12,36,55,33156055
8112,153,1800500,7,9,12,36,208,33156208
8113,66,1800400,1,9,12,36,274,33156274
8114,89,1800500,3,9,12,36,363,33156363
8115,39,1800500,1,9,12,36,402,33156402
8116,538,1800400,1,9,12,36,940,33156940
8117,118,1800400,1,9,12,37,58,33157058
8118,156,1800400,1,9,12,37,214,33157214
8119,69,1800500,2,9,12,37,283,33157283
8120,570,1800400,1,9,12,37,853,33157853
8121,573,1800500,1,9,12,38,426,33158426
8122,87,1800500,1,9,12,38,513,33158513
8123,1561,1800400,1,9,12,40,74,33160074
8124,233,1800500,18,9,12,40,307,33160307
8125,211,1800500,1,9,12,40,518,33160518
8126,105,1800500,1,9,12,40,623,33160623
8127,280,1800500,1,9,12,40,903,33160903
8128,15,1800500,1,9,12,40,918,33160918
8129,10,1800400,1,9,12,40,928,33160928
8130,78,1800500,1,9,12,41,6,33161006
8131,34,1800500,1,9,12,41,40,33161040
8132,42,1800500,3,9,12,41,82,33161082
8134,79,1800500,1,9,12,41,161,33161161
8135,48,1800400,1,9,12,41,209,33161209
8136,72,1800500,1,9,12,41,281,33161281
8137,39,1800600,1,9,12,41,320,33161320
8138,105,1800600,1,9,12,41,425,33161425
8139,22,1800600,1,9,12,41,447,33161447
8140,7,1800600,1,9,12,41,454,33161454
8141,15,1800600,1,9,12,41,469,33161469
8142,60,1800600,1,9,12,41,529,33161529
8143,8,1800600,1,9,12,41,537,33161537
8144,113,1800600,2,9,12,41,650,33161650
8145,17,1800600,1,9,12,41,667,33161667
8146,42,1800400,1,9,12,41,709,33161709
8147,130,1800600,1,9,12,41,839,33161839
8148,95,1800500,1,9,12,41,934,33161934
8149,32,1800600,1,9,12,41,966,33161966
8150,371,1800500,2,9,12,42,337,33162337
8151,234,1800500,2,9,12,42,571,33162571
8152,300,1800600,1,9,12,42,871,33162871
8153,277,1800400,1,9,12,43,148,33163148
8154,60,1800600,1,9,12,43,208,33163208
8155,91,1800600,1,9,12,43,299,33163299
8156,81,1800400,1,9,12,43,380,33163380
8157,70,1800600,1,9,12,43,450,33163450
8158,212,1800600,1,9,12,43,662,33163662
8159,430,1800500,1,9,12,44,92,33164092
8160,50,1800400,2,9,12,44,142,33164142
8161,256,1800400,2,9,12,44,398,33164398
8162,811,1800400,2,9,12,45,209,33165209
8163,0,1800400,1,9,12,45,209,33165209
8164,111,1800300,1,9,12,45,320,33165320
8165,1531,1800400,1,9,12,46,851,33166851
8166,371,1800400,2,9,12,47,222,33167222
8167,699,1800400,1,9,12,47,921,33167921
8168,312,1800400,1,9,12,48,233,33168233
8169,225,1800500,1,9,12,48,458,33168458
8170,201,1800300,1,9,12,48,659,33168659
8171,87,1800500,1,9,12,48,746,33168746
8172,928,1800400,1,9,12,49,674,33169674
8173,215,1800500,1,9,12,49,889,33169889
8174,244,1800400,1,9,12,50,133,33170133
8175,587,1800300,1,9,12,50,720,33170720
8176,1,1800300,6,9,12,50,721,33170721
8177,1530,1800200,2,9,12,52,251,33172251
8178,198,1800200,1,9,12,52,449,33172449
8179,362,1800200,6,9,12,52,811,33172811
8180,0,1800200,1,9,12,52,811,33172811
8181,0,1800200,1,9,12,52,811,33172811
8182,0,1800200,3,9,12,52,811,33172811
8183,1,1800200,3,9,12,52,812,33172812
8184,130,1800100,1,9,12,52,942,33172942
8185,475,1800100,2,9,12,53,417,33173417
8186,10,1800200,2,9,12,53,427,33173427
8187,516,1800200,1,9,12,53,943,33173943
8188,208,1800200,1,9,12,54,151,33174151
8189,1160,1800200,1,9,12,55,311,33175311
8190,330,1800200,1,9,12,55,641,33175641
8191,325,1800100,1,9,12,55,966,33175966
8192,665,1800100,1,9,12,56,631,33176631
8193,1096,1800000,1,9,12,57,727,33177727
8194,143,1800000,5,9,12,57,870,33177870
8195,1190,1800100,3,9,12,59,60,33179060
8196,350,1800100,1,9,12,59,410,33179410
8197,630,1800100,1,9,13,0,40,33180040
8198,211,1800100,2,9,13,0,251,33180251
8199,1082,1800000,1,9,13,1,333,33181333
8200,409,1800100,1,9,13,1,742,33181742
8201,18,1800200,1,9,13,1,760,33181760
8202,279,1800200,1,9,13,2,39,33182039
8203,1296,1800100,1,9,13,3,335,33183335
8204,1629,1800100,1,9,13,4,964,33184964
8205,660,1800100,1,9,13,5,624,33185624
8206,677,1800100,2,9,13,6,301,33186301
8207,303,1800000,1,9,13,6,604,33186604
8208,808,1800000,18,9,13,7,412,33187412
8209,1915,1800000,1,9,13,9,327,33189327
8210,2569,1799900,3,9,13,11,896,33191896
8211,1,1799900,8,9,13,11,897,33191897
8212,34,1799900,1,9,13,11,931,33191931
8213,271,1799900,2,9,13,12,202,33192202
8214,953,1799800,5,9,13,13,155,33193155
8215,1,1799800,1,9,13,13,156,33193156
8216,0,1799800,1,9,13,13,156,33193156
8217,0,1799800,1,9,13,13,156,33193156
8218,8,1799800,1,9,13,13,164,33193164
8219,667,1799700,1,9,13,13,831,33193831
8220,12,1799700,2,9,13,13,843,33193843
8221,1,1799700,1,9,13,13,844,33193844
8222,0,1799700,2,9,13,13,844,33193844
8223,33,1799600,1,9,13,13,877,33193877
8224,20,1799600,1,9,13,13,897,33193897
8225,1,1799600,1,9,13,13,898,33193898
8226,209,1799500,13,9,13,14,107,33194107
8227,3,1799400,1,9,13,14,110,33194110
8228,130,1799400,4,9,13,14,240,33194240
8229,19,1799400,1,9,13,14,259,33194259
8230,36,1799400,1,9,13,14,295,33194295
8231,24,1799500,1,9,13,14,319,33194319
8232,12,1799400,1,9,13,14,331,33194331
8233,135,1799500,2,9,13,14,466,33194466
8234,11,1799600,1,9,13,14,477,33194477
8235,2055,1799500,2,9,13,16,532,33196532
8236,216,1799500,2,9,13,16,748,33196748
8238,1,1799600,2,9,13,16,749,33196749
8239,1,1799700,3,9,13,16,750,33196750
8240,0,1799700,8,9,13,16,750,33196750
8241,0,1799600,3,9,13,16,750,33196750
8242,1,1799700,5,9,13,16,751,33196751
8244,0,1799800,1,9,13,16,751,33196751
8245,2,1799700,3,9,13,16,753,33196753
8246,1,1799700,1,9,13,16,754,33196754
8247,0,1799800,1,9,13,16,754,33196754
8248,96,1799700,1,9,13,16,850,33196850
8249,254,1799700,1,9,13,17,104,33197104
8250,330,1799700,1,9,13,17,434,33197434
8251,1348,1799800,1,9,13,18,782,33198782
8252,567,1799800,1,9,13,19,349,33199349
8253,1651,1799800,1,9,13,21,0,33201000
8254,3,1799700,1,9,13,21,3,33201003
8255,61,1799600,2,9,13,21,64,33201064
8256,1,1799600,9,9,13,21,65,33201065
8257,0,1799600,5,9,13,21,65,33201065
8258,0,1799600,2,9,13,21,65,33201065
8259,0,1799600,1,9,13,21,65,33201065
8260,0,1799600,1,9,13,21,65,33201065
8261,0,1799600,1,9,13,21,65,33201065
8262,0,1799600,7,9,13,21,65,33201065
8263,1,1799600,2,9,13,21,66,33201066
8264,0,1799600,2,9,13,21,66,33201066
8265,2,1799600,5,9,13,21,68,33201068
8266,32,1799700,1,9,13,21,100,33201100
8267,1910,1799600,1,9,13,23,10,33203010
8268,11,1799700,1,9,13,23,21,33203021
8269,138,1799600,1,9,13,23,159,33203159
8270,2528,1799700,1,9,13,25,687,33205687
8271,2428,1799600,1,9,13,28,115,33208115
8272,1,1799600,5,9,13,28,116,33208116
8273,26,1799600,27,9,13,28,142,33208142
8274,229,1799500,1,9,13,28,371,33208371
8275,308,1799500,5,9,13,28,679,33208679
8276,300,1799600,1,9,13,28,979,33208979
8277,146,1799600,1,9,13,29,125,33209125
8278,304,1799500,3,9,13,29,429,33209429
8280,92,1799400,1,9,13,29,521,33209521
8281,992,1799600,1,9,13,30,513,33210513
8282,386,1799600,1,9,13,30,899,33210899
8283,578,1799600,3,9,13,31,477,33211477
8284,542,1799600,2,9,13,32,19,33212019
8285,0,1799600,2,9,13,32,19,33212019
8286,532,1799600,1,9,13,32,551,33212551
8287,1443,1799700,3,9,13,33,994,33213994
8288,105,1799800,4,9,13,34,99,33214099
8289,249,1799900,1,9,13,34,348,33214348
8290,395,1799800,1,9,13,34,743,33214743
8291,2640,1800000,7,9,13,37,383,33217383
8292,48,1800100,1,9,13,37,431,33217431
8293,261,1800100,1,9,13,37,692,33217692
8294,2340,1800000,2,9,13,40,32,33220032
8295,733,1800200,2,9,13,40,765,33220765
8296,982,1800100,1,9,13,41,747,33221747
8297,296,1800200,6,9,13,42,43,33222043
8298,102,1800100,1,9,13,42,145,33222145
8299,265,1800200,1,9,13,42,410,33222410
8300,472,1800200,5,9,13,42,882,33222882
8302,102,1800200,1,9,13,42,984,33222984
8303,520,1800100,1,9,13,43,504,33223504
8304,489,1800000,1,9,13,43,993,33223993
8305,438,1800000,1,9,13,44,431,33224431
8306,970,1800000,1,9,13,45,401,33225401
8307,205,1800100,1,9,13,45,606,33225606
8308,308,1800000,1,9,13,45,914,33225914
8309,458,1800000,1,9,13,46,372,33226372
8310,30,1800100,2,9,13,46,402,33226402
8311,36,1800100,1,9,13,46,438,33226438
8312,61,1800200,1,9,13,46,499,33226499
8313,85,1800200,1,9,13,46,584,33226584
8314,182,1800300,4,9,13,46,766,33226766
8315,157,1800400,6,9,13,46,923,33226923
8316,785,1800400,5,9,13,47,708,33227708
8317,7,1800400,1,9,13,47,715,33227715
8318,179,1800400,1,9,13,47,894,33227894
8319,21,1800400,5,9,13,47,915,33227915
8320,174,1800400,1,9,13,48,89,33228089
8321,26,1800400,5,9,13,48,115,33228115
8322,132,1800400,2,9,13,48,247,33228247
8323,34,1800400,1,9,13,48,281,33228281
8324,7,1800400,4,9,13,48,288,33228288
8325,0,1800400,1,9,13,48,288,33228288
8326,0,1800400,2,9,13,48,288,33228288
8327,0,1800400,3,9,13,48,288,33228288
8328,146,1800400,1,9,13,48,434,33228434
8329,277,1800300,2,9,13,48,711,33228711
8330,1,1800200,1,9,13,48,712,33228712
8331,160,1800200,1,9,13,48,872,33228872
8332,133,1800300,1,9,13,49,5,33229005
8333,47,1800100,1,9,13,49,52,33229052
8334,675,1800100,1,9,13,49,727,33229727
8335,1352,1800400,2,9,13,51,79,33231079
8336,3120,1800400,1,9,13,54,199,33234199
8337,1,1800400,3,9,13,54,200,33234200
8338,1366,1800500,2,9,13,55,566,33235566
8339,481,1800500,1,9,13,56,47,33236047
8340,86,1800500,5,9,13,56,133,33236133
8341,181,1800500,5,9,13,56,314,33236314
8342,550,1800500,2,9,13,56,864,33236864
8343,229,1800500,1,9,13,57,93,33237093
8344,170,1800500,1,9,13,57,263,33237263
8345,45,1800500,1,9,13,57,308,33237308
8346,29,1800500,2,9,13,57,337,33237337
8347,119,1800500,1,9,13,57,456,33237456
8348,174,1800500,1,9,13,57,630,33237630
8349,29,1800500,1,9,13,57,659,33237659
8350,17,1800500,1,9,13,57,676,33237676
8351,339,1800500,2,9,13,58,15,33238015
8353,146,1800600,1,9,13,58,161,33238161
8354,120,1800600,32,9,13,58,281,33238281
8355,1,1800700,3,9,13,58,282,33238282
8356,1,1800700,2,9,13,58,283,33238283
8357,90,1800600,1,9,13,58,373,33238373
8358,39,1800700,1,9,13,58,412,33238412
8359,75,1800700,10,9,13,58,487,33238487
8360,1,1800700,2,9,13,58,488,33238488
8361,121,1800800,1,9,13,58,609,33238609
8362,39,1800800,3,9,13,58,648,33238648
8363,58,1800800,1,9,13,58,706,33238706
8364,21,1800800,1,9,13,58,727,33238727
8365,14,1800800,4,9,13,58,741,33238741
8366,11,1800800,4,9,13,58,752,33238752
8367,2,1800800,5,9,13,58,754,33238754
8368,4,1800800,5,9,13,58,758,33238758
8369,12,1800800,5,9,13,58,770,33238770
8370,0,1800800,1,9,13,58,770,33238770
8371,2,1800800,3,9,13,58,772,33238772
8372,0,1800800,1,9,13,58,772,33238772
8373,1,1800800,1,9,13,58,773,33238773
8374,0,1800800,2,9,13,58,773,33238773
8375,5,1800800,20,9,13,58,778,33238778
8376,1,1800800,6,9,13,58,779,33238779
8377,0,1800800,1,9,13,58,779,33238779
8378,0,1800800,1,9,13,58,779,33238779
8379,0,1800800,2,9,13,58,779,33238779
8380,0,1800800,8,9,13,58,779,33238779
8381,0,1800800,2,9,13,58,779,33238779
8382,0,1800800,1,9,13,58,779,33238779
8383,0,1800800,1,9,13,58,779,33238779
8384,3,1800900,2,9,13,58,782,33238782
8385,15,1800900,6,9,13,58,797,33238797
8386,0,1800900,58,9,13,58,797,33238797
8387,1,1801000,1,9,13,58,798,33238798
8388,0,1801000,1,9,13,58,798,33238798
8389,1,1801000,4,9,13,58,799,33238799
8390,0,1801000,1,9,13,58,799,33238799
8391,0,1801000,1,9,13,58,799,33238799
8392,0,1801000,1,9,13,58,799,33238799
8393,0,1801000,2,9,13,58,799,33238799
8394,0,1801000,5,9,13,58,799,33238799
8395,0,1801000,1,9,13,58,799,33238799
8396,0,1801000,3,9,13,58,799,33238799
8397,0,1801000,11,9,13,58,799,33238799
8398,0,1801000,4,9,13,58,799,33238799
8399,0,1801000,1,9,13,58,799,33238799
8400,1,1801000,2,9,13,58,800,33238800
8401,0,1801000,9,9,13,58,800,33238800
8402,0,1801000,1,9,13,58,800,33238800
8403,0,1801000,4,9,13,58,800,33238800
8404,0,1801000,4,9,13,58,800,33238800
8405,0,1801000,1,9,13,58,800,33238800
8406,1,1801000,1,9,13,58,801,33238801
8407,0,1801000,1,9,13,58,801,33238801
8408,0,1801000,1,9,13,58,801,33238801
8409,0,1801000,4,9,13,58,801,33238801
8410,8,1801100,1,9,13,58,809,33238809
8411,13,1801000,1,9,13,58,822,33238822
8413,13,1801000,1,9,13,58,835,33238835
8414,2,1801000,1,9,13,58,837,33238837
8415,14,1801000,2,9,13,58,851,33238851
8417,0,1801100,8,9,13,58,851,33238851
8418,1,1801100,1,9,13,58,852,33238852
8420,0,1801200,2,9,13,58,852,33238852
8421,1,1801100,1,9,13,58,853,33238853
8422,7,1801000,1,9,13,58,860,33238860
8423,0,1801200,8,9,13,58,860,33238860
8424,2,1801200,1,9,13,58,862,33238862
8425,3,1801200,1,9,13,58,865,33238865
8426,6,1801200,1,9,13,58,871,33238871
8427,10,1801200,1,9,13,58,881,33238881
8428,13,1801100,1,9,13,58,894,33238894
8430,17,1801000,3,9,13,58,911,33238911
8431,1,1801000,1,9,13,58,912,33238912
8432,1,1801000,1,9,13,58,913,33238913
8434,11,1801100,3,9,13,58,924,33238924
8436,3,1800900,1,9,13,58,927,33238927
8437,12,1801000,1,9,13,58,939,33238939
8438,3,1801100,2,9,13,58,942,33238942
8439,4,1801100,3,9,13,58,946,33238946
8440,4,1801100,1,9,13,58,950,33238950
8441,4,1801100,3,9,13,58,954,33238954
8442,8,1801100,1,9,13,58,962,33238962
8443,12,1801100,1,9,13,58,974,33238974
8444,0,1801100,1,9,13,58,974,33238974
8445,3,1801200,2,9,13,58,977,33238977
8446,1,1801200,8,9,13,58,978,33238978
8447,1,1801200,1,9,13,58,979,33238979
8448,5,1801100,2,9,13,58,984,33238984
8449,19,1801200,2,9,13,59,3,33239003
8450,6,1801200,1,9,13,59,9,33239009
8451,4,1801200,4,9,13,59,13,33239013
8452,1,1801200,1,9,13,59,14,33239014
8453,6,1801200,3,9,13,59,20,33239020
8454,2,1801200,1,9,13,59,22,33239022
8455,2,1801300,4,9,13,59,24,33239024
8456,2,1801300,1,9,13,59,26,33239026
8457,1,1801300,1,9,13,59,27,33239027
8458,1,1801300,2,9,13,59,28,33239028
8459,16,1801300,2,9,13,59,44,33239044
8460,0,1801300,1,9,13,59,44,33239044
8461,1,1801300,2,9,13,59,45,33239045
8462,15,1801300,1,9,13,59,60,33239060
8463,22,1801300,1,9,13,59,82,33239082
8464,12,1801300,1,9,13,59,94,33239094
8465,4,1801300,2,9,13,59,98,33239098
8466,20,1801300,6,9,13,59,118,33239118
8467,1,1801400,1,9,13,59,119,33239119
8468,18,1801400,2,9,13,59,137,33239137
8469,2,1801400,2,9,13,59,139,33239139
8470,11,1801400,3,9,13,59,150,33239150
8471,18,1801400,2,9,13,59,168,33239168
8472,0,1801400,1,9,13,59,168,33239168
8473,7,1801400,1,9,13,59,175,33239175
8474,16,1801400,1,9,13,59,191,33239191
8475,3,1801400,1,9,13,59,194,33239194
8476,1,1801400,1,9,13,59,195,33239195
8477,22,1801400,2,9,13,59,217,33239217
8478,2,1801400,2,9,13,59,219,33239219
8479,3,1801400,1,9,13,59,222,33239222
8480,2,1801400,1,9,13,59,224,33239224
8481,0,1801400,1,9,13,59,224,33239224
8482,7,1801400,2,9,13,59,231,33239231
8483,1,1801400,1,9,13,59,232,33239232
8484,3,1801400,2,9,13,59,235,33239235
8485,3,1801400,1,9,13,59,238,33239238
8486,1,1801400,1,9,13,59,239,33239239
8487,0,1801400,1,9,13,59,239,33239239
8488,5,1801200,1,9,13,59,244,33239244
8489,5,1801200,1,9,13,59,249,33239249
8490,3,1801400,1,9,13,59,252,33239252
8491,12,1801400,5,9,13,59,264,33239264
8492,3,1801400,1,9,13,59,267,33239267
8493,8,1801400,1,9,13,59,275,33239275
8494,1,1801400,1,9,13,59,276,33239276
8495,17,1801400,1,9,13,59,293,33239293
8496,5,1801400,1,9,13,59,298,33239298
8497,2,1801400,2,9,13,59,300,33239300
8498,4,1801400,2,9,13,59,304,33239304
8499,6,1801400,1,9,13,59,310,33239310
8500,2,1801400,1,9,13,59,312,33239312
8501,3,1801400,1,9,13,59,315,33239315
8502,8,1801400,1,9,13,59,323,33239323
8503,2,1801400,4,9,13,59,325,33239325
8504,6,1801200,3,9,13,59,331,33239331
8505,0,1801200,1,9,13,59,331,33239331
8506,5,1801300,1,9,13,59,336,33239336
8507,0,1801300,1,9,13,59,336,33239336
8508,1,1801200,1,9,13,59,337,33239337
8509,7,1801300,2,9,13,59,344,33239344
8510,1,1801300,1,9,13,59,345,33239345
8511,4,1801300,1,9,13,59,349,33239349
8512,5,1801300,2,9,13,59,354,33239354
8513,6,1801300,2,9,13,59,360,33239360
8514,1,1801300,1,9,13,59,361,33239361
8515,15,1801300,3,9,13,59,376,33239376
8516,8,1801300,1,9,13,59,384,33239384
8517,12,1801300,1,9,13,59,396,33239396
8518,5,1801300,1,9,13,59,401,33239401
8519,11,1801300,1,9,13,59,412,33239412
8520,23,1801300,3,9,13,59,435,33239435
8522,12,1801300,2,9,13,59,447,33239447
8524,23,1801300,3,9,13,59,470,33239470
8526,2,1801300,1,9,13,59,472,33239472
8527,3,1801300,1,9,13,59,475,33239475
8528,8,1801400,1,9,13,59,483,33239483
8529,0,1801400,1,9,13,59,483,33239483
8530,9,1801400,1,9,13,59,492,33239492
8531,11,1801400,1,9,13,59,503,33239503
8532,1,1801400,1,9,13,59,504,33239504
8533,0,1801400,3,9,13,59,504,33239504
8534,5,1801400,1,9,13,59,509,33239509
8535,3,1801200,1,9,13,59,512,33239512
8536,2,1801400,1,9,13,59,514,33239514
8537,3,1801400,1,9,13,59,517,33239517
8538,7,1801400,1,9,13,59,524,33239524
8539,0,1801400,3,9,13,59,524,33239524
8541,3,1801500,1,9,13,59,527,33239527
8542,5,1801500,1,9,13,59,532,33239532
8543,11,1801500,2,9,13,59,543,33239543
8544,7,1801500,1,9,13,59,550,33239550
8545,11,1801500,1,9,13,59,561,33239561
8546,2,1801500,5,9,13,59,563,33239563
8547,14,1801500,1,9,13,59,577,33239577
8548,5,1801500,5,9,13,59,582,33239582
8549,3,1801500,1,9,13,59,585,33239585
8550,2,1801500,1,9,13,59,587,33239587
8551,1,1801500,1,9,13,59,588,33239588
8552,12,1801500,2,9,13,59,600,33239600
8554,0,1801600,4,9,13,59,600,33239600
8555,1,1801500,3,9,13,59,601,33239601
8556,1,1801500,1,9,13,59,602,33239602
8557,2,1801600,1,9,13,59,604,33239604
8558,0,1801500,1,9,13,59,604,33239604
8559,6,1801600,2,9,13,59,610,33239610
8560,8,1801600,2,9,13,59,618,33239618
8561,14,1801400,1,9,13,59,632,33239632
8562,4,1801400,1,9,13,59,636,33239636
8563,0,1801400,2,9,13,59,636,33239636
8564,5,1801500,2,9,13,59,641,33239641
8566,7,1801500,2,9,13,59,648,33239648
8567,3,1801500,1,9,13,59,651,33239651
8568,17,1801600,3,9,13,59,668,33239668
8569,1,1801600,1,9,13,59,669,33239669
8570,2,1801600,2,9,13,59,671,33239671
8571,23,1801500,2,9,13,59,694,33239694
8572,1,1801500,2,9,13,59,695,33239695
8573,12,1801600,1,9,13,59,707,33239707
8574,4,1801600,1,9,13,59,711,33239711
8575,3,1801600,1,9,13,59,714,33239714
8576,1,1801300,1,9,13,59,715,33239715
8577,3,1801600,4,9,13,59,718,33239718
8578,9,1801500,1,9,13,59,727,33239727
8579,13,1801600,5,9,13,59,740,33239740
8581,43,1801600,1,9,13,59,783,33239783
8582,20,1801600,1,9,13,59,803,33239803
8583,14,1801400,1,9,13,59,817,33239817
8584,24,1801300,6,9,13,59,841,33239841
8585,46,1801200,2,9,13,59,887,33239887
8586,5,1801300,2,9,13,59,892,33239892
8587,40,1801300,4,9,13,59,932,33239932
8589,0,1801200,1,9,13,59,932,33239932
8590,3,1801300,1,9,13,59,935,33239935
8592,15,1801300,1,9,13,59,950,33239950
8593,0,1801300,1,9,13,59,950,33239950
8594,10,1801100,5,9,13,59,960,33239960
8595,1,1801100,1,9,13,59,961,33239961
8596,29,1801300,1,9,13,59,990,33239990
8597,4,1801300,2,9,13,59,994,33239994
8598,4,1801300,1,9,13,59,998,33239998
8599,2,1801300,1,9,14,0,0,33240000
8600,2,1801300,1,9,14,0,2,33240002
8601,1,1801300,1,9,14,0,3,33240003
8602,1,1801300,1,9,14,0,4,33240004
8603,2,1801300,1,9,14,0,6,33240006
8604,2,1801300,1,9,14,0,8,33240008
8605,33,1801300,1,9,14,0,41,33240041
8606,18,1801200,1,9,14,0,59,33240059
8607,20,1801400,1,9,14,0,79,33240079
8608,2,1801400,2,9,14,0,81,33240081
8609,2,1801300,1,9,14,0,83,33240083
8610,41,1801400,1,9,14,0,124,33240124
8611,8,1801400,1,9,14,0,132,33240132
8612,4,1801300,1,9,14,0,136,33240136
8613,21,1801400,1,9,14,0,157,33240157
8614,1,1801400,1,9,14,0,158,33240158
8616,12,1801300,1,9,14,0,170,33240170
8617,23,1801400,1,9,14,0,193,33240193
8618,22,1801400,1,9,14,0,215,33240215
8619,13,1801400,4,9,14,0,228,33240228
8620,3,1801300,1,9,14,0,231,33240231
8621,44,1801200,1,9,14,0,275,33240275
8622,3,1801300,2,9,14,0,278,33240278
8623,2,1801300,1,9,14,0,280,33240280
8624,35,1801300,2,9,14,0,315,33240315
8625,24,1801100,3,9,14,0,339,33240339
8626,21,1801200,2,9,14,0,360,33240360
8627,5,1801200,1,9,14,0,365,33240365
8628,8,1801200,1,9,14,0,373,33240373
8629,21,1801200,1,9,14,0,394,33240394
8630,9,1801200,1,9,14,0,403,33240403
8631,7,1801200,1,9,14,0,410,33240410
8632,0,1801200,1,9,14,0,410,33240410
8633,6,1801300,1,9,14,0,416,33240416
8634,47,1801300,1,9,14,0,463,33240463
8635,32,1801300,1,9,14,0,495,33240495
8636,3,1801300,1,9,14,0,498,33240498
8637,18,1801100,1,9,14,0,516,33240516
8638,18,1801200,1,9,14,0,534,33240534
8639,19,1801200,1,9,14,0,553,33240553
8640,11,1801200,1,9,14,0,564,33240564
8641,0,1801200,1,9,14,0,564,33240564
8642,1,1801200,1,9,14,0,565,33240565
8643,5,1801200,1,9,14,0,570,33240570
8644,4,1801200,1,9,14,0,574,33240574
8645,5,1801200,3,9,14,0,579,33240579
8647,0,1801200,1,9,14,0,579,33240579
8648,0,1801200,1,9,14,0,579,33240579
8649,15,1801300,1,9,14,0,594,33240594
8650,3,1801300,1,9,14,0,597,33240597
8651,30,1801300,1,9,14,0,627,33240627
8652,10,1801400,1,9,14,0,637,33240637
8653,1,1801200,1,9,14,0,638,33240638
8654,17,1801300,1,9,14,0,655,33240655
8655,1,1801200,1,9,14,0,656,33240656
8656,0,1801300,1,9,14,0,656,33240656
8657,19,1801300,1,9,14,0,675,33240675
8658,4,1801200,1,9,14,0,679,33240679
8659,44,1801200,1,9,14,0,723,33240723
8661,3,1801300,1,9,14,0,726,33240726
8662,10,1801300,1,9,14,0,736,33240736
8663,17,1801400,1,9,14,0,753,33240753
8664,1,1801200,1,9,14,0,754,33240754
8665,0,1801300,1,9,14,0,754,33240754
8666,2,1801300,1,9,14,0,756,33240756
8668,6,1801400,3,9,14,0,762,33240762
8669,2,1801400,1,9,14,0,764,33240764
8670,7,1801400,1,9,14,0,771,33240771
8671,4,1801400,1,9,14,0,775,33240775
8672,18,1801300,1,9,14,0,793,33240793
8673,14,1801400,1,9,14,0,807,33240807
8674,18,1801400,4,9,14,0,825,33240825
8675,20,1801300,1,9,14,0,845,33240845
8676,7,1801400,1,9,14,0,852,33240852
8677,21,1801200,2,9,14,0,873,33240873
8678,15,1801400,1,9,14,0,888,33240888
8679,0,1801400,1,9,14,0,888,33240888
8680,8,1801500,1,9,14,0,896,33240896
8681,0,1801500,1,9,14,0,896,33240896
8682,0,1801500,1,9,14,0,896,33240896
8683,40,1801400,1,9,14,0,936,33240936
8684,14,1801400,1,9,14,0,950,33240950
8685,21,1801500,2,9,14,0,971,33240971
8686,3,1801500,1,9,14,0,974,33240974
8687,55,1801500,1,9,14,1,29,33241029
8688,14,1801500,1,9,14,1,43,33241043
8689,9,1801500,2,9,14,1,52,33241052
8690,11,1801500,3,9,14,1,63,33241063
8691,6,1801300,2,9,14,1,69,33241069
8692,34,1801400,1,9,14,1,103,33241103
8693,40,1801500,1,9,14,1,143,33241143
8694,14,1801500,1,9,14,1,157,33241157
8695,98,1801300,4,9,14,1,255,33241255
8696,1,1801300,1,9,14,1,256,33241256
8697,0,1801200,4,9,14,1,256,33241256
8698,0,1801300,1,9,14,1,256,33241256
8699,0,1801300,1,9,14,1,256,33241256
8700,4,1801300,1,9,14,1,260,33241260
8701,5,1801300,1,9,14,1,265,33241265
8702,0,1801300,1,9,14,1,265,33241265
8703,14,1801400,1,9,14,1,279,33241279
8704,1,1801400,1,9,14,1,280,33241280
8705,22,1801500,2,9,14,1,302,33241302
8706,16,1801200,1,9,14,1,318,33241318
8707,48,1801400,1,9,14,1,366,33241366
8708,23,1801400,1,9,14,1,389,33241389
8709,152,1801400,1,9,14,1,541,33241541
8710,64,1801300,1,9,14,1,605,33241605
8711,7,1801300,1,9,14,1,612,33241612
8712,133,1801300,1,9,14,1,745,33241745
8713,5,1801400,1,9,14,1,750,33241750
8714,2,1801400,1,9,14,1,752,33241752
8715,1,1801500,1,9,14,1,753,33241753
8716,8,1801500,4,9,14,1,761,33241761
8717,18,1801500,1,9,14,1,779,33241779
8718,9,1801500,1,9,14,1,788,33241788
8719,6,1801500,1,9,14,1,794,33241794
8720,5,1801500,1,9,14,1,799,33241799
8721,23,1801600,3,9,14,1,822,33241822
8722,39,1801500,1,9,14,1,861,33241861
8723,2,1801400,1,9,14,1,863,33241863
8724,3,1801400,1,9,14,1,866,33241866
8725,140,1801500,1,9,14,2,6,33242006
8726,4,1801500,1,9,14,2,10,33242010
8727,49,1801600,1,9,14,2,59,33242059
8728,29,1801400,1,9,14,2,88,33242088
8729,128,1801400,1,9,14,2,216,33242216
8731,16,1801500,1,9,14,2,232,33242232
8732,268,1801500,1,9,14,2,500,33242500
8733,21,1801500,1,9,14,2,521,33242521
8734,3,1801600,1,9,14,2,524,33242524
8735,156,1801600,1,9,14,2,680,33242680
8736,8,1801400,1,9,14,2,688,33242688
8737,116,1801500,1,9,14,2,804,33242804
8738,33,1801400,2,9,14,2,837,33242837
8739,18,1801500,4,9,14,2,855,33242855
8741,2,1801400,1,9,14,2,857,33242857
8742,186,1801300,1,9,14,3,43,33243043
8743,209,1801300,4,9,14,3,252,33243252
8744,141,1801400,2,9,14,3,393,33243393
8745,91,1801400,1,9,14,3,484,33243484
8746,34,1801500,1,9,14,3,518,33243518
8747,234,1801400,1,9,14,3,752,33243752
8748,142,1801300,1,9,14,3,894,33243894
8749,9,1801500,1,9,14,3,903,33243903
8750,112,1801500,1,9,14,4,15,33244015
8751,3,1801500,1,9,14,4,18,33244018
8752,1,1801500,1,9,14,4,19,33244019
8753,9,1801500,1,9,14,4,28,33244028
8754,1,1801500,1,9,14,4,29,33244029
8755,16,1801500,1,9,14,4,45,33244045
8756,40,1801300,1,9,14,4,85,33244085
8757,186,1801300,3,9,14,4,271,33244271
8758,129,1801400,3,9,14,4,400,33244400
8759,99,1801200,2,9,14,4,499,33244499
8760,39,1801400,4,9,14,4,538,33244538
8762,104,1801400,1,9,14,4,642,33244642
8763,104,1801300,1,9,14,4,746,33244746
8765,14,1801400,1,9,14,4,760,33244760
8766,77,1801400,1,9,14,4,837,33244837
8767,36,1801500,1,9,14,4,873,33244873
8768,53,1801500,2,9,14,4,926,33244926
8769,74,1801500,1,9,14,5,0,33245000
8770,41,1801500,1,9,14,5,41,33245041
8771,37,1801500,1,9,14,5,78,33245078
8772,69,1801500,1,9,14,5,147,33245147
8773,27,1801300,3,9,14,5,174,33245174
8774,155,1801300,1,9,14,5,329,33245329
8775,27,1801400,2,9,14,5,356,33245356
8777,19,1801300,3,9,14,5,375,33245375
8778,24,1801500,1,9,14,5,399,33245399
8779,26,1801500,1,9,14,5,425,33245425
8780,206,1801400,1,9,14,5,631,33245631
8781,34,1801500,1,9,14,5,665,33245665
8782,39,1801500,1,9,14,5,704,33245704
8783,305,1801500,1,9,14,6,9,33246009
8784,0,1801500,1,9,14,6,9,33246009
8785,14,1801500,1,9,14,6,23,33246023
8786,1,1801400,1,9,14,6,24,33246024
8787,1,1801500,1,9,14,6,25,33246025
8788,18,1801500,1,9,14,6,43,33246043
8789,92,1801500,1,9,14,6,135,33246135
8790,43,1801500,1,9,14,6,178,33246178
8791,243,1801600,1,9,14,6,421,33246421
8792,38,1801400,2,9,14,6,459,33246459
8793,60,1801600,1,9,14,6,519,33246519
8794,0,1801600,1,9,14,6,519,33246519
8795,1,1801600,1,9,14,6,520,33246520
8796,0,1801600,1,9,14,6,520,33246520
8797,3,1801600,1,9,14,6,523,33246523
8798,3,1801600,1,9,14,6,526,33246526
8799,0,1801600,3,9,14,6,526,33246526
8801,263,1801400,3,9,14,6,789,33246789
8802,106,1801400,1,9,14,6,895,33246895
8803,35,1801500,1,9,14,6,930,33246930
8804,0,1801500,2,9,14,6,930,33246930
8805,9,1801400,1,9,14,6,939,33246939
8806,46,1801400,1,9,14,6,985,33246985
8807,84,1801500,1,9,14,7,69,33247069
8808,14,1801500,1,9,14,7,83,33247083
8809,18,1801500,1,9,14,7,101,33247101
8810,64,1801600,3,9,14,7,165,33247165
8811,17,1801600,1,9,14,7,182,33247182
8812,325,1801500,1,9,14,7,507,33247507
8813,210,1801500,1,9,14,7,717,33247717
8814,0,1801500,4,9,14,7,717,33247717
8815,342,1801600,1,9,14,8,59,33248059
8816,170,1801500,1,9,14,8,229,33248229
8817,12,1801500,1,9,14,8,241,33248241
8818,43,1801400,4,9,14,8,284,33248284
8819,0,1801400,4,9,14,8,284,33248284
8820,0,1801400,4,9,14,8,284,33248284
8822,5,1801300,1,9,14,8,289,33248289
8823,7,1801200,1,9,14,8,296,33248296
8824,8,1801300,1,9,14,8,304,33248304
8825,31,1801300,1,9,14,8,335,33248335
8826,19,1801300,1,9,14,8,354,33248354
8827,17,1801200,1,9,14,8,371,33248371
8828,45,1801200,1,9,14,8,416,33248416
8829,8,1801200,1,9,14,8,424,33248424
8830,19,1801100,1,9,14,8,443,33248443
8831,22,1801200,1,9,14,8,465,33248465
8832,0,1801300,1,9,14,8,465,33248465
8833,24,1801300,1,9,14,8,489,33248489
8834,47,1801100,1,9,14,8,536,33248536
8835,19,1801300,1,9,14,8,555,33248555
8836,220,1801300,1,9,14,8,775,33248775
8837,451,1801300,1,9,14,9,226,33249226
8838,166,1801300,1,9,14,9,392,33249392
8840,154,1801300,2,9,14,9,546,33249546
8841,152,1801400,1,9,14,9,698,33249698
8842,266,1801400,1,9,14,9,964,33249964
8843,93,1801400,1,9,14,10,57,33250057
8844,0,1801400,1,9,14,10,57,33250057
8845,415,1801400,1,9,14,10,472,33250472
8846,392,1801300,1,9,14,10,864,33250864
8847,0,1801200,2,9,14,10,864,33250864
8848,6,1801200,1,9,14,10,870,33250870
8849,133,1801300,1,9,14,11,3,33251003
8850,531,1801300,1,9,14,11,534,33251534
8851,2,1801400,1,9,14,11,536,33251536
8852,0,1801400,1,9,14,11,536,33251536
8853,1,1801400,1,9,14,11,537,33251537
8854,1,1801400,1,9,14,11,538,33251538
8855,140,1801200,1,9,14,11,678,33251678
8856,149,1801200,1,9,14,11,827,33251827
8857,159,1801300,1,9,14,11,986,33251986
8858,28,1801300,1,9,14,12,14,33252014
8859,24,1801300,1,9,14,12,38,33252038
8860,1,1801400,1,9,14,12,39,33252039
8861,14,1801400,1,9,14,12,53,33252053
8862,2,1801400,1,9,14,12,55,33252055
8863,121,1801100,1,9,14,12,176,33252176
8864,222,1801200,1,9,14,12,398,33252398
8865,82,1801300,1,9,14,12,480,33252480
8866,1,1801200,2,9,14,12,481,33252481
8867,53,1801100,1,9,14,12,534,33252534
8868,9,1801300,1,9,14,12,543,33252543
8869,56,1801200,1,9,14,12,599,33252599
8870,645,1801100,1,9,14,13,244,33253244
8871,450,1801100,1,9,14,13,694,33253694
8872,46,1801300,1,9,14,13,740,33253740
8873,687,1801200,1,9,14,14,427,33254427
8874,720,1801300,1,9,14,15,147,33255147
8875,345,1801300,2,9,14,15,492,33255492
8877,63,1801300,1,9,14,15,555,33255555
8878,147,1801300,2,9,14,15,702,33255702
8879,434,1801200,1,9,14,16,136,33256136
8880,518,1801200,2,9,14,16,654,33256654
8881,39,1801300,1,9,14,16,693,33256693
8882,67,1801200,1,9,14,16,760,33256760
8883,117,1801300,2,9,14,16,877,33256877
8884,51,1801200,7,9,14,16,928,33256928
8886,112,1801300,3,9,14,17,40,33257040
8887,358,1801100,9,9,14,17,398,33257398
8889,14,1801000,3,9,14,17,412,33257412
8890,85,1800900,6,9,14,17,497,33257497
8891,153,1801000,1,9,14,17,650,33257650
8892,18,1801000,3,9,14,17,668,33257668
8893,6,1801000,1,9,14,17,674,33257674
8894,3,1801000,3,9,14,17,677,33257677
8895,64,1801000,1,9,14,17,741,33257741
8896,108,1800800,1,9,14,17,849,33257849
8897,178,1801000,1,9,14,18,27,33258027
8898,1,1801000,1,9,14,18,28,33258028
8899,0,1801000,1,9,14,18,28,33258028
8900,2,1801000,1,9,14,18,30,33258030
8901,0,1801000,1,9,14,18,30,33258030
8902,2,1801000,1,9,14,18,32,33258032
8903,3,1801000,1,9,14,18,35,33258035
8904,11,1800900,1,9,14,18,46,33258046
8905,169,1801000,1,9,14,18,215,33258215
8906,1,1801000,3,9,14,18,216,33258216
8907,27,1801000,1,9,14,18,243,33258243
8908,303,1800900,3,9,14,18,546,33258546
8909,369,1801000,1,9,14,18,915,33258915
8910,68,1801000,3,9,14,18,983,33258983
8911,10,1801000,1,9,14,18,993,33258993
8912,67,1800900,2,9,14,19,60,33259060
8913,44,1800900,1,9,14,19,104,33259104
8914,345,1800800,1,9,14,19,449,33259449
8915,243,1800800,1,9,14,19,692,33259692
8916,376,1800800,1,9,14,20,68,33260068
8917,628,1800800,1,9,14,20,696,33260696
8918,133,1800900,2,9,14,20,829,33260829
8919,1,1800900,1,9,14,20,830,33260830
8920,132,1800800,1,9,14,20,962,33260962
8921,571,1801000,1,9,14,21,533,33261533
8922,131,1801000,2,9,14,21,664,33261664
8923,56,1800900,1,9,14,21,720,33261720
8924,69,1801000,3,9,14,21,789,33261789
8925,54,1800900,1,9,14,21,843,33261843
8926,228,1801000,1,9,14,22,71,33262071
8927,140,1801000,3,9,14,22,211,33262211
8928,271,1801000,1,9,14,22,482,33262482
8929,27,1801100,1,9,14,22,509,33262509
8930,127,1801100,1,9,14,22,636,33262636
8931,328,1801200,9,9,14,22,964,33262964
8932,521,1801300,2,9,14,23,485,33263485
8934,347,1801400,1,9,14,23,832,33263832
8935,399,1801400,1,9,14,24,231,33264231
8936,445,1801400,1,9,14,24,676,33264676
8937,102,1801500,10,9,14,24,778,33264778
8938,75,1801500,1,9,14,24,853,33264853
8939,101,1801400,1,9,14,24,954,33264954
8940,1,1801400,1,9,14,24,955,33264955
8941,301,1801400,1,9,14,25,256,33265256
8942,147,1801500,1,9,14,25,403,33265403
8943,15,1801400,2,9,14,25,418,33265418
8944,461,1801400,1,9,14,25,879,33265879
8945,778,1801500,1,9,14,26,657,33266657
8946,73,1801500,1,9,14,26,730,33266730
8947,496,1801500,1,9,14,27,226,33267226
8949,39,1801500,1,9,14,27,265,33267265
8950,157,1801400,1,9,14,27,422,33267422
8951,83,1801500,1,9,14,27,505,33267505
8952,77,1801500,2,9,14,27,582,33267582
8953,629,1801600,1,9,14,28,211,33268211
8954,25,1801400,1,9,14,28,236,33268236
8955,101,1801500,7,9,14,28,337,33268337
8956,78,1801400,1,9,14,28,415,33268415
8957,9,1801400,1,9,14,28,424,33268424
8958,5,1801500,17,9,14,28,429,33268429
8960,93,1801500,1,9,14,28,522,33268522
8961,116,1801500,1,9,14,28,638,33268638
8962,557,1801500,1,9,14,29,195,33269195
8963,41,1801400,1,9,14,29,236,33269236
8965,313,1801500,1,9,14,29,549,33269549
8966,810,1801500,1,9,14,30,359,33270359
8967,230,1801400,2,9,14,30,589,33270589
8968,84,1801400,2,9,14,30,673,33270673
8970,163,1801400,1,9,14,30,836,33270836
8971,85,1801500,3,9,14,30,921,33270921
8972,73,1801500,1,9,14,30,994,33270994
8973,19,1801500,1,9,14,31,13,33271013
8974,10,1801600,1,9,14,31,23,33271023
8975,83,1801500,1,9,14,31,106,33271106
8976,376,1801500,1,9,14,31,482,33271482
8977,30,1801500,1,9,14,31,512,33271512
8978,445,1801500,1,9,14,31,957,33271957
8979,64,1801500,2,9,14,32,21,33272021
8980,5,1801500,2,9,14,32,26,33272026
8981,42,1801400,4,9,14,32,68,33272068
8982,52,1801300,2,9,14,32,120,33272120
8983,25,1801400,1,9,14,32,145,33272145
8984,1183,1801300,1,9,14,33,328,33273328
8985,890,1801400,2,9,14,34,218,33274218
8986,314,1801400,1,9,14,34,532,33274532
8987,1141,1801400,3,9,14,35,673,33275673
8988,15,1801400,3,9,14,35,688,33275688
8989,1357,1801300,1,9,14,37,45,33277045
8990,158,1801400,1,9,14,37,203,33277203
8991,144,1801300,1,9,14,37,347,33277347
8992,146,1801500,2,9,14,37,493,33277493
8993,0,1801500,12,9,14,37,493,33277493
8994,0,1801500,1,9,14,37,493,33277493
8995,0,1801500,5,9,14,37,493,33277493
8996,619,1801500,1,9,14,38,112,33278112
8997,510,1801600,2,9,14,38,622,33278622
8998,26,1801600,1,9,14,38,648,33278648
8999,0,1801600,11,9,14,38,648,33278648
9000,0,1801600,1,9,14,38,648,33278648
9001,0,1801600,1,9,14,38,648,33278648
9002,0,1801600,1,9,14,38,648,33278648
9003,0,1801600,1,9,14,38,648,33278648
9004,12,1801600,1,9,14,38,660,33278660
9005,134,1801700,5,9,14,38,794,33278794
9006,269,1801600,2,9,14,39,63,33279063
9007,247,1801700,2,9,14,39,310,33279310
9008,142,1801700,4,9,14,39,452,33279452
9009,1,1801700,10,9,14,39,453,33279453
9010,473,1801800,1,9,14,39,926,33279926
9011,207,1801800,1,9,14,40,133,33280133
9012,21,1801800,1,9,14,40,154,33280154
9013,7,1801800,1,9,14,40,161,33280161
9014,151,1801800,2,9,14,40,312,33280312
9015,211,1801800,1,9,14,40,523,33280523
9016,0,1801800,1,9,14,40,523,33280523
9017,185,1801800,48,9,14,40,708,33280708
9018,2,1801800,1,9,14,40,710,33280710
9019,19,1801900,1,9,14,40,729,33280729
9020,21,1801900,6,9,14,40,750,33280750
9021,0,1801900,1,9,14,40,750,33280750
9022,0,1801900,1,9,14,40,750,33280750
9023,0,1801900,4,9,14,40,750,33280750
9024,1,1801900,4,9,14,40,751,33280751
9025,1,1801900,2,9,14,40,752,33280752
9026,9,1801900,2,9,14,40,761,33280761
9027,120,1802000,1,9,14,40,881,33280881
9028,55,1802000,3,9,14,40,936,33280936
9029,16,1801900,1,9,14,40,952,33280952
9030,11,1802000,1,9,14,40,963,33280963
9031,54,1802000,1,9,14,41,17,33281017
9032,2,1802000,2,9,14,41,19,33281019
9033,10,1802000,1,9,14,41,29,33281029
9034,3,1802000,1,9,14,41,32,33281032
9035,0,1802000,4,9,14,41,32,33281032
9036,1,1802000,3,9,14,41,33,33281033
9037,0,1802000,12,9,14,41,33,33281033
9038,0,1802000,1,9,14,41,33,33281033
9039,0,1802000,6,9,14,41,33,33281033
9040,0,1802000,1,9,14,41,33,33281033
9041,1,1802000,4,9,14,41,34,33281034
9042,0,1802000,1,9,14,41,34,33281034
9043,0,1802000,1,9,14,41,34,33281034
9044,0,1802000,2,9,14,41,34,33281034
9045,12,1802100,1,9,14,41,46,33281046
9046,0,1802100,8,9,14,41,46,33281046
9047,1,1802100,1,9,14,41,47,33281047
9048,0,1802100,1,9,14,41,47,33281047
9049,1,1802100,3,9,14,41,48,33281048
9050,0,1802200,1,9,14,41,48,33281048
9051,3,1802100,1,9,14,41,51,33281051
9052,4,1802100,1,9,14,41,55,33281055
9053,4,1802100,1,9,14,41,59,33281059
9054,7,1802200,1,9,14,41,66,33281066
9055,31,1802200,1,9,14,41,97,33281097
9056,21,1802100,2,9,14,41,118,33281118
9058,22,1802200,1,9,14,41,140,33281140
9059,39,1802100,1,9,14,41,179,33281179
9060,22,1802200,2,9,14,41,201,33281201
9061,29,1802200,1,9,14,41,230,33281230
9062,40,1802100,3,9,14,41,270,33281270
9063,11,1802100,1,9,14,41,281,33281281
9064,25,1802200,1,9,14,41,306,33281306
9065,22,1802000,1,9,14,41,328,33281328
9066,3,1802100,1,9,14,41,331,33281331
9067,38,1802200,1,9,14,41,369,33281369
9068,18,1802100,1,9,14,41,387,33281387
9069,25,1802200,1,9,14,41,412,33281412
9070,10,1802200,1,9,14,41,422,33281422
9071,16,1802200,1,9,14,41,438,33281438
9072,52,1802200,2,9,14,41,490,33281490
9073,49,1802200,1,9,14,41,539,33281539
9074,49,1802200,6,9,14,41,588,33281588
9076,4,1802300,2,9,14,41,592,33281592
9077,39,1802300,5,9,14,41,631,33281631
9078,43,1802300,1,9,14,41,674,33281674
9079,31,1802300,1,9,14,41,705,33281705
9080,165,1802300,1,9,14,41,870,33281870
9081,10,1802100,4,9,14,41,880,33281880
9082,4,1802200,1,9,14,41,884,33281884
9083,3,1802200,1,9,14,41,887,33281887
9084,218,1802100,1,9,14,42,105,33282105
9085,224,1802100,1,9,14,42,329,33282329
9086,262,1802000,7,9,14,42,591,33282591
9088,43,1802100,1,9,14,42,634,33282634
9089,247,1802100,3,9,14,42,881,33282881
9090,164,1802000,2,9,14,43,45,33283045
9091,775,1802100,5,9,14,43,820,33283820
9092,92,1802100,1,9,14,43,912,33283912
9093,141,1802000,1,9,14,44,53,33284053
9094,168,1801900,1,9,14,44,221,33284221
9095,38,1802000,2,9,14,44,259,33284259
9096,126,1802100,1,9,14,44,385,33284385
9097,47,1802100,1,9,14,44,432,33284432
9098,118,1802000,1,9,14,44,550,33284550
9099,1,1802100,4,9,14,44,551,33284551
9100,1,1802000,2,9,14,44,552,33284552
9101,54,1802100,1,9,14,44,606,33284606
9102,703,1802100,1,9,14,45,309,33285309
9103,434,1802100,1,9,14,45,743,33285743
9104,85,1802100,1,9,14,45,828,33285828
9105,166,1802200,4,9,14,45,994,33285994
9106,262,1802200,2,9,14,46,256,33286256
9107,174,1802100,1,9,14,46,430,33286430
9108,342,1802200,2,9,14,46,772,33286772
9109,22,1802100,1,9,14,46,794,33286794
9110,7,1802300,3,9,14,46,801,33286801
9111,176,1802400,1,9,14,46,977,33286977
9112,34,1802400,2,9,14,47,11,33287011
9113,57,1802300,1,9,14,47,68,33287068
9114,135,1802400,1,9,14,47,203,33287203
9115,439,1802400,6,9,14,47,642,33287642
9116,69,1802200,1,9,14,47,711,33287711
9117,46,1802400,3,9,14,47,757,33287757
9118,45,1802400,3,9,14,47,802,33287802
9119,4,1802300,1,9,14,47,806,33287806
9120,46,1802300,1,9,14,47,852,33287852
9121,40,1802300,1,9,14,47,892,33287892
9122,27,1802200,1,9,14,47,919,33287919
9123,256,1802400,1,9,14,48,175,33288175
9124,184,1802300,1,9,14,48,359,33288359
9125,62,1802200,1,9,14,48,421,33288421
9126,50,1802200,2,9,14,48,471,33288471
9127,153,1802300,1,9,14,48,624,33288624
9128,12,1802300,2,9,14,48,636,33288636
9129,19,1802300,1,9,14,48,655,33288655
9130,733,1802300,1,9,14,49,388,33289388
9131,289,1802100,2,9,14,49,677,33289677
9132,18,1802300,2,9,14,49,695,33289695
9133,170,1802300,2,9,14,49,865,33289865
9134,79,1802300,2,9,14,49,944,33289944
9135,63,1802300,1,9,14,50,7,33290007
9136,49,1802300,1,9,14,50,56,33290056
9137,124,1802200,1,9,14,50,180,33290180
9138,18,1802300,1,9,14,50,198,33290198
9139,86,1802300,1,9,14,50,284,33290284
9140,206,1802300,4,9,14,50,490,33290490
9141,301,1802200,1,9,14,50,791,33290791
9142,118,1802300,1,9,14,50,909,33290909
9143,47,1802300,1,9,14,50,956,33290956
9144,856,1802200,1,9,14,51,812,33291812
9145,194,1802300,1,9,14,52,6,33292006
9147,1,1802400,1,9,14,52,7,33292007
9148,14,1802200,1,9,14,52,21,33292021
9149,379,1802400,1,9,14,52,400,33292400
9150,140,1802400,3,9,14,52,540,33292540
9151,22,1802300,6,9,14,52,562,33292562
9152,0,1802300,6,9,14,52,562,33292562
9153,0,1802300,6,9,14,52,562,33292562
9155,1,1802000,1,9,14,52,563,33292563
9156,2,1802000,6,9,14,52,565,33292565
9157,0,1802000,2,9,14,52,565,33292565
9158,1,1802000,1,9,14,52,566,33292566
9159,0,1802000,1,9,14,52,566,33292566
9160,39,1802000,4,9,14,52,605,33292605
9161,0,1801900,2,9,14,52,605,33292605
9162,121,1802000,1,9,14,52,726,33292726
9163,40,1802100,2,9,14,52,766,33292766
9164,83,1802100,1,9,14,52,849,33292849
9165,60,1802100,1,9,14,52,909,33292909
9166,21,1801900,1,9,14,52,930,33292930
9167,139,1802100,1,9,14,53,69,33293069
9168,26,1802100,1,9,14,53,95,33293095
9169,124,1802100,1,9,14,53,219,33293219
9170,10,1802100,1,9,14,53,229,33293229
9171,65,1802100,1,9,14,53,294,33293294
9172,209,1802000,1,9,14,53,503,33293503
9173,188,1801900,4,9,14,53,691,33293691
9174,3,1802000,1,9,14,53,694,33293694
9175,402,1802100,1,9,14,54,96,33294096
9176,245,1802000,5,9,14,54,341,33294341
9177,7,1801900,22,9,14,54,348,33294348
9178,2,1801800,1,9,14,54,350,33294350
9179,0,1801800,6,9,14,54,350,33294350
9180,77,1801900,1,9,14,54,427,33294427
9181,109,1801800,2,9,14,54,536,33294536
9182,67,1801700,18,9,14,54,603,33294603
9183,41,1801700,1,9,14,54,644,33294644
9184,51,1801800,1,9,14,54,695,33294695
9185,289,1801800,1,9,14,54,984,33294984
9186,159,1801700,1,9,14,55,143,33295143
9187,582,1801900,1,9,14,55,725,33295725
9188,452,1801800,1,9,14,56,177,33296177
9189,72,1801900,2,9,14,56,249,33296249
9190,38,1801900,1,9,14,56,287,33296287
9191,772,1801700,1,9,14,57,59,33297059
9192,286,1801700,1,9,14,57,345,33297345
9193,115,1801800,1,9,14,57,460,33297460
9194,58,1801700,1,9,14,57,518,33297518
9195,76,1801800,1,9,14,57,594,33297594
9196,677,1801700,1,9,14,58,271,33298271
9197,104,1801700,2,9,14,58,375,33298375
9198,178,1801900,6,9,14,58,553,33298553
9199,127,1802000,2,9,14,58,680,33298680
9200,37,1801900,1,9,14,58,717,33298717
9201,226,1802000,1,9,14,58,943,33298943
9202,313,1801800,1,9,14,59,256,33299256
9203,797,1801700,4,9,15,0,53,33300053
9204,61,1801900,1,9,15,0,114,33300114
9205,63,1802000,1,9,15,0,177,33300177
9206,14,1802000,1,9,15,0,191,33300191
9207,24,1802000,1,9,15,0,215,33300215
9208,29,1802000,1,9,15,0,244,33300244
9209,2,1802000,1,9,15,0,246,33300246
9210,7,1802000,1,9,15,0,253,33300253
9211,45,1802000,1,9,15,0,298,33300298
9212,11,1802000,1,9,15,0,309,33300309
9213,18,1802000,1,9,15,0,327,33300327
9214,12,1802000,1,9,15,0,339,33300339
9215,9,1802100,1,9,15,0,348,33300348
9216,35,1802100,1,9,15,0,383,33300383
9217,11,1802100,1,9,15,0,394,33300394
9218,6,1802100,1,9,15,0,400,33300400
9219,25,1802100,1,9,15,0,425,33300425
9220,16,1802100,3,9,15,0,441,33300441
9221,0,1802100,1,9,15,0,441,33300441
9222,27,1802100,1,9,15,0,468,33300468
9223,34,1802100,2,9,15,0,502,33300502
9224,1,1802100,2,9,15,0,503,33300503
9225,23,1802100,2,9,15,0,526,33300526
9226,4,1802200,1,9,15,0,530,33300530
9227,10,1802200,4,9,15,0,540,33300540
9228,2,1802200,1,9,15,0,542,33300542
9229,1,1802200,1,9,15,0,543,33300543
9230,8,1802200,1,9,15,0,551,33300551
9231,34,1802200,1,9,15,0,585,33300585
9232,1,1802200,2,9,15,0,586,33300586
9233,20,1802200,5,9,15,0,606,33300606
9234,12,1802200,1,9,15,0,618,33300618
9235,115,1802100,1,9,15,0,733,33300733
9236,26,1802100,1,9,15,0,759,33300759
9237,8,1802100,1,9,15,0,767,33300767
9238,51,1802100,1,9,15,0,818,33300818
9239,3,1802100,1,9,15,0,821,33300821
9241,26,1802100,1,9,15,0,847,33300847
9242,37,1802200,1,9,15,0,884,33300884
9243,14,1802200,9,9,15,0,898,33300898
9245,11,1802200,1,9,15,0,909,33300909
9246,19,1802200,1,9,15,0,928,33300928
9247,9,1802100,1,9,15,0,937,33300937
9248,2,1802200,5,9,15,0,939,33300939
9249,5,1802200,1,9,15,0,944,33300944
9250,54,1802000,1,9,15,0,998,33300998
9251,126,1802000,1,9,15,1,124,33301124
9252,5,1802000,1,9,15,1,129,33301129
9253,41,1802000,1,9,15,1,170,33301170
9254,9,1802100,1,9,15,1,179,33301179
9255,48,1802100,1,9,15,1,227,33301227
9256,70,1802000,1,9,15,1,297,33301297
9257,95,1802100,1,9,15,1,392,33301392
9258,11,1802100,5,9,15,1,403,33301403
9259,39,1802100,2,9,15,1,442,33301442
9260,8,1802100,1,9,15,1,450,33301450
9261,19,1802100,2,9,15,1,469,33301469
9263,4,1802200,1,9,15,1,473,33301473
9264,38,1802200,1,9,15,1,511,33301511
9265,18,1802200,1,9,15,1,529,33301529
9266,28,1802200,1,9,15,1,557,33301557
9267,59,1802000,1,9,15,1,616,33301616
9268,24,1802200,1,9,15,1,640,33301640
9269,47,1802000,2,9,15,1,687,33301687
9270,17,1802200,3,9,15,1,704,33301704
9271,16,1802200,8,9,15,1,720,33301720
9272,21,1802000,4,9,15,1,741,33301741
9273,106,1802000,1,9,15,1,847,33301847
9274,52,1802100,3,9,15,1,899,33301899
9276,33,1802200,1,9,15,1,932,33301932
9277,14,1802200,3,9,15,1,946,33301946
9278,106,1802000,2,9,15,2,52,33302052
9279,7,1802000,2,9,15,2,59,33302059
9280,48,1802200,1,9,15,2,107,33302107
9281,8,1802100,1,9,15,2,115,33302115
9282,174,1802200,1,9,15,2,289,33302289
9283,7,1802200,1,9,15,2,296,33302296
9284,114,1802000,2,9,15,2,410,33302410
9285,2,1802200,1,9,15,2,412,33302412
9286,32,1802200,1,9,15,2,444,33302444
9287,7,1802200,2,9,15,2,451,33302451
9288,247,1802200,8,9,15,2,698,33302698
9289,30,1802200,1,9,15,2,728,33302728
9290,142,1802100,1,9,15,2,870,33302870
9291,53,1802200,1,9,15,2,923,33302923
9292,4,1802000,2,9,15,2,927,33302927
9293,21,1802200,1,9,15,2,948,33302948
9294,75,1802200,1,9,15,3,23,33303023
9295,123,1802200,1,9,15,3,146,33303146
9296,40,1802200,1,9,15,3,186,33303186
9297,274,1802100,1,9,15,3,460,33303460
9298,140,1802200,1,9,15,3,600,33303600
9299,242,1802300,1,9,15,3,842,33303842
9300,392,1802200,1,9,15,4,234,33304234
9301,152,1802100,1,9,15,4,386,33304386
9302,446,1802200,1,9,15,4,832,33304832
9303,0,1802200,1,9,15,4,832,33304832
9305,11,1802200,1,9,15,4,843,33304843
9306,95,1802300,8,9,15,4,938,33304938
9307,355,1802300,4,9,15,5,293,33305293
9308,177,1802300,11,9,15,5,470,33305470
9309,137,1802300,1,9,15,5,607,33305607
9310,395,1802400,1,9,15,6,2,33306002
9311,162,1802500,1,9,15,6,164,33306164
9312,13,1802500,1,9,15,6,177,33306177
9313,6,1802500,1,9,15,6,183,33306183
9314,13,1802500,1,9,15,6,196,33306196
9315,7,1802400,3,9,15,6,203,33306203
9316,10,1802500,4,9,15,6,213,33306213
9317,28,1802500,1,9,15,6,241,33306241
9318,34,1802500,1,9,15,6,275,33306275
9319,15,1802500,1,9,15,6,290,33306290
9320,5,1802400,1,9,15,6,295,33306295
9321,25,1802500,2,9,15,6,320,33306320
9322,15,1802500,1,9,15,6,335,33306335
9323,10,1802500,7,9,15,6,345,33306345
9324,0,1802500,2,9,15,6,345,33306345
9325,9,1802500,2,9,15,6,354,33306354
9326,5,1802600,5,9,15,6,359,33306359
9327,4,1802600,4,9,15,6,363,33306363
9328,3,1802600,4,9,15,6,366,33306366
9330,3,1802700,4,9,15,6,369,33306369
9331,1,1802700,10,9,15,6,370,33306370
9332,0,1802700,13,9,15,6,370,33306370
9333,1,1802700,1,9,15,6,371,33306371
9334,0,1802700,1,9,15,6,371,33306371
9335,2,1802700,5,9,15,6,373,33306373
9336,9,1802800,2,9,15,6,382,33306382
9337,41,1802600,1,9,15,6,423,33306423
9338,30,1802800,1,9,15,6,453,33306453
9339,2,1802800,2,9,15,6,455,33306455
9340,4,1802800,1,9,15,6,459,33306459
9341,0,1802800,1,9,15,6,459,33306459
9342,1,1802800,1,9,15,6,460,33306460
9343,2,1802800,1,9,15,6,462,33306462
9344,3,1802800,1,9,15,6,465,33306465
9345,11,1802800,1,9,15,6,476,33306476
9346,1,1802800,1,9,15,6,477,33306477
9347,0,1802800,1,9,15,6,477,33306477
9348,2,1802800,1,9,15,6,479,33306479
9349,4,1802700,1,9,15,6,483,33306483
9350,12,1802800,1,9,15,6,495,33306495
9351,28,1802700,1,9,15,6,523,33306523
9352,9,1802800,1,9,15,6,532,33306532
9353,3,1802800,2,9,15,6,535,33306535
9354,4,1802800,2,9,15,6,539,33306539
9355,5,1802800,1,9,15,6,544,33306544
9356,5,1802800,2,9,15,6,549,33306549
9357,7,1802700,1,9,15,6,556,33306556
9358,8,1802800,2,9,15,6,564,33306564
9359,15,1802800,3,9,15,6,579,33306579
9360,7,1802800,1,9,15,6,586,33306586
9361,14,1802800,1,9,15,6,600,33306600
9362,21,1802700,1,9,15,6,621,33306621
9363,1,1802800,2,9,15,6,622,33306622
9364,3,1802800,2,9,15,6,625,33306625
9365,43,1802800,1,9,15,6,668,33306668
9366,10,1802800,1,9,15,6,678,33306678
9367,47,1802800,1,9,15,6,725,33306725
9368,26,1802600,1,9,15,6,751,33306751
9369,10,1802700,1,9,15,6,761,33306761
9370,1,1802700,5,9,15,6,762,33306762
9372,6,1802700,1,9,15,6,768,33306768
9373,19,1802700,1,9,15,6,787,33306787
9374,1,1802700,1,9,15,6,788,33306788
9375,34,1802500,1,9,15,6,822,33306822
9376,0,1802700,1,9,15,6,822,33306822
9377,6,1802600,1,9,15,6,828,33306828
9378,2,1802700,2,9,15,6,830,33306830
9379,10,1802700,3,9,15,6,840,33306840
9381,45,1802600,1,9,15,6,885,33306885
9382,63,1802700,1,9,15,6,948,33306948
9384,3,1802700,1,9,15,6,951,33306951
9385,32,1802800,1,9,15,6,983,33306983
9386,36,1802800,1,9,15,7,19,33307019
9387,53,1802700,1,9,15,7,72,33307072
9388,11,1802700,1,9,15,7,83,33307083
9389,10,1802700,1,9,15,7,93,33307093
9390,8,1802700,1,9,15,7,101,33307101
9391,0,1802700,1,9,15,7,101,33307101
9392,7,1802800,1,9,15,7,108,33307108
9393,48,1802800,1,9,15,7,156,33307156
9394,11,1802800,1,9,15,7,167,33307167
9395,169,1802600,1,9,15,7,336,33307336
9396,47,1802800,1,9,15,7,383,33307383
9397,21,1802800,1,9,15,7,404,33307404
9398,58,1802800,1,9,15,7,462,33307462
9399,14,1802800,1,9,15,7,476,33307476
9400,93,1802900,2,9,15,7,569,33307569
9401,5,1802700,1,9,15,7,574,33307574
9402,24,1802600,3,9,15,7,598,33307598
9403,4,1802600,3,9,15,7,602,33307602
9404,11,1802700,1,9,15,7,613,33307613
9405,13,1802700,1,9,15,7,626,33307626
9406,75,1802700,1,9,15,7,701,33307701
9407,8,1802700,1,9,15,7,709,33307709
9408,29,1802700,1,9,15,7,738,33307738
9409,42,1802700,1,9,15,7,780,33307780
9410,54,1802700,1,9,15,7,834,33307834
9411,39,1802600,2,9,15,7,873,33307873
9412,112,1802700,1,9,15,7,985,33307985
9413,17,1802700,1,9,15,8,2,33308002
9414,56,1802700,1,9,15,8,58,33308058
9415,101,1802700,2,9,15,8,159,33308159
9416,77,1802600,2,9,15,8,236,33308236
9417,47,1802700,1,9,15,8,283,33308283
9418,11,1802700,3,9,15,8,294,33308294
9419,5,1802600,1,9,15,8,299,33308299
9420,54,1802600,1,9,15,8,353,33308353
9421,46,1802700,2,9,15,8,399,33308399
9422,6,1802700,1,9,15,8,405,33308405
9423,3,1802600,2,9,15,8,408,33308408
9424,87,1802700,1,9,15,8,495,33308495
9426,160,1802800,2,9,15,8,655,33308655
9427,34,1802700,1,9,15,8,689,33308689
9428,33,1802800,1,9,15,8,722,33308722
9429,57,1802700,1,9,15,8,779,33308779
9431,33,1802800,1,9,15,8,812,33308812
9432,266,1802700,1,9,15,9,78,33309078
9433,28,1802500,2,9,15,9,106,33309106
9434,71,1802700,1,9,15,9,177,33309177
9435,64,1802700,1,9,15,9,241,33309241
9436,642,1802700,1,9,15,9,883,33309883
9437,64,1802700,1,9,15,9,947,33309947
9438,128,1802600,2,9,15,10,75,33310075
9439,6,1802800,1,9,15,10,81,33310081
9440,273,1802700,1,9,15,10,354,33310354
9441,165,1802600,1,9,15,10,519,33310519
9442,75,1802700,1,9,15,10,594,33310594
9443,419,1802700,1,9,15,11,13,33311013
9444,131,1802600,5,9,15,11,144,33311144
9445,186,1802700,5,9,15,11,330,33311330
9446,554,1802500,1,9,15,11,884,33311884
9447,88,1802600,2,9,15,11,972,33311972
9448,0,1802500,4,9,15,11,972,33311972
9449,21,1802500,1,9,15,11,993,33311993
9450,42,1802500,1,9,15,12,35,33312035
9451,12,1802500,8,9,15,12,47,33312047
9452,0,1802500,8,9,15,12,47,33312047
9454,42,1802400,3,9,15,12,89,33312089
9455,1,1802300,1,9,15,12,90,33312090
9456,0,1802300,2,9,15,12,90,33312090
9457,135,1802500,1,9,15,12,225,33312225
9458,208,1802400,1,9,15,12,433,33312433
9459,293,1802400,1,9,15,12,726,33312726
9460,116,1802600,1,9,15,12,842,33312842
9461,40,1802600,2,9,15,12,882,33312882
9463,71,1802600,1,9,15,12,953,33312953
9465,76,1802500,1,9,15,13,29,33313029
9466,21,1802700,1,9,15,13,50,33313050
9467,451,1802700,1,9,15,13,501,33313501
9468,134,1802600,5,9,15,13,635,33313635
9469,171,1802600,1,9,15,13,806,33313806
9470,462,1802700,1,9,15,14,268,33314268
9471,12,1802700,1,9,15,14,280,33314280
9472,77,1802700,1,9,15,14,357,33314357
9473,89,1802800,2,9,15,14,446,33314446
9474,1,1802700,1,9,15,14,447,33314447
9475,148,1802700,1,9,15,14,595,33314595
9476,664,1802700,1,9,15,15,259,33315259
9477,211,1802700,1,9,15,15,470,33315470
9478,583,1802800,1,9,15,16,53,33316053
9479,211,1802700,3,9,15,16,264,33316264
9480,124,1802600,1,9,15,16,388,33316388
9481,56,1802600,1,9,15,16,444,33316444
9482,20,1802700,2,9,15,16,464,33316464
9483,0,1802600,3,9,15,16,464,33316464
9484,161,1802700,1,9,15,16,625,33316625
9485,12,1802700,2,9,15,16,637,33316637
9486,0,1802800,1,9,15,16,637,33316637
9487,31,1802800,2,9,15,16,668,33316668
9488,94,1802700,1,9,15,16,762,33316762
9489,95,1802700,1,9,15,16,857,33316857
9490,337,1802700,1,9,15,17,194,33317194
9491,31,1802700,1,9,15,17,225,33317225
9492,1,1802700,1,9,15,17,226,33317226
9493,398,1802700,2,9,15,17,624,33317624
9494,162,1802700,1,9,15,17,786,33317786
9496,116,1802700,2,9,15,17,902,33317902
9497,6,1802500,1,9,15,17,908,33317908
9498,121,1802700,1,9,15,18,29,33318029
9499,465,1802700,1,9,15,18,494,33318494
9500,216,1802600,1,9,15,18,710,33318710
9501,224,1802700,1,9,15,18,934,33318934
9502,223,1802700,1,9,15,19,157,33319157
9504,154,1802700,2,9,15,19,311,33319311
9505,0,1802700,2,9,15,19,311,33319311
9507,47,1802900,15,9,15,19,358,33319358
9508,87,1802700,1,9,15,19,445,33319445
9509,34,1802800,1,9,15,19,479,33319479
9510,119,1802800,1,9,15,19,598,33319598
9511,0,1802800,1,9,15,19,598,33319598
9512,200,1802700,1,9,15,19,798,33319798
9513,114,1802700,5,9,15,19,912,33319912
9514,68,1802800,1,9,15,19,980,33319980
9515,74,1802700,1,9,15,20,54,33320054
9516,740,1802800,1,9,15,20,794,33320794
9517,71,1802700,1,9,15,20,865,33320865
9518,127,1802800,1,9,15,20,992,33320992
9519,112,1802700,1,9,15,21,104,33321104
9520,76,1802700,3,9,15,21,180,33321180
9521,549,1802800,1,9,15,21,729,33321729
9522,0,1802800,1,9,15,21,729,33321729
9523,80,1802700,2,9,15,21,809,33321809
9524,432,1802900,5,9,15,22,241,33322241
9525,0,1802900,1,9,15,22,241,33322241
9526,118,1802800,1,9,15,22,359,33322359
9527,3,1802900,1,9,15,22,362,33322362
9529,4,1802900,1,9,15,22,366,33322366
9530,2,1803000,1,9,15,22,368,33322368
9531,171,1803000,1,9,15,22,539,33322539
9532,36,1802900,1,9,15,22,575,33322575
9533,23,1803000,1,9,15,22,598,33322598
9534,10,1803000,2,9,15,22,608,33322608
9535,20,1803000,1,9,15,22,628,33322628
9536,13,1803000,1,9,15,22,641,33322641
9537,15,1803000,1,9,15,22,656,33322656
9538,110,1802900,1,9,15,22,766,33322766
9539,88,1802900,1,9,15,22,854,33322854
9540,351,1803000,2,9,15,23,205,33323205
9541,295,1803000,1,9,15,23,500,33323500
9542,212,1803000,1,9,15,23,712,33323712
9543,3,1802900,3,9,15,23,715,33323715
9544,80,1802900,12,9,15,23,795,33323795
9545,1,1802800,11,9,15,23,796,33323796
9546,0,1802800,1,9,15,23,796,33323796
9547,3,1802900,2,9,15,23,799,33323799
9548,15,1802900,1,9,15,23,814,33323814
9550,23,1802900,1,9,15,23,837,33323837
9551,4,1802800,4,9,15,23,841,33323841
9552,235,1802900,1,9,15,24,76,33324076
9553,13,1802900,1,9,15,24,89,33324089
9554,2,1802900,2,9,15,24,91,33324091
9555,1,1802800,2,9,15,24,92,33324092
9556,408,1802900,1,9,15,24,500,33324500
9557,325,1802700,1,9,15,24,825,33324825
9558,6,1802900,6,9,15,24,831,33324831
9560,49,1802900,1,9,15,24,880,33324880
9561,266,1802800,5,9,15,25,146,33325146
9562,390,1802800,1,9,15,25,536,33325536
9563,13,1802900,1,9,15,25,549,33325549
9564,73,1802900,1,9,15,25,622,33325622
9565,169,1802900,1,9,15,25,791,33325791
9566,701,1802900,1,9,15,26,492,33326492
9567,20,1802900,2,9,15,26,512,33326512
9569,6,1802800,1,9,15,26,518,33326518
9570,26,1803000,2,9,15,26,544,33326544
9571,153,1802800,2,9,15,26,697,33326697
9572,64,1803000,1,9,15,26,761,33326761
9573,124,1803000,1,9,15,26,885,33326885
9574,301,1802900,1,9,15,27,186,33327186
9575,0,1802900,1,9,15,27,186,33327186
9577,34,1802900,3,9,15,27,220,33327220
9578,5,1803000,1,9,15,27,225,33327225
9579,1,1803000,1,9,15,27,226,33327226
9580,0,1803100,1,9,15,27,226,33327226
9581,7,1803100,3,9,15,27,233,33327233
9582,40,1803000,1,9,15,27,273,33327273
9583,99,1803100,1,9,15,27,372,33327372
9584,238,1803100,2,9,15,27,610,33327610
9585,82,1803100,10,9,15,27,692,33327692
9587,59,1803000,1,9,15,27,751,33327751
9588,30,1803100,1,9,15,27,781,33327781
9589,26,1803100,1,9,15,27,807,33327807
9590,8,1803100,1,9,15,27,815,33327815
9591,84,1803100,1,9,15,27,899,33327899
9592,70,1802900,1,9,15,27,969,33327969
9593,2,1803100,1,9,15,27,971,33327971
9594,20,1802900,1,9,15,27,991,33327991
9595,34,1803100,1,9,15,28,25,33328025
9596,15,1803100,1,9,15,28,40,33328040
9597,0,1803100,1,9,15,28,40,33328040
9598,0,1803100,1,9,15,28,40,33328040
9599,1,1803100,1,9,15,28,41,33328041
9600,4,1803000,1,9,15,28,45,33328045
9601,9,1803100,1,9,15,28,54,33328054
9602,5,1803100,1,9,15,28,59,33328059
9603,4,1803000,1,9,15,28,63,33328063
9604,50,1803100,1,9,15,28,113,33328113
9605,4,1803200,1,9,15,28,117,33328117
9606,51,1803200,1,9,15,28,168,33328168
9607,22,1803200,1,9,15,28,190,33328190
9608,13,1803000,3,9,15,28,203,33328203
9609,8,1803100,1,9,15,28,211,33328211
9610,249,1803000,1,9,15,28,460,33328460
9612,8,1803100,2,9,15,28,468,33328468
9613,74,1803100,1,9,15,28,542,33328542
9614,5,1802900,1,9,15,28,547,33328547
9615,51,1803100,1,9,15,28,598,33328598
9616,2,1803200,2,9,15,28,600,33328600
9617,11,1803200,1,9,15,28,611,33328611
9618,14,1803200,2,9,15,28,625,33328625
9619,43,1803000,1,9,15,28,668,33328668
9620,10,1802900,1,9,15,28,678,33328678
9621,183,1803000,2,9,15,28,861,33328861
9622,1,1802900,2,9,15,28,862,33328862
9623,0,1802900,5,9,15,28,862,33328862
9624,129,1803000,1,9,15,28,991,33328991
9625,52,1803000,1,9,15,29,43,33329043
9626,0,1803000,1,9,15,29,43,33329043
9627,1,1803100,1,9,15,29,44,33329044
9628,14,1803100,1,9,15,29,58,33329058
9630,10,1803200,1,9,15,29,68,33329068
9631,10,1803100,1,9,15,29,78,33329078
9632,7,1803000,1,9,15,29,85,33329085
9633,62,1803100,1,9,15,29,147,33329147
9634,252,1803100,1,9,15,29,399,33329399
9635,114,1803100,1,9,15,29,513,33329513
9636,26,1803000,1,9,15,29,539,33329539
9637,164,1803100,1,9,15,29,703,33329703
9638,63,1803100,1,9,15,29,766,33329766
9640,205,1803100,1,9,15,29,971,33329971
9641,116,1803100,1,9,15,30,87,33330087
9642,178,1803000,1,9,15,30,265,33330265
9643,46,1803100,4,9,15,30,311,33330311
9645,4,1803100,1,9,15,30,315,33330315
9646,12,1803100,1,9,15,30,327,33330327
9647,914,1803000,1,9,15,31,241,33331241
9648,37,1803100,1,9,15,31,278,33331278
9649,105,1803100,1,9,15,31,383,33331383
9650,228,1803000,4,9,15,31,611,33331611
9651,415,1802900,1,9,15,32,26,33332026
9652,31,1803000,1,9,15,32,57,33332057
9653,102,1802900,1,9,15,32,159,33332159
9654,57,1802900,1,9,15,32,216,33332216
9655,90,1802900,2,9,15,32,306,33332306
9656,32,1802800,5,9,15,32,338,33332338
9657,26,1802900,1,9,15,32,364,33332364
9658,0,1802800,3,9,15,32,364,33332364
9659,0,1802800,6,9,15,32,364,33332364
9660,120,1802900,1,9,15,32,484,33332484
9661,82,1803000,1,9,15,32,566,33332566
9662,74,1802800,1,9,15,32,640,33332640
9663,143,1802800,1,9,15,32,783,33332783
9664,163,1803000,2,9,15,32,946,33332946
9665,211,1803000,1,9,15,33,157,33333157
9666,604,1802800,2,9,15,33,761,33333761
9667,3,1802800,3,9,15,33,764,33333764
9668,0,1802700,5,9,15,33,764,33333764
9669,1,1802700,3,9,15,33,765,33333765
9670,4,1802800,1,9,15,33,769,33333769
9671,106,1802700,1,9,15,33,875,33333875
9672,99,1802700,1,9,15,33,974,33333974
9673,261,1802900,2,9,15,34,235,33334235
9674,43,1802700,24,9,15,34,278,33334278
9675,1,1802600,3,9,15,34,279,33334279
9676,1,1802600,3,9,15,34,280,33334280
9677,20,1802700,2,9,15,34,300,33334300
9678,0,1802700,2,9,15,34,300,33334300
9680,301,1802700,1,9,15,34,601,33334601
9681,11,1802800,2,9,15,34,612,33334612
9682,29,1802600,1,9,15,34,641,33334641
9683,224,1802600,9,9,15,34,865,33334865
9684,1,1802500,2,9,15,34,866,33334866
9685,117,1802500,15,9,15,34,983,33334983
9686,1,1802500,1,9,15,34,984,33334984
9687,25,1802400,1,9,15,35,9,33335009
9688,101,1802400,10,9,15,35,110,33335110
9690,118,1802400,2,9,15,35,228,33335228
9691,54,1802500,1,9,15,35,282,33335282
9692,1,1802400,1,9,15,35,283,33335283
9693,104,1802500,1,9,15,35,387,33335387
9694,194,1802500,2,9,15,35,581,33335581
9695,218,1802300,2,9,15,35,799,33335799
9696,172,1802500,1,9,15,35,971,33335971
9697,75,1802500,1,9,15,36,46,33336046
9698,121,1802300,4,9,15,36,167,33336167
9699,425,1802400,1,9,15,36,592,33336592
9700,2,1802400,1,9,15,36,594,33336594
9701,102,1802500,1,9,15,36,696,33336696
9702,263,1802400,1,9,15,36,959,33336959
9704,4,1802400,1,9,15,36,963,33336963
9705,101,1802500,4,9,15,37,64,33337064
9706,466,1802400,2,9,15,37,530,33337530
9708,149,1802300,5,9,15,37,679,33337679
9709,149,1802300,1,9,15,37,828,33337828
9710,568,1802400,2,9,15,38,396,33338396
9711,149,1802200,1,9,15,38,545,33338545
9712,121,1802200,1,9,15,38,666,33338666
9713,0,1802200,1,9,15,38,666,33338666
9714,101,1802200,1,9,15,38,767,33338767
9715,179,1802200,1,9,15,38,946,33338946
9716,999,1802400,4,9,15,39,945,33339945
9717,0,1802400,3,9,15,39,945,33339945
9718,126,1802400,1,9,15,40,71,33340071
9719,177,1802600,1,9,15,40,248,33340248
9720,216,1802400,1,9,15,40,464,33340464
9721,708,1802600,1,9,15,41,172,33341172
9722,53,1802500,1,9,15,41,225,33341225
9723,282,1802600,1,9,15,41,507,33341507
9724,46,1802600,1,9,15,41,553,33341553
9725,0,1802600,1,9,15,41,553,33341553
9726,468,1802700,1,9,15,42,21,33342021
9727,377,1802600,1,9,15,42,398,33342398
9728,190,1802600,1,9,15,42,588,33342588
9729,113,1802700,2,9,15,42,701,33342701
9730,1638,1802700,1,9,15,44,339,33344339
9731,49,1802600,5,9,15,44,388,33344388
9732,313,1802700,1,9,15,44,701,33344701
9733,214,1802600,4,9,15,44,915,33344915
9734,591,1802600,1,9,15,45,506,33345506
9735,50,1802600,1,9,15,45,556,33345556
9736,341,1802700,1,9,15,45,897,33345897
9737,193,1802600,1,9,15,46,90,33346090
9738,0,1802600,5,9,15,46,90,33346090
9739,1,1802500,3,9,15,46,91,33346091
9740,455,1802500,1,9,15,46,546,33346546
9741,1,1802500,1,9,15,46,547,33346547
9742,217,1802400,1,9,15,46,764,33346764
9743,168,1802500,1,9,15,46,932,33346932
9744,0,1802400,2,9,15,46,932,33346932
9745,367,1802500,2,9,15,47,299,33347299
9746,3,1802500,3,9,15,47,302,33347302
9747,466,1802600,1,9,15,47,768,33347768
9748,310,1802400,1,9,15,48,78,33348078
9749,97,1802400,3,9,15,48,175,33348175
9751,1249,1802500,1,9,15,49,424,33349424
9752,1,1802500,1,9,15,49,425,33349425
9753,0,1802500,1,9,15,49,425,33349425
9754,0,1802500,5,9,15,49,425,33349425
9755,0,1802500,2,9,15,49,425,33349425
9756,73,1802500,2,9,15,49,498,33349498
9757,523,1802500,1,9,15,50,21,33350021
9758,159,1802500,1,9,15,50,180,33350180
9759,241,1802600,1,9,15,50,421,33350421
9760,485,1802600,6,9,15,50,906,33350906
9761,780,1802600,4,9,15,51,686,33351686
9763,534,1802600,1,9,15,52,220,33352220
9764,312,1802600,1,9,15,52,532,33352532
9765,481,1802600,2,9,15,53,13,33353013
9766,730,1802500,1,9,15,53,743,33353743
9767,434,1802600,1,9,15,54,177,33354177
9768,212,1802500,1,9,15,54,389,33354389
9769,333,1802600,1,9,15,54,722,33354722
9770,154,1802600,1,9,15,54,876,33354876
9771,40,1802700,8,9,15,54,916,33354916
9773,351,1802800,2,9,15,55,267,33355267
9774,861,1802800,1,9,15,56,128,33356128
9775,684,1802800,1,9,15,56,812,33356812
9776,0,1802800,1,9,15,56,812,33356812
9777,0,1802800,1,9,15,56,812,33356812
9778,467,1802800,1,9,15,57,279,33357279
9779,0,1802800,1,9,15,57,279,33357279
9780,0,1802800,1,9,15,57,279,33357279
9781,443,1802900,5,9,15,57,722,33357722
9782,8,1803000,1,9,15,57,730,33357730
9783,132,1802800,1,9,15,57,862,33357862
9784,1299,1802800,1,9,15,59,161,33359161
9785,111,1802800,1,9,15,59,272,33359272
9786,1964,1802800,2,9,16,1,236,33361236
9787,34,1802900,1,9,16,1,270,33361270
9789,82,1803000,1,9,16,1,352,33361352
9790,0,1803000,5,9,16,1,352,33361352
9791,0,1803000,2,9,16,1,352,33361352
9792,0,1803000,2,9,16,1,352,33361352
9793,0,1803000,3,9,16,1,352,33361352
9794,0,1803000,2,9,16,1,352,33361352
9795,1,1803000,1,9,16,1,353,33361353
9796,0,1803000,1,9,16,1,353,33361353
9797,1,1803000,1,9,16,1,354,33361354
9798,8,1803000,3,9,16,1,362,33361362
9799,25,1802900,3,9,16,1,387,33361387
9800,117,1802900,3,9,16,1,504,33361504
9801,104,1803000,1,9,16,1,608,33361608
9802,195,1803000,1,9,16,1,803,33361803
9803,339,1802900,1,9,16,2,142,33362142
9804,83,1803000,1,9,16,2,225,33362225
9805,1,1803000,1,9,16,2,226,33362226
9806,0,1803000,1,9,16,2,226,33362226
9807,0,1803000,1,9,16,2,226,33362226
9808,0,1803000,1,9,16,2,226,33362226
9809,0,1803000,1,9,16,2,226,33362226
9810,1,1803000,1,9,16,2,227,33362227
9811,233,1803000,2,9,16,2,460,33362460
9812,741,1803100,1,9,16,3,201,33363201
9813,179,1803000,1,9,16,3,380,33363380
9814,339,1803100,1,9,16,3,719,33363719
9815,294,1803000,1,9,16,4,13,33364013
9816,21,1803100,1,9,16,4,34,33364034
9817,69,1803000,6,9,16,4,103,33364103
9818,84,1803100,1,9,16,4,187,33364187
9819,11,1802900,2,9,16,4,198,33364198
9820,88,1802900,2,9,16,4,286,33364286
9821,218,1802800,1,9,16,4,504,33364504
9822,59,1803000,5,9,16,4,563,33364563
9824,637,1803100,7,9,16,5,200,33365200
9826,18,1803000,1,9,16,5,218,33365218
9827,148,1803000,1,9,16,5,366,33365366
9828,216,1802900,1,9,16,5,582,33365582
9829,1262,1803000,1,9,16,6,844,33366844
9830,45,1803000,1,9,16,6,889,33366889
9831,470,1803000,1,9,16,7,359,33367359
9832,116,1803100,1,9,16,7,475,33367475
9833,0,1803100,1,9,16,7,475,33367475
9834,0,1803100,1,9,16,7,475,33367475
9835,0,1803100,1,9,16,7,475,33367475
9836,1,1803100,1,9,16,7,476,33367476
9837,0,1803100,1,9,16,7,476,33367476
9838,0,1803100,1,9,16,7,476,33367476
9839,0,1803200,1,9,16,7,476,33367476
9840,0,1803200,1,9,16,7,476,33367476
9841,0,1803200,1,9,16,7,476,33367476
9842,0,1803200,1,9,16,7,476,33367476
9843,0,1803200,1,9,16,7,476,33367476
9844,0,1803200,1,9,16,7,476,33367476
9845,1,1803200,1,9,16,7,477,33367477
9846,0,1803100,1,9,16,7,477,33367477
9847,0,1803100,1,9,16,7,477,33367477
9848,93,1803100,2,9,16,7,570,33367570
9849,4,1803100,3,9,16,7,574,33367574
9850,62,1803100,1,9,16,7,636,33367636
9851,164,1803000,1,9,16,7,800,33367800
9852,189,1803100,2,9,16,7,989,33367989
9853,434,1803000,1,9,16,8,423,33368423
9854,496,1803200,1,9,16,8,919,33368919
9855,20,1803100,3,9,16,8,939,33368939
9857,124,1803100,1,9,16,9,63,33369063
9858,60,1803100,1,9,16,9,123,33369123
9859,108,1803200,1,9,16,9,231,33369231
9860,7,1803000,1,9,16,9,238,33369238
9861,11,1803000,1,9,16,9,249,33369249
9862,39,1803100,1,9,16,9,288,33369288
9863,58,1803200,1,9,16,9,346,33369346
9864,397,1803100,1,9,16,9,743,33369743
9865,197,1803000,1,9,16,9,940,33369940
9866,737,1803200,1,9,16,10,677,33370677
9867,286,1803100,1,9,16,10,963,33370963
9868,219,1803100,1,9,16,11,182,33371182
9869,119,1803100,1,9,16,11,301,33371301
9870,51,1803100,1,9,16,11,352,33371352
9871,250,1803100,2,9,16,11,602,33371602
9872,653,1803100,1,9,16,12,255,33372255
9873,73,1803100,1,9,16,12,328,33372328
9874,635,1803100,1,9,16,12,963,33372963
9875,502,1803100,1,9,16,13,465,33373465
9876,268,1803100,1,9,16,13,733,33373733
9877,26,1803100,1,9,16,13,759,33373759
9878,166,1803000,1,9,16,13,925,33373925
9879,1185,1803100,2,9,16,15,110,33375110
9880,60,1803000,6,9,16,15,170,33375170
9881,2,1803000,24,9,16,15,172,33375172
9882,4,1802900,2,9,16,15,176,33375176
9883,173,1802900,1,9,16,15,349,33375349
9884,44,1802800,2,9,16,15,393,33375393
9885,162,1802800,1,9,16,15,555,33375555
9886,518,1802800,13,9,16,16,73,33376073
9887,128,1802700,8,9,16,16,201,33376201
9888,152,1802600,1,9,16,16,353,33376353
9889,164,1802600,20,9,16,16,517,33376517
9890,7,1802600,4,9,16,16,524,33376524
9891,80,1802700,1,9,16,16,604,33376604
9892,126,1802500,6,9,16,16,730,33376730
9893,78,1802600,1,9,16,16,808,33376808
9894,64,1802600,1,9,16,16,872,33376872
9895,61,1802600,1,9,16,16,933,33376933
9896,43,1802600,4,9,16,16,976,33376976
9897,189,1802600,2,9,16,17,165,33377165
9898,24,1802700,1,9,16,17,189,33377189
9899,13,1802600,3,9,16,17,202,33377202
9900,23,1802700,1,9,16,17,225,33377225
9901,0,1802700,1,9,16,17,225,33377225
9902,1,1802700,1,9,16,17,226,33377226
9903,0,1802800,1,9,16,17,226,33377226
9904,0,1802800,1,9,16,17,226,33377226
9905,0,1802800,1,9,16,17,226,33377226
9906,0,1802800,1,9,16,17,226,33377226
9907,1,1802800,1,9,16,17,227,33377227
9908,1,1802800,1,9,16,17,228,33377228
9909,94,1802700,6,9,16,17,322,33377322
9910,14,1802700,1,9,16,17,336,33377336
9911,168,1802700,2,9,16,17,504,33377504
9912,232,1802700,3,9,16,17,736,33377736
9913,509,1802600,3,9,16,18,245,33378245
9914,318,1802700,1,9,16,18,563,33378563
9915,70,1802700,1,9,16,18,633,33378633
9916,61,1802600,1,9,16,18,694,33378694
9917,338,1802700,1,9,16,19,32,33379032
9918,42,1802700,5,9,16,19,74,33379074
9919,0,1802700,5,9,16,19,74,33379074
9921,466,1802700,2,9,16,19,540,33379540
9922,317,1802600,4,9,16,19,857,33379857
9923,163,1802600,2,9,16,20,20,33380020
9924,91,1802700,1,9,16,20,111,33380111
9925,528,1802500,31,9,16,20,639,33380639
9926,11,1802400,2,9,16,20,650,33380650
9927,1,1802400,3,9,16,20,651,33380651
9928,0,1802400,2,9,16,20,651,33380651
9929,0,1802400,1,9,16,20,651,33380651
9930,34,1802300,7,9,16,20,685,33380685
9931,133,1802200,1,9,16,20,818,33380818
9932,3,1802200,18,9,16,20,821,33380821
9933,40,1802200,2,9,16,20,861,33380861
9934,10,1802300,1,9,16,20,871,33380871
9935,0,1802300,1,9,16,20,871,33380871
9936,44,1802200,1,9,16,20,915,33380915
9937,447,1802300,1,9,16,21,362,33381362
9938,105,1802200,3,9,16,21,467,33381467
9939,21,1802300,1,9,16,21,488,33381488
9940,102,1802300,1,9,16,21,590,33381590
9941,323,1802300,2,9,16,21,913,33381913
9942,42,1802200,3,9,16,21,955,33381955
9943,191,1802300,1,9,16,22,146,33382146
9944,198,1802200,1,9,16,22,344,33382344
9945,135,1802200,2,9,16,22,479,33382479
9946,119,1802200,3,9,16,22,598,33382598
9947,105,1802300,1,9,16,22,703,33382703
9948,358,1802300,1,9,16,23,61,33383061
9950,5,1802300,1,9,16,23,66,33383066
9951,160,1802200,1,9,16,23,226,33383226
9952,0,1802200,1,9,16,23,226,33383226
9953,11,1802200,3,9,16,23,237,33383237
9954,43,1802200,2,9,16,23,280,33383280
9955,18,1802300,1,9,16,23,298,33383298
9956,26,1802200,2,9,16,23,324,33383324
9957,43,1802200,2,9,16,23,367,33383367
9958,194,1802200,1,9,16,23,561,33383561
9959,29,1802200,1,9,16,23,590,33383590
9960,289,1802100,1,9,16,23,879,33383879
9961,34,1802100,1,9,16,23,913,33383913
9962,320,1802100,1,9,16,24,233,33384233
9963,233,1802200,1,9,16,24,466,33384466
9964,68,1802200,1,9,16,24,534,33384534
9965,80,1802200,1,9,16,24,614,33384614
9966,245,1802100,1,9,16,24,859,33384859
9967,639,1802100,1,9,16,25,498,33385498
9968,86,1802200,1,9,16,25,584,33385584
9969,145,1802200,1,9,16,25,729,33385729
9970,0,1802200,2,9,16,25,729,33385729
9971,1,1802200,1,9,16,25,730,33385730
9972,44,1802300,1,9,16,25,774,33385774
9973,56,1802200,2,9,16,25,830,33385830
9974,16,1802200,2,9,16,25,846,33385846
9975,32,1802200,4,9,16,25,878,33385878
9976,24,1802200,6,9,16,25,902,33385902
9977,13,1802200,6,9,16,25,915,33385915
9978,13,1802200,4,9,16,25,928,33385928
9979,105,1802100,29,9,16,26,33,33386033
9980,103,1802000,45,9,16,26,136,33386136
9981,2,1801900,1,9,16,26,138,33386138
9982,0,1801900,1,9,16,26,138,33386138
9983,0,1801900,1,9,16,26,138,33386138
9984,1,1801900,1,9,16,26,139,33386139
9985,2,1801900,9,9,16,26,141,33386141
9986,90,1801800,1,9,16,26,231,33386231
9987,176,1802000,2,9,16,26,407,33386407
9988,29,1801800,1,9,16,26,436,33386436
9989,67,1802000,1,9,16,26,503,33386503
9990,227,1801800,1,9,16,26,730,33386730
9991,244,1801800,9,9,16,26,974,33386974
9992,3,1801800,1,9,16,26,977,33386977
9993,10,1801900,1,9,16,26,987,33386987
9994,247,1802000,1,9,16,27,234,33387234
9995,75,1802000,1,9,16,27,309,33387309
9996,41,1802000,1,9,16,27,350,33387350
9997,0,1802000,1,9,16,27,350,33387350
9998,0,1802000,1,9,16,27,350,33387350
9999,0,1802000,1,9,16,27,350,33387350
10000,0,1802000,1,9,16,27,350,33387350
10001,0,1802000,1,9,16,27,350,33387350
10002,1,1802000,1,9,16,27,351,33387351
10003,73,1801900,4,9,16,27,424,33387424
10004,279,1802000,2,9,16,27,703,33387703
10005,24,1802100,1,9,16,27,727,33387727
10006,240,1802000,1,9,16,27,967,33387967
10007,837,1802200,1,9,16,28,804,33388804
10008,361,1802200,1,9,16,29,165,33389165
10009,736,1802400,2,9,16,29,901,33389901
10010,181,1802300,4,9,16,30,82,33390082
10011,213,1802200,9,9,16,30,295,33390295
10012,388,1802400,1,9,16,30,683,33390683
10014,840,1802400,1,9,16,31,523,33391523
10015,78,1802300,1,9,16,31,601,33391601
10016,4,1802500,1,9,16,31,605,33391605
10017,5,1802500,1,9,16,31,610,33391610
10018,790,1802300,1,9,16,32,400,33392400
10019,12,1802500,1,9,16,32,412,33392412
10020,614,1802500,2,9,16,33,26,33393026
10021,726,1802300,8,9,16,33,752,33393752
10022,0,1802300,8,9,16,33,752,33393752
10023,0,1802300,8,9,16,33,752,33393752
10025,3,1802000,4,9,16,33,755,33393755
10026,1,1802000,3,9,16,33,756,33393756
10027,0,1802000,1,9,16,33,756,33393756
10028,0,1802000,4,9,16,33,756,33393756
10029,7,1802100,2,9,16,33,763,33393763
10030,31,1802000,1,9,16,33,794,33393794
10031,0,1802000,3,9,16,33,794,33393794
10032,1,1801900,2,9,16,33,795,33393795
10033,98,1802100,1,9,16,33,893,33393893
10034,18,1802100,1,9,16,33,911,33393911
10035,57,1802000,1,9,16,33,968,33393968
10036,0,1802000,1,9,16,33,968,33393968
10037,0,1802000,1,9,16,33,968,33393968
10038,0,1802000,1,9,16,33,968,33393968
10040,5,1802200,1,9,16,33,973,33393973
10041,65,1802300,1,9,16,34,38,33394038
10042,38,1802200,1,9,16,34,76,33394076
10043,1220,1802200,1,9,16,35,296,33395296
10045,32,1802300,1,9,16,35,328,33395328
10046,403,1802300,1,9,16,35,731,33395731
10047,0,1802300,4,9,16,35,731,33395731
10048,0,1802300,3,9,16,35,731,33395731
10049,75,1802300,2,9,16,35,806,33395806
10050,207,1802200,1,9,16,36,13,33396013
10051,0,1802200,2,9,16,36,13,33396013
10052,1274,1802300,1,9,16,37,287,33397287
10053,63,1802300,1,9,16,37,350,33397350
10054,1,1802300,1,9,16,37,351,33397351
10055,103,1802300,1,9,16,37,454,33397454
10056,1172,1802300,1,9,16,38,626,33398626
10057,286,1802200,1,9,16,38,912,33398912
10058,1,1802200,1,9,16,38,913,33398913
10059,266,1802300,3,9,16,39,179,33399179
10060,372,1802200,2,9,16,39,551,33399551
10061,899,1802200,1,9,16,40,450,33400450
10062,175,1802200,1,9,16,40,625,33400625
10063,1,1802100,1,9,16,40,626,33400626
10064,0,1802100,2,9,16,40,626,33400626
10065,598,1802200,1,9,16,41,224,33401224
10066,63,1802100,1,9,16,41,287,33401287
10067,284,1802200,1,9,16,41,571,33401571
10069,422,1802300,1,9,16,41,993,33401993
10070,221,1802200,1,9,16,42,214,33402214
10071,156,1802200,2,9,16,42,370,33402370
10072,228,1802100,1,9,16,42,598,33402598
10073,431,1802100,1,9,16,43,29,33403029
10074,0,1802100,2,9,16,43,29,33403029
10075,1,1802100,1,9,16,43,30,33403030
10076,0,1802100,2,9,16,43,30,33403030
10077,0,1802100,6,9,16,43,30,33403030
10078,0,1802100,1,9,16,43,30,33403030
10079,0,1802100,1,9,16,43,30,33403030
10080,0,1802100,1,9,16,43,30,33403030
10081,0,1802100,1,9,16,43,30,33403030
10082,0,1802100,1,9,16,43,30,33403030
10083,4,1802100,27,9,16,43,34,33403034
10084,923,1802200,1,9,16,43,957,33403957
10085,1448,1802100,2,9,16,45,405,33405405
10086,503,1802100,1,9,16,45,908,33405908
10087,1391,1802000,1,9,16,47,299,33407299
10088,2,1802000,14,9,16,47,301,33407301
10089,78,1802000,1,9,16,47,379,33407379
10090,254,1802000,3,9,16,47,633,33407633
10091,464,1801900,19,9,16,48,97,33408097
10092,1,1801900,5,9,16,48,98,33408098
10093,2,1801900,1,9,16,48,100,33408100
10094,857,1802000,1,9,16,48,957,33408957
10095,326,1801800,1,9,16,49,283,33409283
10096,238,1801900,1,9,16,49,521,33409521
10097,271,1802000,1,9,16,49,792,33409792
10098,105,1801800,4,9,16,49,897,33409897
10099,0,1801800,1,9,16,49,897,33409897
10100,0,1801800,4,9,16,49,897,33409897
10101,0,1801800,1,9,16,49,897,33409897
10102,0,1801800,12,9,16,49,897,33409897
10103,99,1801800,1,9,16,49,996,33409996
10104,192,1801700,5,9,16,50,188,33410188
10105,9,1801800,1,9,16,50,197,33410197
10106,42,1801700,4,9,16,50,239,33410239
10107,40,1801700,1,9,16,50,279,33410279
10108,0,1801700,2,9,16,50,279,33410279
10109,1,1801700,9,9,16,50,280,33410280
10110,0,1801600,2,9,16,50,280,33410280
10111,52,1801600,6,9,16,50,332,33410332
10112,25,1801600,1,9,16,50,357,33410357
10113,17,1801600,2,9,16,50,374,33410374
10114,11,1801600,1,9,16,50,385,33410385
10115,341,1801600,1,9,16,50,726,33410726
10116,25,1801700,3,9,16,50,751,33410751
10117,1,1801600,1,9,16,50,752,33410752
10118,111,1801700,3,9,16,50,863,33410863
10119,46,1801600,1,9,16,50,909,33410909
10120,98,1801700,1,9,16,51,7,33411007
10121,103,1801600,1,9,16,51,110,33411110
10122,174,1801600,1,9,16,51,284,33411284
10123,99,1801600,1,9,16,51,383,33411383
10124,59,1801600,1,9,16,51,442,33411442
10125,1,1801600,1,9,16,51,443,33411443
10126,73,1801700,1,9,16,51,516,33411516
10127,143,1801600,1,9,16,51,659,33411659
10128,95,1801600,1,9,16,51,754,33411754
10129,155,1801600,1,9,16,51,909,33411909
10130,14,1801600,1,9,16,51,923,33411923
10131,52,1801600,1,9,16,51,975,33411975
10132,65,1801600,13,9,16,52,40,33412040
10133,652,1801500,1,9,16,52,692,33412692
10134,39,1801500,1,9,16,52,731,33412731
10135,57,1801500,5,9,16,52,788,33412788
10136,7,1801500,2,9,16,52,795,33412795
10137,623,1801500,1,9,16,53,418,33413418
10138,14,1801500,1,9,16,53,432,33413432
10139,26,1801600,1,9,16,53,458,33413458
10140,0,1801600,3,9,16,53,458,33413458
10141,120,1801600,1,9,16,53,578,33413578
10142,35,1801600,1,9,16,53,613,33413613
10143,50,1801600,1,9,16,53,663,33413663
10145,66,1801600,1,9,16,53,729,33413729
10146,718,1801800,1,9,16,54,447,33414447
10147,211,1801900,1,9,16,54,658,33414658
10148,309,1801800,1,9,16,54,967,33414967
10149,32,1801800,1,9,16,54,999,33414999
10150,295,1801800,1,9,16,55,294,33415294
10151,48,1802000,1,9,16,55,342,33415342
10152,600,1801800,1,9,16,55,942,33415942
10153,197,1801900,1,9,16,56,139,33416139
10154,220,1801900,1,9,16,56,359,33416359
10155,301,1801900,5,9,16,56,660,33416660
10156,0,1801900,5,9,16,56,660,33416660
10158,4,1801800,1,9,16,56,664,33416664
10159,579,1801900,1,9,16,57,243,33417243
10160,398,1801900,1,9,16,57,641,33417641
10161,886,1802000,3,9,16,58,527,33418527
10162,198,1801900,1,9,16,58,725,33418725
10163,552,1801900,1,9,16,59,277,33419277
10164,118,1801900,1,9,16,59,395,33419395
10165,55,1801900,2,9,16,59,450,33419450
10166,114,1802000,1,9,16,59,564,33419564
10167,43,1801900,1,9,16,59,607,33419607
10168,648,1801800,1,9,17,0,255,33420255
10169,153,1801800,6,9,17,0,408,33420408
10170,0,1801800,3,9,17,0,408,33420408
10171,1,1801700,4,9,17,0,409,33420409
10172,20,1801700,1,9,17,0,429,33420429
10173,31,1801600,2,9,17,0,460,33420460
10174,238,1801800,6,9,17,0,698,33420698
10176,174,1801700,5,9,17,0,872,33420872
10177,461,1801800,2,9,17,1,333,33421333
10178,403,1801800,1,9,17,1,736,33421736
10179,12,1801900,1,9,17,1,748,33421748
10180,22,1801900,1,9,17,1,770,33421770
10181,288,1801800,1,9,17,2,58,33422058
10182,111,1801800,1,9,17,2,169,33422169
10183,81,1801800,1,9,17,2,250,33422250
10184,36,1801800,1,9,17,2,286,33422286
10185,365,1801800,2,9,17,2,651,33422651
10186,1,1801800,1,9,17,2,652,33422652
10187,466,1801900,1,9,17,3,118,33423118
10188,162,1801800,2,9,17,3,280,33423280
10189,212,1801800,1,9,17,3,492,33423492
10190,660,1802000,1,9,17,4,152,33424152
10191,565,1802000,1,9,17,4,717,33424717
10192,117,1801800,1,9,17,4,834,33424834
10193,1985,1801900,4,9,17,6,819,33426819
10194,15,1801800,1,9,17,6,834,33426834
10195,26,1801900,2,9,17,6,860,33426860
10196,1947,1801800,4,9,17,8,807,33428807
10197,1,1801800,1,9,17,8,808,33428808
10198,824,1801800,1,9,17,9,632,33429632
10199,0,1801800,4,9,17,9,632,33429632
10200,310,1801700,1,9,17,9,942,33429942
10201,0,1801700,1,9,17,9,942,33429942
10202,0,1801700,1,9,17,9,942,33429942
10203,0,1801700,2,9,17,9,942,33429942
10204,515,1801700,1,9,17,10,457,33430457
10205,775,1801600,1,9,17,11,232,33431232
10206,467,1801600,1,9,17,11,699,33431699
10207,946,1801600,5,9,17,12,645,33432645
10208,191,1801700,1,9,17,12,836,33432836
10209,386,1801700,1,9,17,13,222,33433222
10210,12,1801600,1,9,17,13,234,33433234
10211,0,1801600,3,9,17,13,234,33433234
10212,515,1801700,10,9,17,13,749,33433749
10213,390,1801700,1,9,17,14,139,33434139
10214,2900,1801800,4,9,17,17,39,33437039
10216,895,1801900,2,9,17,17,934,33437934
10218,693,1801800,1,9,17,18,627,33438627
10219,98,1801900,1,9,17,18,725,33438725
10220,1,1801900,1,9,17,18,726,33438726
10221,0,1801900,1,9,17,18,726,33438726
10222,0,1801900,1,9,17,18,726,33438726
10223,0,1802000,1,9,17,18,726,33438726
10224,1,1802000,1,9,17,18,727,33438727
10225,139,1801800,1,9,17,18,866,33438866
10226,197,1802000,1,9,17,19,63,33439063
10228,1099,1802100,6,9,17,20,162,33440162
10230,66,1802200,1,9,17,20,228,33440228
10231,5,1802200,1,9,17,20,233,33440233
10232,197,1801900,3,9,17,20,430,33440430
10233,194,1801900,1,9,17,20,624,33440624
10234,27,1802100,1,9,17,20,651,33440651
10235,70,1801900,1,9,17,20,721,33440721
10236,812,1802000,1,9,17,21,533,33441533
10237,138,1801900,1,9,17,21,671,33441671
10238,499,1802000,1,9,17,22,170,33442170
10239,221,1801900,1,9,17,22,391,33442391
10240,171,1802000,1,9,17,22,562,33442562
10241,1085,1801900,1,9,17,23,647,33443647
10242,30,1801800,1,9,17,23,677,33443677
10243,134,1802000,1,9,17,23,811,33443811
10244,314,1802000,2,9,17,24,125,33444125
10245,446,1802000,2,9,17,24,571,33444571
10246,652,1802000,1,9,17,25,223,33445223
10247,70,1802000,2,9,17,25,293,33445293
10248,2712,1802000,1,9,17,28,5,33448005
10249,207,1802000,5,9,17,28,212,33448212
10250,387,1802100,1,9,17,28,599,33448599
10251,1241,1802000,1,9,17,29,840,33449840
10252,10,1802200,1,9,17,29,850,33449850
10253,0,1802200,1,9,17,29,850,33449850
10254,248,1802200,1,9,17,30,98,33450098
10255,1582,1802200,1,9,17,31,680,33451680
10256,99,1802100,3,9,17,31,779,33451779
10257,247,1802200,1,9,17,32,26,33452026
10258,238,1802100,7,9,17,32,264,33452264
10259,71,1802000,2,9,17,32,335,33452335
10260,177,1801900,5,9,17,32,512,33452512
10261,154,1801900,1,9,17,32,666,33452666
10262,987,1801900,4,9,17,33,653,33453653
10263,1453,1802000,1,9,17,35,106,33455106
10264,293,1801900,1,9,17,35,399,33455399
10265,2287,1801800,1,9,17,37,686,33457686
10266,775,1801900,2,9,17,38,461,33458461
10267,15,1802000,1,9,17,38,476,33458476
10268,133,1801900,1,9,17,38,609,33458609
10269,386,1802000,3,9,17,38,995,33458995
10270,1130,1802000,1,9,17,40,125,33460125
10271,115,1802000,1,9,17,40,240,33460240
10272,173,1802000,1,9,17,40,413,33460413
10273,110,1801800,1,9,17,40,523,33460523
10274,881,1801800,7,9,17,41,404,33461404
10275,46,1801700,4,9,17,41,450,33461450
10276,24,1801600,18,9,17,41,474,33461474
10277,45,1801500,7,9,17,41,519,33461519
10278,0,1801500,1,9,17,41,519,33461519
10279,289,1801500,1,9,17,41,808,33461808
10280,149,1801400,5,9,17,41,957,33461957
10281,1,1801400,11,9,17,41,958,33461958
10282,97,1801400,1,9,17,42,55,33462055
10283,257,1801500,1,9,17,42,312,33462312
10284,5,1801400,1,9,17,42,317,33462317
10285,193,1801400,1,9,17,42,510,33462510
10286,86,1801300,9,9,17,42,596,33462596
10287,9,1801200,1,9,17,42,605,33462605
10288,4,1801200,1,9,17,42,609,33462609
10289,28,1801200,1,9,17,42,637,33462637
10290,75,1801200,2,9,17,42,712,33462712
10291,72,1801200,2,9,17,42,784,33462784
10292,306,1801200,2,9,17,43,90,33463090
10293,54,1801400,2,9,17,43,144,33463144
10294,48,1801200,3,9,17,43,192,33463192
10295,645,1801400,6,9,17,43,837,33463837
10296,0,1801400,6,9,17,43,837,33463837
10298,1803,1801300,2,9,17,45,640,33465640
10299,70,1801400,3,9,17,45,710,33465710
10300,0,1801400,3,9,17,45,710,33465710
10302,1,1801500,2,9,17,45,711,33465711
10303,82,1801500,1,9,17,45,793,33465793
10304,228,1801500,1,9,17,46,21,33466021
10305,231,1801600,1,9,17,46,252,33466252
10306,344,1801400,1,9,17,46,596,33466596
10307,899,1801600,1,9,17,47,495,33467495
10308,106,1801600,1,9,17,47,601,33467601
10309,0,1801600,1,9,17,47,601,33467601
10310,308,1801400,1,9,17,47,909,33467909
10311,37,1801400,1,9,17,47,946,33467946
10312,585,1801400,1,9,17,48,531,33468531
10313,352,1801400,1,9,17,48,883,33468883
10314,316,1801300,3,9,17,49,199,33469199
10315,0,1801300,1,9,17,49,199,33469199
10316,235,1801200,1,9,17,49,434,33469434
10317,294,1801200,1,9,17,49,728,33469728
10318,17,1801300,1,9,17,49,745,33469745
10319,486,1801200,2,9,17,50,231,33470231
10320,0,1801200,1,9,17,50,231,33470231
10321,1,1801100,14,9,17,50,232,33470232
10322,281,1801000,2,9,17,50,513,33470513
10323,8,1801000,5,9,17,50,521,33470521
10324,0,1801000,3,9,17,50,521,33470521
10325,1,1801000,1,9,17,50,522,33470522
10326,0,1801000,4,9,17,50,522,33470522
10327,0,1801000,4,9,17,50,522,33470522
10328,84,1800900,1,9,17,50,606,33470606
10329,1,1800900,3,9,17,50,607,33470607
10330,4,1800900,1,9,17,50,611,33470611
10331,89,1800900,1,9,17,50,700,33470700
10332,0,1800900,1,9,17,50,700,33470700
10333,105,1800900,1,9,17,50,805,33470805
10334,26,1800900,1,9,17,50,831,33470831
10335,0,1800900,5,9,17,50,831,33470831
10336,28,1800800,1,9,17,50,859,33470859
10337,335,1800800,1,9,17,51,194,33471194
10338,51,1800900,2,9,17,51,245,33471245
10339,267,1800800,1,9,17,51,512,33471512
10340,169,1800900,1,9,17,51,681,33471681
10341,0,1800900,1,9,17,51,681,33471681
10342,1,1801000,2,9,17,51,682,33471682
10343,2,1801100,1,9,17,51,684,33471684
10344,0,1801100,1,9,17,51,684,33471684
10345,1,1801100,1,9,17,51,685,33471685
10346,0,1801100,1,9,17,51,685,33471685
10347,65,1801200,3,9,17,51,750,33471750
10348,47,1801300,3,9,17,51,797,33471797
10349,45,1801400,1,9,17,51,842,33471842
10350,0,1801400,3,9,17,51,842,33471842
10351,1,1801500,5,9,17,51,843,33471843
10352,0,1801400,1,9,17,51,843,33471843
10353,2,1801500,1,9,17,51,845,33471845
10354,6,1801500,1,9,17,51,851,33471851
10355,25,1801500,1,9,17,51,876,33471876
10356,38,1801500,1,9,17,51,914,33471914
10357,39,1801400,3,9,17,51,953,33471953
10358,222,1801400,1,9,17,52,175,33472175
10359,330,1801500,13,9,17,52,505,33472505
10360,1,1801500,5,9,17,52,506,33472506
10361,0,1801500,5,9,17,52,506,33472506
10362,0,1801500,9,9,17,52,506,33472506
10363,0,1801500,1,9,17,52,506,33472506
10364,72,1801600,2,9,17,52,578,33472578
10365,846,1801600,4,9,17,53,424,33473424
10366,898,1801400,1,9,17,54,322,33474322
10367,423,1801400,1,9,17,54,745,33474745
10368,84,1801500,2,9,17,54,829,33474829
10369,167,1801300,1,9,17,54,996,33474996
10370,215,1801300,3,9,17,55,211,33475211
10372,723,1801100,1,9,17,55,934,33475934
10373,349,1801300,2,9,17,56,283,33476283
10374,113,1801100,4,9,17,56,396,33476396
10376,216,1801200,2,9,17,56,612,33476612
10377,165,1801000,1,9,17,56,777,33476777
10378,254,1801000,1,9,17,57,31,33477031
10379,11,1801100,3,9,17,57,42,33477042
10380,55,1801100,1,9,17,57,97,33477097
10381,1120,1801000,2,9,17,58,217,33478217
10383,3,1801100,1,9,17,58,220,33478220
10384,685,1801100,1,9,17,58,905,33478905
10385,34,1801100,1,9,17,58,939,33478939
10386,71,1801100,1,9,17,59,10,33479010
10387,134,1801200,1,9,17,59,144,33479144
10388,491,1801100,1,9,17,59,635,33479635
10389,306,1801100,1,9,17,59,941,33479941
10390,52,1801200,1,9,17,59,993,33479993
10391,437,1801200,1,9,18,0,430,33480430
10392,301,1801100,1,9,18,0,731,33480731
10393,55,1801200,1,9,18,0,786,33480786
10394,100,1801100,2,9,18,0,886,33480886
10395,8,1801200,1,9,18,0,894,33480894
10396,157,1801100,1,9,18,1,51,33481051
10397,358,1801100,1,9,18,1,409,33481409
10399,109,1801200,1,9,18,1,518,33481518
10400,349,1801100,1,9,18,1,867,33481867
10401,42,1801000,1,9,18,1,909,33481909
10402,790,1801100,1,9,18,2,699,33482699
10403,486,1801100,5,9,18,3,185,33483185
10404,440,1801000,1,9,18,3,625,33483625
10405,390,1801100,1,9,18,4,15,33484015
10406,442,1801100,2,9,18,4,457,33484457
10408,84,1801000,1,9,18,4,541,33484541
10409,159,1801100,1,9,18,4,700,33484700
10410,891,1801000,1,9,18,5,591,33485591
10411,717,1801200,7,9,18,6,308,33486308
10412,72,1801200,2,9,18,6,380,33486380
10413,48,1801100,2,9,18,6,428,33486428
10414,498,1801200,1,9,18,6,926,33486926
10415,91,1801100,1,9,18,7,17,33487017
10416,60,1801100,1,9,18,7,77,33487077
10417,33,1801200,3,9,18,7,110,33487110
10418,490,1801200,1,9,18,7,600,33487600
10419,138,1801000,1,9,18,7,738,33487738
10420,1598,1801100,1,9,18,9,336,33489336
10421,14,1801100,1,9,18,9,350,33489350
10422,115,1801200,3,9,18,9,465,33489465
10423,142,1801100,1,9,18,9,607,33489607
10424,1029,1801200,1,9,18,10,636,33490636
10425,84,1801200,1,9,18,10,720,33490720
10426,1249,1801200,1,9,18,11,969,33491969
10427,466,1801100,1,9,18,12,435,33492435
10428,912,1801200,1,9,18,13,347,33493347
10429,722,1801200,1,9,18,14,69,33494069
10430,123,1801200,1,9,18,14,192,33494192
10431,1057,1801100,1,9,18,15,249,33495249
10432,21,1801100,10,9,18,15,270,33495270
10433,173,1801100,1,9,18,15,443,33495443
10434,1,1801000,3,9,18,15,444,33495444
10435,0,1801000,4,9,18,15,444,33495444
10436,734,1801100,1,9,18,16,178,33496178
10437,72,1801100,1,9,18,16,250,33496250
10438,281,1801000,30,9,18,16,531,33496531
10439,1,1801000,1,9,18,16,532,33496532
10440,0,1801000,1,9,18,16,532,33496532
10441,0,1801000,1,9,18,16,532,33496532
10442,1,1801000,1,9,18,16,533,33496533
10443,0,1801000,1,9,18,16,533,33496533
10444,40,1800900,1,9,18,16,573,33496573
10445,0,1800900,1,9,18,16,573,33496573
10446,0,1800900,1,9,18,16,573,33496573
10447,0,1800900,1,9,18,16,573,33496573
10448,0,1800900,2,9,18,16,573,33496573
10449,684,1800900,7,9,18,17,257,33497257
10450,1,1800800,5,9,18,17,258,33497258
10451,1,1800800,4,9,18,17,259,33497259
10452,0,1800800,1,9,18,17,259,33497259
10453,0,1800800,1,9,18,17,259,33497259
10454,0,1800800,4,9,18,17,259,33497259
10455,0,1800800,1,9,18,17,259,33497259
10456,0,1800800,1,9,18,17,259,33497259
10457,0,1800800,1,9,18,17,259,33497259
10458,0,1800800,1,9,18,17,259,33497259
10459,0,1800800,2,9,18,17,259,33497259
10460,0,1800800,21,9,18,17,259,33497259
10461,4,1800800,1,9,18,17,263,33497263
10462,151,1800900,1,9,18,17,414,33497414
10463,131,1800800,1,9,18,17,545,33497545
10464,103,1800900,1,9,18,17,648,33497648
10465,409,1800900,1,9,18,18,57,33498057
10466,263,1800800,1,9,18,18,320,33498320
10467,397,1800900,1,9,18,18,717,33498717
10468,214,1800900,2,9,18,18,931,33498931
10470,71,1800900,2,9,18,19,2,33499002
10471,348,1801000,1,9,18,19,350,33499350
10472,300,1801100,1,9,18,19,650,33499650
10473,0,1801100,1,9,18,19,650,33499650
10474,548,1801100,2,9,18,20,198,33500198
10475,383,1801000,1,9,18,20,581,33500581
10476,883,1801000,1,9,18,21,464,33501464
10477,123,1800900,1,9,18,21,587,33501587
10478,694,1801100,2,9,18,22,281,33502281
10479,893,1801000,1,9,18,23,174,33503174
10480,0,1800900,1,9,18,23,174,33503174
10481,0,1800900,1,9,18,23,174,33503174
10482,1511,1801000,1,9,18,24,685,33504685
10483,598,1801000,1,9,18,25,283,33505283
10484,327,1801000,1,9,18,25,610,33505610
10485,898,1801000,1,9,18,26,508,33506508
10486,160,1801100,2,9,18,26,668,33506668
10487,0,1801100,3,9,18,26,668,33506668
10488,803,1801000,1,9,18,27,471,33507471
10489,1222,1801200,5,9,18,28,693,33508693
10490,0,1801200,3,9,18,28,693,33508693
10491,0,1801200,2,9,18,28,693,33508693
10492,3,1801200,5,9,18,28,696,33508696
10493,114,1801200,1,9,18,28,810,33508810
10494,620,1801300,1,9,18,29,430,33509430
10495,433,1801300,8,9,18,29,863,33509863
10496,181,1801300,1,9,18,30,44,33510044
10497,1115,1801300,1,9,18,31,159,33511159
10498,887,1801300,1,9,18,32,46,33512046
10499,922,1801300,1,9,18,32,968,33512968
10500,164,1801200,1,9,18,33,132,33513132
10501,1018,1801400,1,9,18,34,150,33514150
10502,78,1801400,1,9,18,34,228,33514228
10503,11,1801400,1,9,18,34,239,33514239
10504,599,1801400,1,9,18,34,838,33514838
10505,43,1801300,1,9,18,34,881,33514881
10506,82,1801400,1,9,18,34,963,33514963
10507,110,1801400,8,9,18,35,73,33515073
10508,1,1801400,1,9,18,35,74,33515074
10509,597,1801500,3,9,18,35,671,33515671
10510,4,1801500,22,9,18,35,675,33515675
10511,42,1801600,6,9,18,35,717,33515717
10512,188,1801500,1,9,18,35,905,33515905
10513,78,1801600,1,9,18,35,983,33515983
10514,766,1801600,1,9,18,36,749,33516749
10515,284,1801600,1,9,18,37,33,33517033
10516,125,1801600,1,9,18,37,158,33517158
10517,94,1801600,1,9,18,37,252,33517252
10518,395,1801600,1,9,18,37,647,33517647
10519,931,1801700,5,9,18,38,578,33518578
10520,265,1801700,2,9,18,38,843,33518843
10521,1119,1801800,1,9,18,39,962,33519962
10522,61,1801700,1,9,18,40,23,33520023
10523,1,1801700,4,9,18,40,24,33520024
10524,197,1801600,1,9,18,40,221,33520221
10525,43,1801700,1,9,18,40,264,33520264
10526,149,1801600,1,9,18,40,413,33520413
10527,17,1801700,5,9,18,40,430,33520430
10528,854,1801600,6,9,18,41,284,33521284
10529,0,1801600,6,9,18,41,284,33521284
10530,0,1801600,6,9,18,41,284,33521284
10531,0,1801600,6,9,18,41,284,33521284
10533,5,1801200,1,9,18,41,289,33521289
10534,2,1801200,4,9,18,41,291,33521291
10535,0,1801200,1,9,18,41,291,33521291
10536,5,1801200,2,9,18,41,296,33521296
10537,29,1801200,1,9,18,41,325,33521325
10538,1,1801200,1,9,18,41,326,33521326
10539,3,1801200,1,9,18,41,329,33521329
10540,24,1801200,1,9,18,41,353,33521353
10541,1,1801100,3,9,18,41,354,33521354
10542,9,1801100,1,9,18,41,363,33521363
10543,4,1801200,1,9,18,41,367,33521367
10544,40,1801100,1,9,18,41,407,33521407
10545,4,1801200,1,9,18,41,411,33521411
10546,209,1801300,1,9,18,41,620,33521620
10547,305,1801200,1,9,18,41,925,33521925
10548,57,1801200,1,9,18,41,982,33521982
10549,110,1801200,1,9,18,42,92,33522092
10550,163,1801200,1,9,18,42,255,33522255
10551,438,1801100,2,9,18,42,693,33522693
10552,1473,1801000,1,9,18,44,166,33524166
10553,1,1801000,4,9,18,44,167,33524167
10554,34,1801000,16,9,18,44,201,33524201
10555,107,1800900,1,9,18,44,308,33524308
10556,0,1800900,9,9,18,44,308,33524308
10557,0,1800900,1,9,18,44,308,33524308
10558,0,1800900,1,9,18,44,308,33524308
10559,0,1800900,6,9,18,44,308,33524308
10560,0,1800900,1,9,18,44,308,33524308
10561,67,1800900,1,9,18,44,375,33524375
10562,59,1800800,8,9,18,44,434,33524434
10563,347,1800800,2,9,18,44,781,33524781
10564,295,1800900,2,9,18,45,76,33525076
10565,31,1800900,10,9,18,45,107,33525107
10566,412,1800900,1,9,18,45,519,33525519
10567,11,1800800,1,9,18,45,530,33525530
10568,2319,1800800,1,9,18,47,849,33527849
10569,92,1800900,1,9,18,47,941,33527941
10570,372,1800900,5,9,18,48,313,33528313
10571,1311,1800900,2,9,18,49,624,33529624
10572,573,1800900,2,9,18,50,197,33530197
10573,523,1800900,2,9,18,50,720,33530720
10574,72,1800900,1,9,18,50,792,33530792
10575,279,1801000,2,9,18,51,71,33531071
10576,562,1800900,1,9,18,51,633,33531633
10577,153,1800900,1,9,18,51,786,33531786
10578,388,1801100,1,9,18,52,174,33532174
10579,578,1800900,1,9,18,52,752,33532752
10580,1275,1801100,6,9,18,54,27,33534027
10581,139,1801200,1,9,18,54,166,33534166
10582,1416,1801000,2,9,18,55,582,33535582
10583,292,1801000,1,9,18,55,874,33535874
10584,2601,1801000,1,9,18,58,475,33538475
10585,47,1801100,1,9,18,58,522,33538522
10586,202,1800900,1,9,18,58,724,33538724
10587,0,1800900,2,9,18,58,724,33538724
10588,0,1800900,2,9,18,58,724,33538724
10589,0,1800900,1,9,18,58,724,33538724
10590,1411,1800900,1,9,19,0,135,33540135
10591,1,1801000,1,9,19,0,136,33540136
10592,261,1801000,2,9,19,0,397,33540397
10593,29,1801000,2,9,19,0,426,33540426
10594,541,1800900,1,9,19,0,967,33540967
10595,944,1801000,2,9,19,1,911,33541911
10596,37,1800900,3,9,19,1,948,33541948
10597,895,1800900,1,9,19,2,843,33542843
10598,183,1800800,3,9,19,3,26,33543026
10599,174,1800800,1,9,19,3,200,33543200
10600,36,1800900,1,9,19,3,236,33543236
10601,51,1800800,3,9,19,3,287,33543287
10602,325,1800900,2,9,19,3,612,33543612
10603,0,1800800,4,9,19,3,612,33543612
10604,17,1800900,1,9,19,3,629,33543629
10605,53,1800900,2,9,19,3,682,33543682
10606,149,1800900,1,9,19,3,831,33543831
10607,774,1800900,1,9,19,4,605,33544605
10608,133,1801000,1,9,19,4,738,33544738
10609,75,1800900,1,9,19,4,813,33544813
10610,1351,1801000,3,9,19,6,164,33546164
10611,37,1801000,1,9,19,6,201,33546201
10612,3658,1801000,1,9,19,9,859,33549859
10613,148,1801000,2,9,19,10,7,33550007
10614,177,1801100,1,9,19,10,184,33550184
10615,288,1801000,1,9,19,10,472,33550472
10616,485,1800900,12,9,19,10,957,33550957
10617,2,1800900,1,9,19,10,959,33550959
10618,0,1800900,1,9,19,10,959,33550959
10619,84,1800800,1,9,19,11,43,33551043
10620,355,1800800,6,9,19,11,398,33551398
10621,0,1800700,19,9,19,11,398,33551398
10622,81,1800600,1,9,19,11,479,33551479
10623,6,1800600,1,9,19,11,485,33551485
10624,0,1800600,1,9,19,11,485,33551485
10625,24,1800600,2,9,19,11,509,33551509
10626,1,1800600,2,9,19,11,510,33551510
10627,4,1800600,2,9,19,11,514,33551514
10628,1,1800600,9,9,19,11,515,33551515
10629,2,1800500,1,9,19,11,517,33551517
10630,0,1800500,1,9,19,11,517,33551517
10631,0,1800500,1,9,19,11,517,33551517
10632,0,1800500,11,9,19,11,517,33551517
10633,3,1800400,2,9,19,11,520,33551520
10634,1,1800400,1,9,19,11,521,33551521
10635,12,1800400,1,9,19,11,533,33551533
10636,8,1800400,1,9,19,11,541,33551541
10637,17,1800500,1,9,19,11,558,33551558
10638,46,1800400,1,9,19,11,604,33551604
10639,0,1800400,1,9,19,11,604,33551604
10640,10,1800400,1,9,19,11,614,33551614
10641,4,1800400,1,9,19,11,618,33551618
10642,17,1800500,1,9,19,11,635,33551635
10643,12,1800400,4,9,19,11,647,33551647
10644,3,1800400,1,9,19,11,650,33551650
10645,28,1800400,4,9,19,11,678,33551678
10646,18,1800500,1,9,19,11,696,33551696
10647,14,1800300,5,9,19,11,710,33551710
10648,34,1800300,1,9,19,11,744,33551744
10649,29,1800300,1,9,19,11,773,33551773
10650,46,1800300,6,9,19,11,819,33551819
10652,23,1800200,2,9,19,11,842,33551842
10653,22,1800400,1,9,19,11,864,33551864
10654,3,1800400,1,9,19,11,867,33551867
10655,0,1800300,1,9,19,11,867,33551867
10656,3,1800300,1,9,19,11,870,33551870
10657,12,1800500,1,9,19,11,882,33551882
10658,21,1800300,1,9,19,11,903,33551903
10659,22,1800500,1,9,19,11,925,33551925
10660,18,1800500,2,9,19,11,943,33551943
10661,3,1800300,1,9,19,11,946,33551946
10662,45,1800500,1,9,19,11,991,33551991
10663,8,1800400,1,9,19,11,999,33551999
10664,591,1800500,1,9,19,12,590,33552590
10665,161,1800400,3,9,19,12,751,33552751
10666,464,1800600,1,9,19,13,215,33553215
10667,29,1800600,1,9,19,13,244,33553244
10668,142,1800600,1,9,19,13,386,33553386
10669,344,1800500,1,9,19,13,730,33553730
10670,224,1800600,1,9,19,13,954,33553954
10671,200,1800600,1,9,19,14,154,33554154
10672,0,1800500,1,9,19,14,154,33554154
10674,92,1800500,1,9,19,14,246,33554246
10675,126,1800600,1,9,19,14,372,33554372
10676,38,1800500,1,9,19,14,410,33554410
10677,117,1800400,2,9,19,14,527,33554527
10678,721,1800400,1,9,19,15,248,33555248
10679,133,1800500,1,9,19,15,381,33555381
10681,125,1800500,1,9,19,15,506,33555506
10682,949,1800500,1,9,19,16,455,33556455
10683,0,1800500,1,9,19,16,455,33556455
10684,0,1800500,2,9,19,16,455,33556455
10685,154,1800500,1,9,19,16,609,33556609
10686,39,1800600,1,9,19,16,648,33556648
10687,119,1800500,1,9,19,16,767,33556767
10688,709,1800400,2,9,19,17,476,33557476
10689,176,1800400,1,9,19,17,652,33557652
10690,131,1800500,1,9,19,17,783,33557783
10691,365,1800400,1,9,19,18,148,33558148
10692,747,1800400,3,9,19,18,895,33558895
10693,497,1800300,1,9,19,19,392,33559392
10694,145,1800200,3,9,19,19,537,33559537
10695,27,1800300,4,9,19,19,564,33559564
10697,106,1800300,2,9,19,19,670,33559670
10699,43,1800200,1,9,19,19,713,33559713
10700,599,1800300,1,9,19,20,312,33560312
10701,273,1800300,1,9,19,20,585,33560585
10702,198,1800300,1,9,19,20,783,33560783
10703,132,1800300,1,9,19,20,915,33560915
10704,43,1800300,1,9,19,20,958,33560958
10705,65,1800200,3,9,19,21,23,33561023
10706,238,1800300,1,9,19,21,261,33561261
10707,48,1800200,1,9,19,21,309,33561309
10708,160,1800300,1,9,19,21,469,33561469
10709,64,1800200,1,9,19,21,533,33561533
10710,99,1800200,1,9,19,21,632,33561632
10711,35,1800200,1,9,19,21,667,33561667
10712,115,1800200,1,9,19,21,782,33561782
10713,5,1800200,1,9,19,21,787,33561787
10714,102,1800200,3,9,19,21,889,33561889
10715,33,1800200,2,9,19,21,922,33561922
10716,170,1800200,1,9,19,22,92,33562092
10717,254,1800200,6,9,19,22,346,33562346
10718,0,1800200,1,9,19,22,346,33562346
10719,35,1800200,2,9,19,22,381,33562381
10720,284,1800100,1,9,19,22,665,33562665
10721,120,1800200,1,9,19,22,785,33562785
10723,0,1800300,1,9,19,22,785,33562785
10724,17,1800100,16,9,19,22,802,33562802
10726,72,1800000,2,9,19,22,874,33562874
10727,4,1800000,1,9,19,22,878,33562878
10728,8,1800000,2,9,19,22,886,33562886
10729,13,1800000,1,9,19,22,899,33562899
10730,6,1800000,1,9,19,22,905,33562905
10731,4,1800000,1,9,19,22,909,33562909
10732,10,1800000,1,9,19,22,919,33562919
10733,4,1800000,1,9,19,22,923,33562923
10734,0,1800000,1,9,19,22,923,33562923
10735,32,1799900,2,9,19,22,955,33562955
10736,1,1799900,1,9,19,22,956,33562956
10737,0,1799900,1,9,19,22,956,33562956
10738,1,1799800,2,9,19,22,957,33562957
10739,0,1799800,5,9,19,22,957,33562957
10740,1,1799800,1,9,19,22,958,33562958
10741,0,1799800,1,9,19,22,958,33562958
10742,0,1799800,4,9,19,22,958,33562958
10743,32,1799700,1,9,19,22,990,33562990
10744,6,1799700,1,9,19,22,996,33562996
10745,8,1799700,1,9,19,23,4,33563004
10746,44,1799800,1,9,19,23,48,33563048
10747,0,1799800,2,9,19,23,48,33563048
10748,3,1799800,1,9,19,23,51,33563051
10749,0,1799800,1,9,19,23,51,33563051
10751,52,1799800,1,9,19,23,103,33563103
10752,11,1799700,1,9,19,23,114,33563114
10753,35,1799700,2,9,19,23,149,33563149
10754,3,1799800,1,9,19,23,152,33563152
10755,23,1799700,1,9,19,23,175,33563175
10756,99,1799900,3,9,19,23,274,33563274
10757,53,1799800,2,9,19,23,327,33563327
10758,98,1799800,1,9,19,23,425,33563425
10759,463,1799800,2,9,19,23,888,33563888
10760,32,1799800,1,9,19,23,920,33563920
10762,199,1799700,2,9,19,24,119,33564119
10763,58,1799700,1,9,19,24,177,33564177
10765,69,1799600,4,9,19,24,246,33564246
10766,0,1799600,8,9,19,24,246,33564246
10767,5,1799500,1,9,19,24,251,33564251
10768,22,1799600,1,9,19,24,273,33564273
10769,78,1799600,3,9,19,24,351,33564351
10770,5,1799500,1,9,19,24,356,33564356
10771,51,1799600,1,9,19,24,407,33564407
10773,12,1799500,2,9,19,24,419,33564419
10774,47,1799700,1,9,19,24,466,33564466
10775,4,1799500,1,9,19,24,470,33564470
10776,20,1799500,1,9,19,24,490,33564490
10777,71,1799600,1,9,19,24,561,33564561
10778,66,1799500,1,9,19,24,627,33564627
10779,7,1799600,1,9,19,24,634,33564634
10780,29,1799600,1,9,19,24,663,33564663
10781,101,1799600,3,9,19,24,764,33564764
10782,132,1799500,5,9,19,24,896,33564896
10783,36,1799600,1,9,19,24,932,33564932
10784,32,1799600,1,9,19,24,964,33564964
10785,51,1799700,1,9,19,25,15,33565015
10786,22,1799600,1,9,19,25,37,33565037
10787,138,1799600,3,9,19,25,175,33565175
10789,130,1799600,1,9,19,25,305,33565305
10790,129,1799600,4,9,19,25,434,33565434
10791,37,1799500,1,9,19,25,471,33565471
10792,53,1799500,1,9,19,25,524,33565524
10793,184,1799700,1,9,19,25,708,33565708
10794,124,1799500,1,9,19,25,832,33565832
10795,92,1799700,2,9,19,25,924,33565924
10796,90,1799600,1,9,19,26,14,33566014
10797,148,1799500,1,9,19,26,162,33566162
10798,189,1799600,1,9,19,26,351,33566351
10799,370,1799500,1,9,19,26,721,33566721
10800,148,1799700,4,9,19,26,869,33566869
10801,21,1799600,2,9,19,26,890,33566890
10802,8,1799800,1,9,19,26,898,33566898
10803,252,1799800,2,9,19,27,150,33567150
10804,51,1799700,1,9,19,27,201,33567201
10805,166,1799900,1,9,19,27,367,33567367
10806,2,1799700,3,9,19,27,369,33567369
10807,201,1799700,1,9,19,27,570,33567570
10808,2,1799900,1,9,19,27,572,33567572
10809,172,1799800,1,9,19,27,744,33567744
10810,70,1799800,1,9,19,27,814,33567814
10811,195,1799800,1,9,19,28,9,33568009
10812,304,1799900,1,9,19,28,313,33568313
10813,568,1799900,1,9,19,28,881,33568881
10814,55,1799900,11,9,19,28,936,33568936
10815,73,1799900,2,9,19,29,9,33569009
10816,89,1799900,2,9,19,29,98,33569098
10817,3,1800100,1,9,19,29,101,33569101
10818,90,1800100,2,9,19,29,191,33569191
10819,143,1800000,11,9,19,29,334,33569334
10821,914,1800200,1,9,19,30,248,33570248
10822,251,1800100,1,9,19,30,499,33570499
10823,208,1800200,3,9,19,30,707,33570707
10825,304,1800300,1,9,19,31,11,33571011
10826,20,1800300,1,9,19,31,31,33571031
10827,13,1800400,1,9,19,31,44,33571044
10828,19,1800400,1,9,19,31,63,33571063
10829,41,1800500,1,9,19,31,104,33571104
10830,145,1800500,2,9,19,31,249,33571249
10831,168,1800300,1,9,19,31,417,33571417
10832,256,1800500,10,9,19,31,673,33571673
10833,494,1800500,4,9,19,32,167,33572167
10834,594,1800600,2,9,19,32,761,33572761
10835,0,1800600,2,9,19,32,761,33572761
10837,19,1800600,1,9,19,32,780,33572780
10838,147,1800700,1,9,19,32,927,33572927
10840,92,1800800,1,9,19,33,19,33573019
10841,138,1800800,1,9,19,33,157,33573157
10842,11,1800800,1,9,19,33,168,33573168
10843,1,1800600,1,9,19,33,169,33573169
10844,11,1800700,1,9,19,33,180,33573180
10845,219,1800600,1,9,19,33,399,33573399
10846,0,1800600,1,9,19,33,399,33573399
10847,1,1800500,1,9,19,33,400,33573400
10848,149,1800600,1,9,19,33,549,33573549
10849,165,1800700,3,9,19,33,714,33573714
10850,215,1800600,1,9,19,33,929,33573929
10851,223,1800700,1,9,19,34,152,33574152
10852,23,1800500,5,9,19,34,175,33574175
10853,326,1800700,4,9,19,34,501,33574501
10854,300,1800500,3,9,19,34,801,33574801
10855,496,1800400,1,9,19,35,297,33575297
10856,206,1800500,3,9,19,35,503,33575503
10857,136,1800600,1,9,19,35,639,33575639
10858,67,1800500,1,9,19,35,706,33575706
10859,343,1800400,1,9,19,36,49,33576049
10860,0,1800400,1,9,19,36,49,33576049
10861,452,1800500,2,9,19,36,501,33576501
10862,233,1800500,1,9,19,36,734,33576734
10863,475,1800500,4,9,19,37,209,33577209
10865,292,1800600,1,9,19,37,501,33577501
10866,125,1800400,4,9,19,37,626,33577626
10868,767,1800300,1,9,19,38,393,33578393
10869,391,1800300,2,9,19,38,784,33578784
10870,36,1800300,2,9,19,38,820,33578820
10871,559,1800400,4,9,19,39,379,33579379
10872,0,1800400,4,9,19,39,379,33579379
10874,45,1800400,2,9,19,39,424,33579424
10875,865,1800500,1,9,19,40,289,33580289
10876,90,1800400,1,9,19,40,379,33580379
10877,159,1800400,1,9,19,40,538,33580538
10878,226,1800400,1,9,19,40,764,33580764
10879,679,1800400,1,9,19,41,443,33581443
10880,391,1800400,1,9,19,41,834,33581834
10881,279,1800400,1,9,19,42,113,33582113
10882,218,1800400,1,9,19,42,331,33582331
10883,585,1800500,1,9,19,42,916,33582916
10884,195,1800600,1,9,19,43,111,33583111
10885,248,1800400,4,9,19,43,359,33583359
10886,0,1800400,4,9,19,43,359,33583359
10888,734,1800500,1,9,19,44,93,33584093
10889,264,1800300,4,9,19,44,357,33584357
10891,516,1800400,1,9,19,44,873,33584873
10892,194,1800300,2,9,19,45,67,33585067
10894,88,1800400,2,9,19,45,155,33585155
10895,144,1800400,2,9,19,45,299,33585299
10896,142,1800200,1,9,19,45,441,33585441
10897,0,1800400,1,9,19,45,441,33585441
10898,138,1800500,6,9,19,45,579,33585579
10900,53,1800400,1,9,19,45,632,33585632
10901,57,1800300,7,9,19,45,689,33585689
10903,1,1800300,1,9,19,45,690,33585690
10904,1,1800200,3,9,19,45,691,33585691
10905,568,1800400,1,9,19,46,259,33586259
10906,59,1800400,1,9,19,46,318,33586318
10907,39,1800500,1,9,19,46,357,33586357
10908,836,1800400,1,9,19,47,193,33587193
10909,363,1800400,1,9,19,47,556,33587556
10910,201,1800300,3,9,19,47,757,33587757
10911,607,1800300,2,9,19,48,364,33588364
10912,0,1800500,5,9,19,48,364,33588364
10913,792,1800300,1,9,19,49,156,33589156
10914,7,1800300,4,9,19,49,163,33589163
10915,323,1800300,5,9,19,49,486,33589486
10916,198,1800300,1,9,19,49,684,33589684
10917,2114,1800300,1,9,19,51,798,33591798
10918,30,1800300,1,9,19,51,828,33591828
10919,204,1800300,1,9,19,52,32,33592032
10920,1524,1800200,1,9,19,53,556,33593556
10921,84,1800300,1,9,19,53,640,33593640
10922,17,1800300,4,9,19,53,657,33593657
10923,350,1800300,1,9,19,54,7,33594007
10924,67,1800200,1,9,19,54,74,33594074
10925,584,1800400,6,9,19,54,658,33594658
10926,307,1800300,5,9,19,54,965,33594965
10927,1,1800300,1,9,19,54,966,33594966
10928,798,1800200,2,9,19,55,764,33595764
10929,759,1800400,8,9,19,56,523,33596523
10930,371,1800300,5,9,19,56,894,33596894
10931,316,1800400,1,9,19,57,210,33597210
10932,617,1800300,1,9,19,57,827,33597827
10933,884,1800200,1,9,19,58,711,33598711
10934,595,1800400,4,9,19,59,306,33599306
10935,746,1800500,9,9,20,0,52,33600052
10936,157,1800500,1,9,20,0,209,33600209
10937,28,1800400,2,9,20,0,237,33600237
10938,78,1800400,3,9,20,0,315,33600315
10939,186,1800400,1,9,20,0,501,33600501
10940,138,1800300,2,9,20,0,639,33600639
10941,15,1800300,1,9,20,0,654,33600654
10942,320,1800300,1,9,20,0,974,33600974
10943,104,1800500,5,9,20,1,78,33601078
10944,246,1800400,1,9,20,1,324,33601324
10946,374,1800500,1,9,20,1,698,33601698
10947,184,1800500,1,9,20,1,882,33601882
10948,38,1800300,1,9,20,1,920,33601920
10949,633,1800400,1,9,20,2,553,33602553
10950,23,1800300,1,9,20,2,576,33602576
10951,101,1800500,1,9,20,2,677,33602677
10952,393,1800400,1,9,20,3,70,33603070
10953,5,1800500,3,9,20,3,75,33603075
10954,185,1800400,1,9,20,3,260,33603260
10955,373,1800300,1,9,20,3,633,33603633
10956,1,1800300,1,9,20,3,634,33603634
10957,593,1800400,1,9,20,4,227,33604227
10958,345,1800500,1,9,20,4,572,33604572
10959,745,1800400,1,9,20,5,317,33605317
10960,56,1800500,1,9,20,5,373,33605373
10961,139,1800500,1,9,20,5,512,33605512
10962,268,1800400,4,9,20,5,780,33605780
10964,154,1800500,1,9,20,5,934,33605934
10965,452,1800300,1,9,20,6,386,33606386
10966,1,1800200,1,9,20,6,387,33606387
10967,0,1800200,2,9,20,6,387,33606387
10968,0,1800200,3,9,20,6,387,33606387
10969,123,1800300,1,9,20,6,510,33606510
10970,24,1800200,1,9,20,6,534,33606534
10971,1058,1800200,1,9,20,7,592,33607592
10972,763,1800300,1,9,20,8,355,33608355
10973,544,1800300,1,9,20,8,899,33608899
10974,132,1800200,1,9,20,9,31,33609031
10975,411,1800300,1,9,20,9,442,33609442
10976,546,1800300,1,9,20,9,988,33609988
10977,1469,1800300,1,9,20,11,457,33611457
10978,348,1800300,4,9,20,11,805,33611805
10979,14,1800200,1,9,20,11,819,33611819
10980,987,1800300,1,9,20,12,806,33612806
10981,180,1800300,1,9,20,12,986,33612986
10982,58,1800200,5,9,20,13,44,33613044
10983,173,1800300,2,9,20,13,217,33613217
10984,253,1800200,1,9,20,13,470,33613470
10985,339,1800200,9,9,20,13,809,33613809
10986,383,1800200,1,9,20,14,192,33614192
10987,483,1800200,1,9,20,14,675,33614675
10988,131,1800300,5,9,20,14,806,33614806
10989,440,1800200,13,9,20,15,246,33615246
10990,1,1800200,1,9,20,15,247,33615247
10991,0,1800200,8,9,20,15,247,33615247
10992,831,1800200,1,9,20,16,78,33616078
10993,1,1800200,1,9,20,16,79,33616079
10994,368,1800200,1,9,20,16,447,33616447
10995,820,1800200,4,9,20,17,267,33617267
10997,61,1800300,5,9,20,17,328,33617328
10998,138,1800200,1,9,20,17,466,33617466
10999,124,1800200,1,9,20,17,590,33617590
11000,148,1800100,5,9,20,17,738,33617738
11001,1,1800100,5,9,20,17,739,33617739
11002,10,1800200,1,9,20,17,749,33617749
11003,420,1800200,1,9,20,18,169,33618169
11004,145,1800200,1,9,20,18,314,33618314
11005,684,1800100,1,9,20,18,998,33618998
11006,268,1800200,2,9,20,19,266,33619266
11008,24,1800200,1,9,20,19,290,33619290
11009,837,1800100,2,9,20,20,127,33620127
11011,101,1800200,1,9,20,20,228,33620228
11012,121,1800100,1,9,20,20,349,33620349
11013,669,1800100,1,9,20,21,18,33621018
11014,382,1800100,1,9,20,21,400,33621400
11015,509,1800100,1,9,20,21,909,33621909
11016,317,1800200,1,9,20,22,226,33622226
11017,204,1800100,1,9,20,22,430,33622430
11018,141,1800100,1,9,20,22,571,33622571
11019,383,1800100,2,9,20,22,954,33622954
11020,309,1800000,1,9,20,23,263,33623263
11021,130,1800200,10,9,20,23,393,33623393
11022,74,1800200,1,9,20,23,467,33623467
11023,74,1800200,1,9,20,23,541,33623541
11024,363,1800200,3,9,20,23,904,33623904
11026,11,1800200,1,9,20,23,915,33623915
11027,59,1800300,4,9,20,23,974,33623974
11028,44,1800400,5,9,20,24,18,33624018
11029,0,1800400,1,9,20,24,18,33624018
11030,202,1800300,1,9,20,24,220,33624220
11031,1529,1800300,1,9,20,25,749,33625749
11032,13,1800300,1,9,20,25,762,33625762
11033,1,1800200,9,9,20,25,763,33625763
11035,158,1800100,1,9,20,25,921,33625921
11036,71,1800100,2,9,20,25,992,33625992
11037,0,1800000,1,9,20,25,992,33625992
11038,0,1800000,2,9,20,25,992,33625992
11039,0,1800000,1,9,20,25,992,33625992
11040,0,1800000,2,9,20,25,992,33625992
11041,27,1800100,1,9,20,26,19,33626019
11042,2148,1800100,1,9,20,28,167,33628167
11043,73,1800100,1,9,20,28,240,33628240
11044,0,1800100,1,9,20,28,240,33628240
11045,42,1800000,1,9,20,28,282,33628282
11046,1,1800000,5,9,20,28,283,33628283
11047,0,1800000,3,9,20,28,283,33628283
11048,0,1800000,11,9,20,28,283,33628283
11049,253,1800000,2,9,20,28,536,33628536
11051,641,1799900,2,9,20,29,177,33629177
11052,34,1800000,1,9,20,29,211,33629211
11053,82,1799900,1,9,20,29,293,33629293
11054,174,1799900,2,9,20,29,467,33629467
11055,72,1799900,2,9,20,29,539,33629539
11056,0,1799900,2,9,20,29,539,33629539
11058,80,1799700,1,9,20,29,619,33629619
11059,17,1799700,2,9,20,29,636,33629636
11060,582,1799700,1,9,20,30,218,33630218
11061,149,1799800,1,9,20,30,367,33630367
11062,163,1799700,1,9,20,30,530,33630530
11063,1388,1799700,1,9,20,31,918,33631918
11064,70,1799800,1,9,20,31,988,33631988
11065,0,1799800,1,9,20,31,988,33631988
11066,0,1799800,2,9,20,31,988,33631988
11067,13,1800000,1,9,20,32,1,33632001
11068,180,1799900,1,9,20,32,181,33632181
11069,472,1800000,1,9,20,32,653,33632653
11070,784,1800100,2,9,20,33,437,33633437
11071,36,1799900,1,9,20,33,473,33633473
11072,355,1800000,1,9,20,33,828,33633828
11073,243,1799900,1,9,20,34,71,33634071
11074,538,1800100,3,9,20,34,609,33634609
11075,0,1800100,1,9,20,34,609,33634609
11076,44,1800100,1,9,20,34,653,33634653
11077,34,1800100,4,9,20,34,687,33634687
11078,119,1800100,1,9,20,34,806,33634806
11079,452,1800200,2,9,20,35,258,33635258
11080,0,1800200,2,9,20,35,258,33635258
11081,381,1800000,1,9,20,35,639,33635639
11082,182,1800000,2,9,20,35,821,33635821
11083,1,1800000,1,9,20,35,822,33635822
11084,525,1800100,1,9,20,36,347,33636347
11085,860,1800100,1,9,20,37,207,33637207
11086,491,1800200,2,9,20,37,698,33637698
11087,742,1800200,1,9,20,38,440,33638440
11088,345,1800100,1,9,20,38,785,33638785
11089,367,1800000,1,9,20,39,152,33639152
11090,45,1800000,1,9,20,39,197,33639197
11091,362,1800000,1,9,20,39,559,33639559
11092,309,1800000,1,9,20,39,868,33639868
11094,2,1800100,2,9,20,39,870,33639870
11095,441,1800200,1,9,20,40,311,33640311
11096,566,1800300,1,9,20,40,877,33640877
11097,497,1800200,1,9,20,41,374,33641374
11098,861,1800200,1,9,20,42,235,33642235
11099,203,1800200,1,9,20,42,438,33642438
11100,227,1800300,2,9,20,42,665,33642665
11101,37,1800200,1,9,20,42,702,33642702
11102,1632,1800200,2,9,20,44,334,33644334
11103,52,1800300,1,9,20,44,386,33644386
11104,271,1800200,1,9,20,44,657,33644657
11105,951,1800300,1,9,20,45,608,33645608
11106,1060,1800300,1,9,20,46,668,33646668
11107,430,1800100,1,9,20,47,98,33647098
11108,543,1800100,1,9,20,47,641,33647641
11109,1213,1800300,2,9,20,48,854,33648854
11110,72,1800300,1,9,20,48,926,33648926
11111,71,1800300,1,9,20,48,997,33648997
11112,1,1800300,1,9,20,48,998,33648998
11113,112,1800400,3,9,20,49,110,33649110
11114,37,1800500,1,9,20,49,147,33649147
11115,1,1800500,5,9,20,49,148,33649148
11116,48,1800400,6,9,20,49,196,33649196
11118,2,1800400,1,9,20,49,198,33649198
11119,744,1800500,1,9,20,49,942,33649942
11120,100,1800400,1,9,20,50,42,33650042
11121,258,1800500,1,9,20,50,300,33650300
11122,85,1800500,1,9,20,50,385,33650385
11123,143,1800400,1,9,20,50,528,33650528
11124,194,1800400,2,9,20,50,722,33650722
11125,1993,1800400,1,9,20,52,715,33652715
11126,825,1800400,1,9,20,53,540,33653540
11127,2880,1800500,16,9,20,56,420,33656420
11128,3,1800600,6,9,20,56,423,33656423
11129,5,1800700,6,9,20,56,428,33656428
11130,134,1800700,2,9,20,56,562,33656562
11131,283,1800700,3,9,20,56,845,33656845
11132,294,1800700,1,9,20,57,139,33657139
11133,1213,1800700,1,9,20,58,352,33658352
11134,84,1800700,1,9,20,58,436,33658436
11135,253,1800600,1,9,20,58,689,33658689
11136,406,1800700,1,9,20,59,95,33659095
11137,185,1800800,6,9,20,59,280,33659280
11138,311,1800800,1,9,20,59,591,33659591
11139,130,1800800,1,9,20,59,721,33659721
11140,471,1800800,2,9,21,0,192,33660192
11141,101,1800700,1,9,21,0,293,33660293
11142,54,1800700,1,9,21,0,347,33660347
11143,59,1800800,1,9,21,0,406,33660406
11144,50,1800800,1,9,21,0,456,33660456
11145,269,1800800,1,9,21,0,725,33660725
11146,116,1800800,1,9,21,0,841,33660841
11147,71,1800700,1,9,21,0,912,33660912
11148,0,1800700,1,9,21,0,912,33660912
11149,118,1800700,1,9,21,1,30,33661030
11150,29,1800800,2,9,21,1,59,33661059
11151,262,1800700,1,9,21,1,321,33661321
11152,418,1800700,1,9,21,1,739,33661739
11153,142,1800600,7,9,21,1,881,33661881
11154,20,1800700,1,9,21,1,901,33661901
11155,65,1800700,1,9,21,1,966,33661966
11156,229,1800800,1,9,21,2,195,33662195
11157,0,1800800,1,9,21,2,195,33662195
11158,72,1800600,1,9,21,2,267,33662267
11159,244,1800600,1,9,21,2,511,33662511
11160,236,1800600,1,9,21,2,747,33662747
11161,419,1800800,1,9,21,3,166,33663166
11162,563,1800800,1,9,21,3,729,33663729
11163,1032,1800700,1,9,21,4,761,33664761
11164,20,1800800,1,9,21,4,781,33664781
11165,2102,1800700,2,9,21,6,883,33666883
11166,106,1800800,2,9,21,6,989,33666989
11167,429,1800800,1,9,21,7,418,33667418
11168,390,1800900,2,9,21,7,808,33667808
11169,86,1800900,1,9,21,7,894,33667894
11170,5,1800900,1,9,21,7,899,33667899
11171,0,1800900,1,9,21,7,899,33667899
11172,16,1801000,1,9,21,7,915,33667915
11173,78,1801000,1,9,21,7,993,33667993
11174,41,1800800,1,9,21,8,34,33668034
11175,12,1801000,1,9,21,8,46,33668046
11176,75,1801000,1,9,21,8,121,33668121
11177,459,1801000,2,9,21,8,580,33668580
11178,99,1801000,1,9,21,8,679,33668679
11179,71,1801100,2,9,21,8,750,33668750
11180,1,1801100,1,9,21,8,751,33668751
11181,13,1801200,1,9,21,8,764,33668764
11182,165,1801200,1,9,21,8,929,33668929
11183,51,1801200,1,9,21,8,980,33668980
11184,22,1801200,1,9,21,9,2,33669002
11185,207,1801200,5,9,21,9,209,33669209
11186,542,1801300,8,9,21,9,751,33669751
11187,8,1801300,2,9,21,9,759,33669759
11188,109,1801400,1,9,21,9,868,33669868
11189,49,1801400,4,9,21,9,917,33669917
11190,95,1801400,3,9,21,10,12,33670012
11192,65,1801400,1,9,21,10,77,33670077
11193,23,1801500,1,9,21,10,100,33670100
11194,4,1801500,1,9,21,10,104,33670104
11195,6,1801500,1,9,21,10,110,33670110
11196,18,1801400,4,9,21,10,128,33670128
11198,7,1801300,1,9,21,10,135,33670135
11199,29,1801500,1,9,21,10,164,33670164
11200,47,1801300,1,9,21,10,211,33670211
11201,1,1801300,4,9,21,10,212,33670212
11202,254,1801300,1,9,21,10,466,33670466
11203,65,1801300,5,9,21,10,531,33670531
11204,217,1801400,1,9,21,10,748,33670748
11205,921,1801300,2,9,21,11,669,33671669
11207,105,1801400,3,9,21,11,774,33671774
11208,156,1801200,1,9,21,11,930,33671930
11209,156,1801400,1,9,21,12,86,33672086
11210,121,1801400,3,9,21,12,207,33672207
11211,885,1801300,1,9,21,13,92,33673092
11212,58,1801400,1,9,21,13,150,33673150
11213,111,1801400,2,9,21,13,261,33673261
11214,1,1801400,1,9,21,13,262,33673262
11215,453,1801400,3,9,21,13,715,33673715
11216,298,1801400,1,9,21,14,13,33674013
11217,3,1801400,1,9,21,14,16,33674016
11218,0,1801400,11,9,21,14,16,33674016
11219,0,1801300,12,9,21,14,16,33674016
11220,645,1801400,1,9,21,14,661,33674661
11221,20,1801200,1,9,21,14,681,33674681
11222,382,1801400,2,9,21,15,63,33675063
11223,233,1801300,1,9,21,15,296,33675296
11224,986,1801400,1,9,21,16,282,33676282
11225,398,1801400,4,9,21,16,680,33676680
11226,1181,1801300,1,9,21,17,861,33677861
11227,12,1801400,3,9,21,17,873,33677873
11228,1504,1801300,2,9,21,19,377,33679377
11229,90,1801300,1,9,21,19,467,33679467
11230,1340,1801200,1,9,21,20,807,33680807
11231,503,1801400,1,9,21,21,310,33681310
11232,321,1801400,5,9,21,21,631,33681631
11233,1,1801400,2,9,21,21,632,33681632
11234,428,1801300,6,9,21,22,60,33682060
11235,0,1801300,7,9,21,22,60,33682060
11236,12,1801400,6,9,21,22,72,33682072
11237,23,1801500,12,9,21,22,95,33682095
11238,3,1801600,1,9,21,22,98,33682098
11239,0,1801600,2,9,21,22,98,33682098
11240,0,1801600,1,9,21,22,98,33682098
11241,0,1801600,1,9,21,22,98,33682098
11242,130,1801500,3,9,21,22,228,33682228
11243,33,1801600,3,9,21,22,261,33682261
11244,25,1801600,1,9,21,22,286,33682286
11245,1,1801700,4,9,21,22,287,33682287
11246,76,1801800,1,9,21,22,363,33682363
11247,48,1801700,1,9,21,22,411,33682411
11248,163,1801700,1,9,21,22,574,33682574
11249,24,1801700,4,9,21,22,598,33682598
11250,69,1801800,1,9,21,22,667,33682667
11251,38,1801600,1,9,21,22,705,33682705
11252,177,1801600,1,9,21,22,882,33682882
11253,225,1801600,1,9,21,23,107,33683107
11254,156,1801600,1,9,21,23,263,33683263
11255,534,1801600,1,9,21,23,797,33683797
11256,45,1801600,2,9,21,23,842,33683842
11257,132,1801400,4,9,21,23,974,33683974
11258,656,1801200,1,9,21,24,630,33684630
11259,38,1801200,1,9,21,24,668,33684668
11260,919,1801200,20,9,21,25,587,33685587
11261,1,1801100,1,9,21,25,588,33685588
11262,21,1801200,13,9,21,25,609,33685609
11264,121,1801000,1,9,21,25,730,33685730
11265,914,1801100,1,9,21,26,644,33686644
11267,444,1801000,1,9,21,27,88,33687088
11268,3315,1801100,1,9,21,30,403,33690403
11269,1009,1801000,2,9,21,31,412,33691412
11270,89,1801000,2,9,21,31,501,33691501
11271,192,1800900,1,9,21,31,693,33691693
11272,207,1800800,3,9,21,31,900,33691900
11273,0,1800800,1,9,21,31,900,33691900
11274,142,1800800,1,9,21,32,42,33692042
11275,186,1800800,2,9,21,32,228,33692228
11276,191,1800800,8,9,21,32,419,33692419
11277,51,1800900,2,9,21,32,470,33692470
11278,147,1800800,4,9,21,32,617,33692617
11280,189,1800900,1,9,21,32,806,33692806
11281,492,1800800,2,9,21,33,298,33693298
11282,437,1801000,2,9,21,33,735,33693735
11283,71,1801000,1,9,21,33,806,33693806
11284,484,1801000,1,9,21,34,290,33694290
11285,358,1800900,1,9,21,34,648,33694648
11286,856,1800800,2,9,21,35,504,33695504
11287,1441,1800700,1,9,21,36,945,33696945
11288,61,1800700,1,9,21,37,6,33697006
11289,256,1800800,1,9,21,37,262,33697262
11290,777,1800800,1,9,21,38,39,33698039
11291,404,1800700,3,9,21,38,443,33698443
11292,45,1800700,1,9,21,38,488,33698488
11293,114,1800800,1,9,21,38,602,33698602
11294,163,1800700,1,9,21,38,765,33698765
11295,652,1800800,1,9,21,39,417,33699417
11296,59,1800700,1,9,21,39,476,33699476
11297,304,1800700,1,9,21,39,780,33699780
11298,855,1800900,2,9,21,40,635,33700635
11299,412,1800800,1,9,21,41,47,33701047
11300,126,1800900,2,9,21,41,173,33701173
11302,2,1801000,3,9,21,41,175,33701175
11303,230,1800900,1,9,21,41,405,33701405
11304,514,1800900,1,9,21,41,919,33701919
11305,966,1800800,1,9,21,42,885,33702885
11306,812,1801000,1,9,21,43,697,33703697
11307,1256,1801100,23,9,21,44,953,33704953
11308,1809,1801200,1,9,21,46,762,33706762
11309,434,1801000,1,9,21,47,196,33707196
11310,20,1801100,1,9,21,47,216,33707216
11311,390,1801000,1,9,21,47,606,33707606
11312,6,1800900,1,9,21,47,612,33707612
11313,27,1800900,3,9,21,47,639,33707639
11314,344,1800800,1,9,21,47,983,33707983
11315,663,1801000,1,9,21,48,646,33708646
11316,969,1801000,2,9,21,49,615,33709615
11317,405,1800800,1,9,21,50,20,33710020
11318,370,1800900,1,9,21,50,390,33710390
11319,349,1801000,1,9,21,50,739,33710739
11320,1245,1801000,4,9,21,51,984,33711984
11321,7,1800900,1,9,21,51,991,33711991
11322,140,1800900,1,9,21,52,131,33712131
11323,185,1801000,1,9,21,52,316,33712316
11324,0,1801000,1,9,21,52,316,33712316
11325,1,1801000,2,9,21,52,317,33712317
11326,491,1801000,1,9,21,52,808,33712808
11327,84,1801000,1,9,21,52,892,33712892
11328,612,1801100,1,9,21,53,504,33713504
11329,536,1801100,1,9,21,54,40,33714040
11330,431,1801200,4,9,21,54,471,33714471
11331,358,1801300,1,9,21,54,829,33714829
11332,0,1801300,1,9,21,54,829,33714829
11333,0,1801300,6,9,21,54,829,33714829
11334,31,1801200,1,9,21,54,860,33714860
11335,462,1801300,1,9,21,55,322,33715322
11336,154,1801200,1,9,21,55,476,33715476
11337,352,1801400,1,9,21,55,828,33715828
11338,526,1801300,2,9,21,56,354,33716354
11339,5,1801300,1,9,21,56,359,33716359
11340,266,1801300,1,9,21,56,625,33716625
11341,368,1801300,1,9,21,56,993,33716993
11343,275,1801400,1,9,21,57,268,33717268
11344,340,1801300,1,9,21,57,608,33717608
11345,183,1801200,1,9,21,57,791,33717791
11346,193,1801300,1,9,21,57,984,33717984
11347,126,1801300,1,9,21,58,110,33718110
11348,942,1801300,2,9,21,59,52,33719052
11349,155,1801300,1,9,21,59,207,33719207
11350,461,1801200,2,9,21,59,668,33719668
11351,231,1801100,1,9,21,59,899,33719899
11352,399,1801200,1,9,22,0,298,33720298
11353,164,1801200,1,9,22,0,462,33720462
11354,194,1801200,1,9,22,0,656,33720656
11355,187,1801200,1,9,22,0,843,33720843
11356,99,1801200,1,9,22,0,942,33720942
11357,326,1801300,1,9,22,1,268,33721268
11358,374,1801300,1,9,22,1,642,33721642
11359,266,1801300,1,9,22,1,908,33721908
11360,364,1801100,4,9,22,2,272,33722272
11361,255,1801300,2,9,22,2,527,33722527
11362,79,1801200,1,9,22,2,606,33722606
11363,325,1801200,1,9,22,2,931,33722931
11364,457,1801300,1,9,22,3,388,33723388
11365,0,1801200,2,9,22,3,388,33723388
11366,2677,1801300,4,9,22,6,65,33726065
11368,40,1801300,1,9,22,6,105,33726105
11369,4,1801400,1,9,22,6,109,33726109
11370,32,1801300,1,9,22,6,141,33726141
11371,1095,1801100,1,9,22,7,236,33727236
11372,403,1801100,1,9,22,7,639,33727639
11373,2,1801100,3,9,22,7,641,33727641
11374,0,1801100,1,9,22,7,641,33727641
11375,0,1801100,1,9,22,7,641,33727641
11376,791,1801100,1,9,22,8,432,33728432
11377,84,1801100,1,9,22,8,516,33728516
11378,707,1800900,2,9,22,9,223,33729223
11379,1137,1800900,1,9,22,10,360,33730360
11380,414,1800900,1,9,22,10,774,33730774
11381,300,1800900,1,9,22,11,74,33731074
11382,356,1800800,1,9,22,11,430,33731430
11383,335,1800800,1,9,22,11,765,33731765
11384,642,1800800,1,9,22,12,407,33732407
11385,166,1800800,1,9,22,12,573,33732573
11386,383,1800800,1,9,22,12,956,33732956
11387,426,1800800,1,9,22,13,382,33733382
11388,1583,1800900,1,9,22,14,965,33734965
11389,400,1801000,1,9,22,15,365,33735365
11390,449,1801000,1,9,22,15,814,33735814
11391,1520,1800900,1,9,22,17,334,33737334
11392,306,1800900,1,9,22,17,640,33737640
11393,250,1800900,1,9,22,17,890,33737890
11394,646,1800900,1,9,22,18,536,33738536
11395,262,1800900,1,9,22,18,798,33738798
11396,557,1800800,1,9,22,19,355,33739355
11397,5,1800800,5,9,22,19,360,33739360
11398,341,1800900,1,9,22,19,701,33739701
11399,533,1800700,1,9,22,20,234,33740234
11400,110,1800700,1,9,22,20,344,33740344
11401,318,1800700,1,9,22,20,662,33740662
11402,716,1800700,1,9,22,21,378,33741378
11403,1,1800700,1,9,22,21,379,33741379
11404,926,1800600,1,9,22,22,305,33742305
11405,0,1800600,11,9,22,22,305,33742305
11406,0,1800600,1,9,22,22,305,33742305
11407,43,1800500,1,9,22,22,348,33742348
11408,49,1800500,1,9,22,22,397,33742397
11409,126,1800500,1,9,22,22,523,33742523
11410,8,1800500,1,9,22,22,531,33742531
11411,9,1800500,1,9,22,22,540,33742540
11412,207,1800500,1,9,22,22,747,33742747
11413,91,1800500,2,9,22,22,838,33742838
11414,195,1800500,1,9,22,23,33,33743033
11415,122,1800600,1,9,22,23,155,33743155
11416,486,1800500,1,9,22,23,641,33743641
11417,41,1800500,1,9,22,23,682,33743682
11418,128,1800600,10,9,22,23,810,33743810
11420,2,1800700,1,9,22,23,812,33743812
11421,1,1800800,2,9,22,23,813,33743813
11422,0,1800700,3,9,22,23,813,33743813
11423,0,1800800,1,9,22,23,813,33743813
11424,1,1800800,8,9,22,23,814,33743814
11425,0,1800800,1,9,22,23,814,33743814
11426,0,1800800,1,9,22,23,814,33743814
11427,0,1800800,3,9,22,23,814,33743814
11429,1,1800900,1,9,22,23,815,33743815
11430,1,1800800,4,9,22,23,816,33743816
11431,36,1800900,2,9,22,23,852,33743852
11432,0,1800900,1,9,22,23,852,33743852
11433,1,1801000,3,9,22,23,853,33743853
11434,33,1800800,1,9,22,23,886,33743886
11435,745,1800900,4,9,22,24,631,33744631
11436,300,1800900,1,9,22,24,931,33744931
11437,60,1800900,1,9,22,24,991,33744991
11438,260,1800800,1,9,22,25,251,33745251
11439,1491,1800900,1,9,22,26,742,33746742
11440,226,1801000,2,9,22,26,968,33746968
11441,248,1801000,1,9,22,27,216,33747216
11442,934,1800900,1,9,22,28,150,33748150
11444,172,1801000,1,9,22,28,322,33748322
11445,0,1801000,1,9,22,28,322,33748322
11446,460,1801000,1,9,22,28,782,33748782
11447,517,1801000,6,9,22,29,299,33749299
11448,0,1801000,14,9,22,29,299,33749299
11449,279,1801100,1,9,22,29,578,33749578
11450,843,1801200,1,9,22,30,421,33750421
11451,1350,1801200,6,9,22,31,771,33751771
11452,340,1801200,1,9,22,32,111,33752111
11453,79,1801200,1,9,22,32,190,33752190
11454,1107,1801300,1,9,22,33,297,33753297
11455,0,1801300,1,9,22,33,297,33753297
11456,1,1801300,5,9,22,33,298,33753298
11457,809,1801300,1,9,22,34,107,33754107
11458,1918,1801200,3,9,22,36,25,33756025
11459,143,1801200,4,9,22,36,168,33756168
11461,34,1801100,1,9,22,36,202,33756202
11462,984,1801200,1,9,22,37,186,33757186
11463,423,1801300,1,9,22,37,609,33757609
11464,192,1801200,1,9,22,37,801,33757801
11465,478,1801200,1,9,22,38,279,33758279
11466,53,1801400,1,9,22,38,332,33758332
11467,1519,1801300,6,9,22,39,851,33759851
11469,1740,1801200,1,9,22,41,591,33761591
11470,818,1801200,1,9,22,42,409,33762409
11471,2104,1801200,2,9,22,44,513,33764513
11472,1829,1801300,1,9,22,46,342,33766342
11473,2,1801300,3,9,22,46,344,33766344
11474,152,1801400,1,9,22,46,496,33766496
11475,865,1801400,1,9,22,47,361,33767361
11476,755,1801200,1,9,22,48,116,33768116
11477,192,1801300,1,9,22,48,308,33768308
11478,1910,1801300,2,9,22,50,218,33770218
11479,314,1801400,1,9,22,50,532,33770532
11480,266,1801400,16,9,22,50,798,33770798
11481,200,1801500,7,9,22,50,998,33770998
11482,0,1801500,7,9,22,50,998,33770998
11483,156,1801500,2,9,22,51,154,33771154
11484,184,1801400,1,9,22,51,338,33771338
11485,533,1801500,1,9,22,51,871,33771871
11486,298,1801500,1,9,22,52,169,33772169
11487,119,1801500,1,9,22,52,288,33772288
11488,133,1801300,1,9,22,52,421,33772421
11489,888,1801400,1,9,22,53,309,33773309
11490,1516,1801400,1,9,22,54,825,33774825
11491,118,1801400,1,9,22,54,943,33774943
11492,74,1801300,1,9,22,55,17,33775017
11493,1118,1801400,9,9,22,56,135,33776135
11494,261,1801300,1,9,22,56,396,33776396
11495,836,1801400,1,9,22,57,232,33777232
11496,931,1801400,1,9,22,58,163,33778163
11497,1149,1801300,6,9,22,59,312,33779312
11498,0,1801300,7,9,22,59,312,33779312
11499,1751,1801300,4,9,23,1,63,33781063
11500,77,1801300,4,9,23,1,140,33781140
11501,1036,1801200,3,9,23,2,176,33782176
11502,1196,1801300,1,9,23,3,372,33783372
11503,107,1801400,1,9,23,3,479,33783479
11504,4,1801400,1,9,23,3,483,33783483
11505,476,1801300,1,9,23,3,959,33783959
11506,346,1801400,3,9,23,4,305,33784305
11507,48,1801500,1,9,23,4,353,33784353
11508,62,1801400,1,9,23,4,415,33784415
11509,64,1801500,1,9,23,4,479,33784479
11510,0,1801500,6,9,23,4,479,33784479
11511,229,1801600,14,9,23,4,708,33784708
11512,158,1801600,1,9,23,4,866,33784866
11513,359,1801700,4,9,23,5,225,33785225
11514,235,1801700,1,9,23,5,460,33785460
11515,110,1801700,1,9,23,5,570,33785570
11516,714,1801600,1,9,23,6,284,33786284
11517,3,1801600,2,9,23,6,287,33786287
11518,105,1801500,1,9,23,6,392,33786392
11519,7,1801600,1,9,23,6,399,33786399
11520,525,1801300,1,9,23,6,924,33786924
11521,181,1801500,1,9,23,7,105,33787105
11522,121,1801500,1,9,23,7,226,33787226
11523,467,1801300,1,9,23,7,693,33787693
11524,2126,1801400,1,9,23,9,819,33789819
11525,80,1801300,1,9,23,9,899,33789899
11526,165,1801300,1,9,23,10,64,33790064
11527,92,1801300,1,9,23,10,156,33790156
11528,595,1801400,3,9,23,10,751,33790751
11529,256,1801400,3,9,23,11,7,33791007
11530,443,1801400,1,9,23,11,450,33791450
11531,126,1801400,1,9,23,11,576,33791576
11532,872,1801300,1,9,23,12,448,33792448
11533,1656,1801400,1,9,23,14,104,33794104
11534,164,1801400,3,9,23,14,268,33794268
11535,252,1801400,1,9,23,14,520,33794520
11536,994,1801400,1,9,23,15,514,33795514
11537,94,1801500,1,9,23,15,608,33795608
11538,403,1801600,1,9,23,16,11,33796011
11539,1376,1801600,1,9,23,17,387,33797387
11540,688,1801400,1,9,23,18,75,33798075
11541,449,1801400,1,9,23,18,524,33798524
11542,1031,1801600,1,9,23,19,555,33799555
11543,886,1801500,1,9,23,20,441,33800441
11544,809,1801500,1,9,23,21,250,33801250
11545,1081,1801400,1,9,23,22,331,33802331
11547,12,1801500,3,9,23,22,343,33802343
11548,23,1801500,1,9,23,22,366,33802366
11549,241,1801500,5,9,23,22,607,33802607
11550,0,1801500,5,9,23,22,607,33802607
11552,3,1801800,2,9,23,22,610,33802610
11553,0,1801800,1,9,23,22,610,33802610
11554,0,1801800,1,9,23,22,610,33802610
11555,0,1801800,16,9,23,22,610,33802610
11556,3,1801900,7,9,23,22,613,33802613
11557,1,1801900,1,9,23,22,614,33802614
11558,0,1801900,2,9,23,22,614,33802614
11559,0,1801900,3,9,23,22,614,33802614
11560,0,1801900,2,9,23,22,614,33802614
11561,0,1801900,1,9,23,22,614,33802614
11562,1,1801800,1,9,23,22,615,33802615
11563,9,1801900,1,9,23,22,624,33802624
11564,26,1802000,38,9,23,22,650,33802650
11565,162,1802100,2,9,23,22,812,33802812
11566,5,1802100,6,9,23,22,817,33802817
11567,8,1802100,1,9,23,22,825,33802825
11568,2,1802100,1,9,23,22,827,33802827
11569,32,1802100,1,9,23,22,859,33802859
11570,4,1802200,1,9,23,22,863,33802863
11571,18,1802200,1,9,23,22,881,33802881
11572,18,1802100,1,9,23,22,899,33802899
11574,61,1802100,1,9,23,22,960,33802960
11575,25,1802200,2,9,23,22,985,33802985
11576,25,1802000,1,9,23,23,10,33803010
11577,12,1802200,3,9,23,23,22,33803022
11578,98,1802200,1,9,23,23,120,33803120
11579,17,1802200,2,9,23,23,137,33803137
11580,24,1802000,3,9,23,23,161,33803161
11581,418,1802200,1,9,23,23,579,33803579
11582,383,1802000,1,9,23,23,962,33803962
11583,140,1802200,1,9,23,24,102,33804102
11584,189,1802200,1,9,23,24,291,33804291
11585,156,1802000,1,9,23,24,447,33804447
11586,149,1802000,7,9,23,24,596,33804596
11588,88,1801900,1,9,23,24,684,33804684
11589,354,1802000,3,9,23,25,38,33805038
11590,213,1802100,10,9,23,25,251,33805251
11591,865,1802200,1,9,23,26,116,33806116
11592,134,1802100,1,9,23,26,250,33806250
11593,688,1802200,1,9,23,26,938,33806938
11594,257,1802200,1,9,23,27,195,33807195
11595,399,1802300,1,9,23,27,594,33807594
11596,0,1802300,20,9,23,27,594,33807594
11597,25,1802400,1,9,23,27,619,33807619
11598,10,1802400,4,9,23,27,629,33807629
11599,0,1802400,4,9,23,27,629,33807629
11600,39,1802400,4,9,23,27,668,33807668
11601,10,1802400,1,9,23,27,678,33807678
11602,77,1802400,1,9,23,27,755,33807755
11603,11,1802300,1,9,23,27,766,33807766
11604,47,1802400,1,9,23,27,813,33807813
11605,371,1802300,1,9,23,28,184,33808184
11606,100,1802400,2,9,23,28,284,33808284
11607,38,1802300,1,9,23,28,322,33808322
11608,45,1802400,1,9,23,28,367,33808367
11609,65,1802400,2,9,23,28,432,33808432
11610,111,1802400,2,9,23,28,543,33808543
11611,159,1802400,1,9,23,28,702,33808702
11612,14,1802400,1,9,23,28,716,33808716
11613,10,1802400,1,9,23,28,726,33808726
11614,138,1802300,1,9,23,28,864,33808864
11615,338,1802400,2,9,23,29,202,33809202
11616,23,1802300,4,9,23,29,225,33809225
11618,546,1802300,1,9,23,29,771,33809771
11619,0,1802300,2,9,23,29,771,33809771
11620,259,1802300,3,9,23,30,30,33810030
11622,42,1802200,1,9,23,30,72,33810072
11623,103,1802300,1,9,23,30,175,33810175
11624,22,1802300,2,9,23,30,197,33810197
11625,83,1802300,1,9,23,30,280,33810280
11626,742,1802300,1,9,23,31,22,33811022
11627,150,1802300,2,9,23,31,172,33811172
11628,23,1802300,1,9,23,31,195,33811195
11629,142,1802400,7,9,23,31,337,33811337
11630,1,1802500,6,9,23,31,338,33811338
11631,0,1802500,2,9,23,31,338,33811338
11632,0,1802500,2,9,23,31,338,33811338
11633,0,1802500,1,9,23,31,338,33811338
11634,55,1802500,1,9,23,31,393,33811393
11635,8,1802400,1,9,23,31,401,33811401
11636,145,1802500,1,9,23,31,546,33811546
11637,2,1802500,2,9,23,31,548,33811548
11638,28,1802400,1,9,23,31,576,33811576
11639,17,1802500,1,9,23,31,593,33811593
11640,264,1802500,3,9,23,31,857,33811857
11641,1,1802500,4,9,23,31,858,33811858
11642,17,1802500,1,9,23,31,875,33811875
11643,137,1802600,1,9,23,32,12,33812012
11644,210,1802600,6,9,23,32,222,33812222
11645,90,1802500,1,9,23,32,312,33812312
11646,102,1802500,2,9,23,32,414,33812414
11647,244,1802400,1,9,23,32,658,33812658
11648,253,1802400,1,9,23,32,911,33812911
11649,578,1802400,3,9,23,33,489,33813489
11650,106,1802300,1,9,23,33,595,33813595
11651,9,1802500,1,9,23,33,604,33813604
11652,5,1802500,1,9,23,33,609,33813609
11653,1232,1802600,2,9,23,34,841,33814841
11654,253,1802600,1,9,23,35,94,33815094
11655,245,1802500,1,9,23,35,339,33815339
11656,96,1802600,1,9,23,35,435,33815435
11657,5,1802600,1,9,23,35,440,33815440
11658,79,1802600,1,9,23,35,519,33815519
11659,357,1802400,1,9,23,35,876,33815876
11660,23,1802600,1,9,23,35,899,33815899
11661,97,1802400,1,9,23,35,996,33815996
11662,635,1802600,1,9,23,36,631,33816631
11663,769,1802500,1,9,23,37,400,33817400
11664,490,1802500,1,9,23,37,890,33817890
11665,358,1802400,14,9,23,38,248,33818248
11666,342,1802500,1,9,23,38,590,33818590
11667,258,1802500,1,9,23,38,848,33818848
11668,162,1802300,1,9,23,39,10,33819010
11669,890,1802400,1,9,23,39,900,33819900
11670,320,1802400,1,9,23,40,220,33820220
11672,370,1802400,2,9,23,40,590,33820590
11673,10,1802500,1,9,23,40,600,33820600
11674,445,1802300,1,9,23,41,45,33821045
11675,119,1802400,2,9,23,41,164,33821164
11676,240,1802400,1,9,23,41,404,33821404
11677,235,1802300,2,9,23,41,639,33821639
11678,544,1802200,1,9,23,42,183,33822183
11679,712,1802300,1,9,23,42,895,33822895
11680,2,1802300,2,9,23,42,897,33822897
11681,249,1802400,1,9,23,43,146,33823146
11682,473,1802400,2,9,23,43,619,33823619
11683,245,1802400,1,9,23,43,864,33823864
11684,649,1802400,1,9,23,44,513,33824513
11685,407,1802200,3,9,23,44,920,33824920
11686,5,1802100,1,9,23,44,925,33824925
11687,0,1802100,4,9,23,44,925,33824925
11688,368,1802000,3,9,23,45,293,33825293
11689,905,1802100,1,9,23,46,198,33826198
11690,81,1802300,1,9,23,46,279,33826279
11691,934,1802100,1,9,23,47,213,33827213
11692,18,1802100,2,9,23,47,231,33827231
11693,248,1802200,3,9,23,47,479,33827479
11694,834,1802200,1,9,23,48,313,33828313
11695,1013,1802300,1,9,23,49,326,33829326
11696,24,1802200,2,9,23,49,350,33829350
11697,1361,1802300,1,9,23,50,711,33830711
11698,1014,1802200,1,9,23,51,725,33831725
11699,810,1802200,1,9,23,52,535,33832535
11700,555,1802300,4,9,23,53,90,33833090
11701,449,1802300,1,9,23,53,539,33833539
11702,205,1802300,1,9,23,53,744,33833744
11703,211,1802300,1,9,23,53,955,33833955
11704,1,1802300,1,9,23,53,956,33833956
11705,645,1802300,1,9,23,54,601,33834601
11706,21,1802300,2,9,23,54,622,33834622
11708,641,1802300,1,9,23,55,263,33835263
11709,0,1802300,2,9,23,55,263,33835263
11710,24,1802200,1,9,23,55,287,33835287
11711,337,1802200,1,9,23,55,624,33835624
11712,97,1802200,1,9,23,55,721,33835721
11713,478,1802300,1,9,23,56,199,33836199
11714,130,1802100,1,9,23,56,329,33836329
11715,222,1802300,1,9,23,56,551,33836551
11716,317,1802300,2,9,23,56,868,33836868
11717,2142,1802200,1,9,23,59,10,33839010
11718,200,1802300,1,9,23,59,210,33839210
11720,825,1802400,10,9,24,0,35,33840035
11721,270,1802500,4,9,24,0,305,33840305
11722,13,1802500,1,9,24,0,318,33840318
11723,110,1802400,1,9,24,0,428,33840428
11724,85,1802500,1,9,24,0,513,33840513
11725,80,1802400,1,9,24,0,593,33840593
11726,250,1802300,1,9,24,0,843,33840843
11727,738,1802300,4,9,24,1,581,33841581
11728,85,1802300,1,9,24,1,666,33841666
11729,200,1802400,1,9,24,1,866,33841866
11731,274,1802400,1,9,24,2,140,33842140
11732,95,1802300,3,9,24,2,235,33842235
11733,416,1802300,1,9,24,2,651,33842651
11734,208,1802300,1,9,24,2,859,33842859
11735,285,1802400,5,9,24,3,144,33843144
11736,847,1802400,1,9,24,3,991,33843991
11737,399,1802400,1,9,24,4,390,33844390
11738,178,1802400,2,9,24,4,568,33844568
11739,121,1802400,1,9,24,4,689,33844689
11740,343,1802500,9,9,24,5,32,33845032
11741,196,1802600,5,9,24,5,228,33845228
11742,0,1802600,4,9,24,5,228,33845228
11743,148,1802700,1,9,24,5,376,33845376
11744,82,1802500,5,9,24,5,458,33845458
11745,0,1802500,5,9,24,5,458,33845458
11746,0,1802500,5,9,24,5,458,33845458
11747,0,1802500,5,9,24,5,458,33845458
11749,22,1802300,1,9,24,5,480,33845480
11750,17,1802400,2,9,24,5,497,33845497
11751,3,1802200,5,9,24,5,500,33845500
11752,2,1802300,2,9,24,5,502,33845502
11753,5,1802400,2,9,24,5,507,33845507
11754,5,1802400,2,9,24,5,512,33845512
11755,2,1802400,2,9,24,5,514,33845514
11756,35,1802400,2,9,24,5,549,33845549
11757,133,1802100,3,9,24,5,682,33845682
11758,51,1802300,1,9,24,5,733,33845733
11759,94,1802300,2,9,24,5,827,33845827
11760,464,1802100,1,9,24,6,291,33846291
11761,1,1802100,5,9,24,6,292,33846292
11762,0,1802100,1,9,24,6,292,33846292
11763,159,1802100,1,9,24,6,451,33846451
11765,5,1802200,1,9,24,6,456,33846456
11766,400,1802100,1,9,24,6,856,33846856
11767,22,1802000,2,9,24,6,878,33846878
11768,425,1802000,2,9,24,7,303,33847303
11769,620,1802000,1,9,24,7,923,33847923
11770,765,1802000,2,9,24,8,688,33848688
11771,1,1802000,5,9,24,8,689,33848689
11772,0,1802000,1,9,24,8,689,33848689
11773,0,1802000,1,9,24,8,689,33848689
11774,0,1802000,6,9,24,8,689,33848689
11775,99,1801900,3,9,24,8,788,33848788
11776,80,1802000,1,9,24,8,868,33848868
11777,5,1801900,1,9,24,8,873,33848873
11778,2,1801900,1,9,24,8,875,33848875
11780,66,1802000,2,9,24,8,941,33848941
11781,10,1802000,2,9,24,8,951,33848951
11782,632,1801900,2,9,24,9,583,33849583
11783,1198,1801900,1,9,24,10,781,33850781
11784,263,1801800,1,9,24,11,44,33851044
11785,199,1801800,1,9,24,11,243,33851243
11786,270,1801800,1,9,24,11,513,33851513
11787,54,1801800,1,9,24,11,567,33851567
11788,752,1801900,2,9,24,12,319,33852319
11789,1341,1801800,1,9,24,13,660,33853660
11790,54,1801800,1,9,24,13,714,33853714
11791,150,1801900,1,9,24,13,864,33853864
11792,303,1801900,3,9,24,14,167,33854167
11793,46,1802000,1,9,24,14,213,33854213
11794,823,1802000,5,9,24,15,36,33855036
11795,0,1802000,1,9,24,15,36,33855036
11796,0,1802000,1,9,24,15,36,33855036
11797,194,1802100,1,9,24,15,230,33855230
11798,331,1802000,1,9,24,15,561,33855561
11799,808,1802100,1,9,24,16,369,33856369
11800,0,1802100,1,9,24,16,369,33856369
11801,42,1802200,3,9,24,16,411,33856411
11802,191,1802300,1,9,24,16,602,33856602
11803,52,1802300,1,9,24,16,654,33856654
11804,1039,1802400,1,9,24,17,693,33857693
11805,931,1802200,1,9,24,18,624,33858624
11806,12,1802300,1,9,24,18,636,33858636
11807,584,1802300,1,9,24,19,220,33859220
11808,377,1802300,2,9,24,19,597,33859597
11809,4028,1802200,2,9,24,23,625,33863625
11810,529,1802300,2,9,24,24,154,33864154
11811,419,1802100,1,9,24,24,573,33864573
11812,273,1802100,5,9,24,24,846,33864846
11814,4,1802000,31,9,24,24,850,33864850
11815,63,1802000,1,9,24,24,913,33864913
11816,33,1801900,3,9,24,24,946,33864946
11817,40,1802000,1,9,24,24,986,33864986
11818,471,1802000,4,9,24,25,457,33865457
11819,154,1802000,1,9,24,25,611,33865611
11820,1148,1801800,3,9,24,26,759,33866759
11821,1023,1801800,1,9,24,27,782,33867782
11822,745,1801800,1,9,24,28,527,33868527
11823,559,1801900,1,9,24,29,86,33869086
11824,70,1801900,1,9,24,29,156,33869156
11825,2446,1802000,2,9,24,31,602,33871602
11826,202,1801900,1,9,24,31,804,33871804
11827,1414,1802100,4,9,24,33,218,33873218
11828,240,1802000,1,9,24,33,458,33873458
11829,882,1802300,2,9,24,34,340,33874340
11830,14,1802300,6,9,24,34,354,33874354
11831,2920,1802200,1,9,24,37,274,33877274
11832,122,1802200,1,9,24,37,396,33877396
11833,260,1802200,1,9,24,37,656,33877656
11834,454,1802200,1,9,24,38,110,33878110
11835,1101,1802100,1,9,24,39,211,33879211
11836,490,1802200,1,9,24,39,701,33879701
11837,258,1802100,1,9,24,39,959,33879959
11838,1254,1802200,5,9,24,41,213,33881213
11839,29,1802200,1,9,24,41,242,33881242
11840,108,1802200,1,9,24,41,350,33881350
11841,686,1802100,1,9,24,42,36,33882036
11842,940,1802000,3,9,24,42,976,33882976
11843,768,1802000,1,9,24,43,744,33883744
11844,2212,1802000,1,9,24,45,956,33885956
11845,371,1801900,2,9,24,46,327,33886327
11846,1651,1801800,8,9,24,47,978,33887978
11847,897,1801800,1,9,24,48,875,33888875
11848,25,1801800,1,9,24,48,900,33888900
11849,229,1801700,2,9,24,49,129,33889129
11850,10,1801800,3,9,24,49,139,33889139
11851,0,1801800,3,9,24,49,139,33889139
11853,1278,1801700,1,9,24,50,417,33890417
11854,1002,1801800,1,9,24,51,419,33891419
11855,1009,1801800,1,9,24,52,428,33892428
11856,244,1801800,1,9,24,52,672,33892672
11857,314,1801700,1,9,24,52,986,33892986
11858,1958,1801900,2,9,24,54,944,33894944
11859,709,1801800,1,9,24,55,653,33895653
11860,260,1801900,1,9,24,55,913,33895913
11861,136,1802000,2,9,24,56,49,33896049
11862,0,1802000,7,9,24,56,49,33896049
11863,0,1802000,3,9,24,56,49,33896049
11864,48,1802100,1,9,24,56,97,33896097
11865,776,1802100,1,9,24,56,873,33896873
11866,398,1802100,3,9,24,57,271,33897271
11867,0,1802100,3,9,24,57,271,33897271
11868,0,1802100,3,9,24,57,271,33897271
11870,108,1801900,1,9,24,57,379,33897379
11871,338,1802000,1,9,24,57,717,33897717
11872,593,1802000,5,9,24,58,310,33898310
11873,694,1802000,1,9,24,59,4,33899004
11874,213,1802100,1,9,24,59,217,33899217
11875,1648,1802100,2,9,25,0,865,33900865
11876,92,1802000,3,9,25,0,957,33900957
11877,96,1802100,1,9,25,1,53,33901053
11878,13,1802100,2,9,25,1,66,33901066
11880,63,1802000,1,9,25,1,129,33901129
11881,14,1802200,1,9,25,1,143,33901143
11882,63,1802200,2,9,25,1,206,33901206
11883,38,1802200,1,9,25,1,244,33901244
11884,154,1802100,2,9,25,1,398,33901398
11885,224,1802100,1,9,25,1,622,33901622
11886,29,1802100,2,9,25,1,651,33901651
11887,161,1802100,2,9,25,1,812,33901812
11888,0,1802100,1,9,25,1,812,33901812
11889,44,1802200,2,9,25,1,856,33901856
11890,8,1802200,2,9,25,1,864,33901864
11891,116,1802200,1,9,25,1,980,33901980
11892,6,1802300,1,9,25,1,986,33901986
11893,686,1802100,1,9,25,2,672,33902672
11894,562,1802000,1,9,25,3,234,33903234
11895,115,1802100,1,9,25,3,349,33903349
11896,73,1802000,4,9,25,3,422,33903422
11897,198,1802100,2,9,25,3,620,33903620
11898,968,1802100,1,9,25,4,588,33904588
11899,12,1802100,2,9,25,4,600,33904600
11900,245,1802100,1,9,25,4,845,33904845
11901,266,1802100,3,9,25,5,111,33905111
11902,1429,1802000,1,9,25,6,540,33906540
11903,406,1802100,1,9,25,6,946,33906946
11904,47,1802000,4,9,25,6,993,33906993
11905,1314,1802000,1,9,25,8,307,33908307
11906,211,1801900,1,9,25,8,518,33908518
11907,1161,1802000,1,9,25,9,679,33909679
11908,545,1801900,1,9,25,10,224,33910224
11909,244,1802000,1,9,25,10,468,33910468
11910,3333,1802100,2,9,25,13,801,33913801
11911,17,1802000,1,9,25,13,818,33913818
11912,144,1802000,1,9,25,13,962,33913962
11913,1215,1802200,1,9,25,15,177,33915177
11914,196,1802000,1,9,25,15,373,33915373
11915,4628,1802100,1,9,25,20,1,33920001
11916,46,1802000,5,9,25,20,47,33920047
11917,3281,1802000,1,9,25,23,328,33923328
11918,3063,1802000,1,9,25,26,391,33926391
11919,251,1801900,1,9,25,26,642,33926642
11920,1,1801900,1,9,25,26,643,33926643
11921,0,1801900,1,9,25,26,643,33926643
11922,0,1801900,1,9,25,26,643,33926643
11923,0,1801900,1,9,25,26,643,33926643
11924,0,1801900,1,9,25,26,643,33926643
11925,105,1801900,1,9,25,26,748,33926748
11926,34,1801900,1,9,25,26,782,33926782
11927,119,1801900,1,9,25,26,901,33926901
11928,126,1801900,1,9,25,27,27,33927027
11929,1433,1801800,1,9,25,28,460,33928460
11930,8,1802000,1,9,25,28,468,33928468
11931,26,1801800,1,9,25,28,494,33928494
11932,1224,1802000,1,9,25,29,718,33929718
11933,4001,1801900,1,9,25,33,719,33933719
11934,1331,1801900,2,9,25,35,50,33935050
11935,194,1802000,5,9,25,35,244,33935244
11936,1002,1802000,1,9,25,36,246,33936246
11937,223,1802000,2,9,25,36,469,33936469
11938,990,1801900,1,9,25,37,459,33937459
11939,1,1801900,8,9,25,37,460,33937460
11940,1684,1801800,1,9,25,39,144,33939144
11941,858,1801800,1,9,25,40,2,33940002
11942,62,1801800,1,9,25,40,64,33940064
11943,31,1801800,3,9,25,40,95,33940095
11944,73,1801800,2,9,25,40,168,33940168
11945,0,1801800,1,9,25,40,168,33940168
11946,748,1801800,1,9,25,40,916,33940916
11947,289,1801700,3,9,25,41,205,33941205
11948,279,1801600,1,9,25,41,484,33941484
11949,152,1801600,2,9,25,41,636,33941636
11950,54,1801600,1,9,25,41,690,33941690
11951,179,1801600,2,9,25,41,869,33941869
11952,304,1801700,1,9,25,42,173,33942173
11953,725,1801700,1,9,25,42,898,33942898
11954,432,1801600,1,9,25,43,330,33943330
11955,1321,1801600,1,9,25,44,651,33944651
11956,41,1801600,8,9,25,44,692,33944692
11957,432,1801500,2,9,25,45,124,33945124
11958,2,1801500,5,9,25,45,126,33945126
11959,1,1801500,1,9,25,45,127,33945127
11960,1,1801500,1,9,25,45,128,33945128
11961,0,1801500,1,9,25,45,128,33945128
11962,0,1801500,9,9,25,45,128,33945128
11963,121,1801400,1,9,25,45,249,33945249
11964,390,1801400,1,9,25,45,639,33945639
11965,568,1801400,1,9,25,46,207,33946207
11966,117,1801400,1,9,25,46,324,33946324
11967,143,1801500,1,9,25,46,467,33946467
11968,633,1801300,5,9,25,47,100,33947100
11969,137,1801300,1,9,25,47,237,33947237
11970,15,1801200,1,9,25,47,252,33947252
11971,142,1801200,1,9,25,47,394,33947394
11972,15,1801200,1,9,25,47,409,33947409
11973,14,1801200,1,9,25,47,423,33947423
11974,61,1801200,3,9,25,47,484,33947484
11975,63,1801200,1,9,25,47,547,33947547
11976,250,1801300,1,9,25,47,797,33947797
11977,244,1801300,1,9,25,48,41,33948041
11978,101,1801300,1,9,25,48,142,33948142
11979,68,1801200,1,9,25,48,210,33948210
11980,38,1801200,1,9,25,48,248,33948248
11981,47,1801200,1,9,25,48,295,33948295
11982,6,1801200,1,9,25,48,301,33948301
11983,279,1801200,1,9,25,48,580,33948580
11984,53,1801400,1,9,25,48,633,33948633
11985,847,1801300,1,9,25,49,480,33949480
11986,6,1801200,1,9,25,49,486,33949486
11987,191,1801300,1,9,25,49,677,33949677
11988,235,1801200,2,9,25,49,912,33949912
11989,254,1801300,5,9,25,50,166,33950166
11990,218,1801300,1,9,25,50,384,33950384
11991,1290,1801200,1,9,25,51,674,33951674
11992,67,1801200,1,9,25,51,741,33951741
11993,469,1801400,2,9,25,52,210,33952210
11994,781,1801400,1,9,25,52,991,33952991
11995,350,1801400,3,9,25,53,341,33953341
11996,386,1801500,1,9,25,53,727,33953727
11997,177,1801500,1,9,25,53,904,33953904
11998,1925,1801400,1,9,25,55,829,33955829
11999,218,1801400,1,9,25,56,47,33956047
12000,2253,1801400,2,9,25,58,300,33958300
12001,354,1801500,5,9,25,58,654,33958654
12002,717,1801600,1,9,25,59,371,33959371
12003,183,1801500,1,9,25,59,554,33959554
12004,217,1801500,1,9,25,59,771,33959771
12005,1195,1801500,2,9,26,0,966,33960966
12006,53,1801500,1,9,26,1,19,33961019
12007,657,1801500,3,9,26,1,676,33961676
12008,232,1801500,1,9,26,1,908,33961908
12009,122,1801600,2,9,26,2,30,33962030
12010,488,1801600,1,9,26,2,518,33962518
12011,492,1801600,1,9,26,3,10,33963010
12013,11,1801500,1,9,26,3,21,33963021
12014,12,1801500,1,9,26,3,33,33963033
12015,139,1801600,1,9,26,3,172,33963172
12016,232,1801400,1,9,26,3,404,33963404
12017,97,1801600,2,9,26,3,501,33963501
12018,1058,1801700,1,9,26,4,559,33964559
12019,1604,1801600,1,9,26,6,163,33966163
12020,1567,1801600,2,9,26,7,730,33967730
12021,304,1801700,1,9,26,8,34,33968034
12022,393,1801600,2,9,26,8,427,33968427
12023,3177,1801600,1,9,26,11,604,33971604
12024,829,1801600,1,9,26,12,433,33972433
12025,1611,1801700,1,9,26,14,44,33974044
12026,263,1801700,1,9,26,14,307,33974307
12027,1,1801700,1,9,26,14,308,33974308
12028,1,1801700,1,9,26,14,309,33974309
12029,0,1801700,1,9,26,14,309,33974309
12030,234,1801700,1,9,26,14,543,33974543
12031,562,1801700,1,9,26,15,105,33975105
12032,191,1801700,3,9,26,15,296,33975296
12033,87,1801700,1,9,26,15,383,33975383
12034,190,1801700,1,9,26,15,573,33975573
12035,2890,1801600,10,9,26,18,463,33978463
12036,451,1801600,1,9,26,18,914,33978914
12037,1802,1801500,1,9,26,20,716,33980716
12038,349,1801700,1,9,26,21,65,33981065
12039,1438,1801600,1,9,26,22,503,33982503
12040,628,1801600,1,9,26,23,131,33983131
12041,116,1801500,1,9,26,23,247,33983247
12042,252,1801500,1,9,26,23,499,33983499
12043,539,1801500,1,9,26,24,38,33984038
12044,222,1801600,1,9,26,24,260,33984260
12045,425,1801500,2,9,26,24,685,33984685
12046,166,1801400,1,9,26,24,851,33984851
12047,391,1801400,14,9,26,25,242,33985242
12048,2469,1801600,1,9,26,27,711,33987711
12050,2903,1801600,1,9,26,30,614,33990614
12052,111,1801700,3,9,26,30,725,33990725
12053,140,1801700,9,9,26,30,865,33990865
12054,0,1801700,3,9,26,30,865,33990865
12055,124,1801700,1,9,26,30,989,33990989
12056,4,1801800,5,9,26,30,993,33990993
12057,246,1801900,4,9,26,31,239,33991239
12059,277,1801800,1,9,26,31,516,33991516
12060,5,1801700,1,9,26,31,521,33991521
12061,274,1801700,2,9,26,31,795,33991795
12062,939,1801700,1,9,26,32,734,33992734
12063,483,1801700,1,9,26,33,217,33993217
12064,2611,1801600,1,9,26,35,828,33995828
12065,1542,1801800,2,9,26,37,370,33997370
12066,406,1801700,4,9,26,37,776,33997776
12067,0,1801700,4,9,26,37,776,33997776
12069,2,1801500,8,9,26,37,778,33997778
12070,0,1801500,1,9,26,37,778,33997778
12071,1,1801500,6,9,26,37,779,33997779
12072,0,1801500,18,9,26,37,779,33997779
12073,17,1801400,12,9,26,37,796,33997796
12074,25,1801400,2,9,26,37,821,33997821
12075,1,1801500,4,9,26,37,822,33997822
12076,71,1801400,1,9,26,37,893,33997893
12077,221,1801400,1,9,26,38,114,33998114
12078,646,1801400,1,9,26,38,760,33998760
12079,536,1801400,1,9,26,39,296,33999296
12080,327,1801400,1,9,26,39,623,33999623
12081,895,1801500,1,9,26,40,518,34000518
12082,706,1801500,1,9,26,41,224,34001224
12083,1605,1801500,1,9,26,42,829,34002829
12084,2159,1801500,1,9,26,44,988,34004988
12085,366,1801400,3,9,26,45,354,34005354
12086,1,1801400,1,9,26,45,355,34005355
12087,553,1801400,1,9,26,45,908,34005908
12088,32,1801400,1,9,26,45,940,34005940
12089,821,1801400,1,9,26,46,761,34006761
12090,696,1801400,1,9,26,47,457,34007457
12091,175,1801500,1,9,26,47,632,34007632
12092,267,1801500,1,9,26,47,899,34007899
12093,561,1801500,2,9,26,48,460,34008460
12094,201,1801500,1,9,26,48,661,34008661
12095,2,1801500,1,9,26,48,663,34008663
12096,1345,1801400,1,9,26,50,8,34010008
12097,1630,1801600,1,9,26,51,638,34011638
12098,0,1801500,7,9,26,51,638,34011638
12099,359,1801400,1,9,26,51,997,34011997
12100,282,1801500,2,9,26,52,279,34012279
12101,1622,1801500,1,9,26,53,901,34013901
12102,1481,1801500,1,9,26,55,382,34015382
12103,1505,1801400,1,9,26,56,887,34016887
12104,1083,1801400,3,9,26,57,970,34017970
12105,200,1801400,1,9,26,58,170,34018170
12106,354,1801400,1,9,26,58,524,34018524
12107,397,1801300,1,9,26,58,921,34018921
12108,1784,1801500,3,9,27,0,705,34020705
12109,0,1801500,4,9,27,0,705,34020705
12110,18,1801600,3,9,27,0,723,34020723
12111,126,1801700,1,9,27,0,849,34020849
12112,0,1801700,1,9,27,0,849,34020849
12113,0,1801700,1,9,27,0,849,34020849
12114,1,1801700,1,9,27,0,850,34020850
12115,232,1801800,1,9,27,1,82,34021082
12116,12,1801800,2,9,27,1,94,34021094
12117,23,1801600,1,9,27,1,117,34021117
12118,121,1801700,1,9,27,1,238,34021238
12119,2,1801700,1,9,27,1,240,34021240
12120,20,1801500,2,9,27,1,260,34021260
12121,631,1801700,1,9,27,1,891,34021891
12122,243,1801600,2,9,27,2,134,34022134
12123,11,1801700,1,9,27,2,145,34022145
12124,158,1801700,1,9,27,2,303,34022303
12125,144,1801500,1,9,27,2,447,34022447
12126,530,1801400,1,9,27,2,977,34022977
12127,166,1801400,1,9,27,3,143,34023143
12128,1,1801400,1,9,27,3,144,34023144
12129,1302,1801400,1,9,27,4,446,34024446
12130,54,1801300,4,9,27,4,500,34024500
12131,42,1801200,1,9,27,4,542,34024542
12132,866,1801200,3,9,27,5,408,34025408
12133,1,1801200,3,9,27,5,409,34025409
12134,382,1801200,1,9,27,5,791,34025791
12135,173,1801200,1,9,27,5,964,34025964
12136,951,1801200,2,9,27,6,915,34026915
12137,431,1801300,1,9,27,7,346,34027346
12138,994,1801500,2,9,27,8,340,34028340
12139,1267,1801400,1,9,27,9,607,34029607
12140,1150,1801700,6,9,27,10,757,34030757
12141,330,1801800,1,9,27,11,87,34031087
12142,440,1801900,6,9,27,11,527,34031527
12143,26,1802000,4,9,27,11,553,34031553
12144,0,1802000,2,9,27,11,553,34031553
12145,219,1802000,1,9,27,11,772,34031772
12146,495,1802100,1,9,27,12,267,34032267
12147,196,1802100,1,9,27,12,463,34032463
12148,326,1802100,1,9,27,12,789,34032789
12149,59,1802100,1,9,27,12,848,34032848
12150,674,1802100,1,9,27,13,522,34033522
12151,169,1802200,11,9,27,13,691,34033691
12152,17,1802200,1,9,27,13,708,34033708
12153,171,1802100,14,9,27,13,879,34033879
12154,0,1802100,14,9,27,13,879,34033879
12155,0,1802100,14,9,27,13,879,34033879
12156,0,1802100,14,9,27,13,879,34033879
12158,10,1801800,5,9,27,13,889,34033889
12159,32,1801800,3,9,27,13,921,34033921
12160,1,1801700,2,9,27,13,922,34033922
12161,0,1801900,6,9,27,13,922,34033922
12163,1,1801800,1,9,27,13,923,34033923
12164,66,1801900,1,9,27,13,989,34033989
12165,5,1801900,1,9,27,13,994,34033994
12166,33,1801900,1,9,27,14,27,34034027
12167,27,1801800,1,9,27,14,54,34034054
12168,4,1801900,1,9,27,14,58,34034058
12169,60,1801800,1,9,27,14,118,34034118
12170,63,1801800,1,9,27,14,181,34034181
12171,64,1801700,1,9,27,14,245,34034245
12172,31,1801900,1,9,27,14,276,34034276
12173,17,1801700,1,9,27,14,293,34034293
12174,49,1801700,1,9,27,14,342,34034342
12175,51,1801700,2,9,27,14,393,34034393
12176,53,1801900,1,9,27,14,446,34034446
12177,494,1801700,2,9,27,14,940,34034940
12178,343,1801800,1,9,27,15,283,34035283
12179,1262,1801900,1,9,27,16,545,34036545
12180,1248,1801800,1,9,27,17,793,34037793
12181,1426,1801800,1,9,27,19,219,34039219
12182,0,1801800,1,9,27,19,219,34039219
12183,0,1801800,1,9,27,19,219,34039219
12185,2,1801500,4,9,27,19,221,34039221
12186,0,1801500,3,9,27,19,221,34039221
12187,0,1801500,5,9,27,19,221,34039221
12188,0,1801500,3,9,27,19,221,34039221
12189,3,1801500,1,9,27,19,224,34039224
12190,0,1801500,1,9,27,19,224,34039224
12191,1,1801500,10,9,27,19,225,34039225
12192,1,1801500,1,9,27,19,226,34039226
12193,6,1801500,2,9,27,19,232,34039232
12194,100,1801500,4,9,27,19,332,34039332
12195,166,1801500,1,9,27,19,498,34039498
12196,1,1801400,1,9,27,19,499,34039499
12197,64,1801400,1,9,27,19,563,34039563
12198,65,1801400,1,9,27,19,628,34039628
12199,45,1801500,2,9,27,19,673,34039673
12200,22,1801400,1,9,27,19,695,34039695
12201,31,1801400,1,9,27,19,726,34039726
12202,0,1801400,1,9,27,19,726,34039726
12203,2,1801300,1,9,27,19,728,34039728
12204,65,1801300,1,9,27,19,793,34039793
12205,44,1801200,3,9,27,19,837,34039837
12206,1,1801200,1,9,27,19,838,34039838
12207,38,1801200,1,9,27,19,876,34039876
12208,43,1801200,1,9,27,19,919,34039919
12209,67,1801100,1,9,27,19,986,34039986
12210,31,1801100,1,9,27,20,17,34040017
12211,65,1801100,1,9,27,20,82,34040082
12212,64,1801100,1,9,27,20,146,34040146
12213,60,1801100,1,9,27,20,206,34040206
12214,1,1801100,1,9,27,20,207,34040207
12215,63,1801100,1,9,27,20,270,34040270
12216,27,1801100,2,9,27,20,297,34040297
12217,46,1801200,2,9,27,20,343,34040343
12218,945,1801200,2,9,27,21,288,34041288
12219,564,1801100,1,9,27,21,852,34041852
12220,915,1801100,1,9,27,22,767,34042767
12222,3,1801000,1,9,27,22,770,34042770
12223,0,1801000,15,9,27,22,770,34042770
12224,0,1801000,4,9,27,22,770,34042770
12225,85,1800900,1,9,27,22,855,34042855
12226,0,1800900,5,9,27,22,855,34042855
12227,1,1800900,14,9,27,22,856,34042856
12228,3,1800800,1,9,27,22,859,34042859
12229,27,1800800,1,9,27,22,886,34042886
12230,41,1800900,1,9,27,22,927,34042927
12231,37,1800900,2,9,27,22,964,34042964
12232,19,1800800,1,9,27,22,983,34042983
12233,42,1800800,2,9,27,23,25,34043025
12234,73,1800800,2,9,27,23,98,34043098
12235,16,1800800,2,9,27,23,114,34043114
12236,17,1800800,1,9,27,23,131,34043131
12237,35,1800900,2,9,27,23,166,34043166
12238,265,1801000,1,9,27,23,431,34043431
12239,86,1800900,1,9,27,23,517,34043517
12240,1,1800800,1,9,27,23,518,34043518
12241,394,1801000,1,9,27,23,912,34043912
12242,536,1800900,1,9,27,24,448,34044448
12243,761,1800800,4,9,27,25,209,34045209
12244,0,1800800,3,9,27,25,209,34045209
12245,163,1800800,1,9,27,25,372,34045372
12246,581,1800800,1,9,27,25,953,34045953
12247,825,1800800,1,9,27,26,778,34046778
12248,27,1800800,1,9,27,26,805,34046805
12249,0,1800800,1,9,27,26,805,34046805
12250,1,1800800,1,9,27,26,806,34046806
12251,140,1800800,1,9,27,26,946,34046946
12252,387,1800800,1,9,27,27,333,34047333
12253,60,1800800,1,9,27,27,393,34047393
12254,44,1800800,1,9,27,27,437,34047437
12255,277,1800700,11,9,27,27,714,34047714
12256,0,1800700,1,9,27,27,714,34047714
12257,1,1800700,1,9,27,27,715,34047715
12258,0,1800700,7,9,27,27,715,34047715
12259,9,1800600,15,9,27,27,724,34047724
12260,6,1800500,1,9,27,27,730,34047730
12261,4,1800500,9,9,27,27,734,34047734
12262,0,1800500,1,9,27,27,734,34047734
12263,0,1800500,3,9,27,27,734,34047734
12264,0,1800500,4,9,27,27,734,34047734
12265,0,1800400,1,9,27,27,734,34047734
12266,5,1800500,1,9,27,27,739,34047739
12267,19,1800400,2,9,27,27,758,34047758
12268,18,1800400,2,9,27,27,776,34047776
12269,9,1800500,1,9,27,27,785,34047785
12270,8,1800500,1,9,27,27,793,34047793
12271,12,1800300,2,9,27,27,805,34047805
12272,10,1800300,2,9,27,27,815,34047815
12273,47,1800300,1,9,27,27,862,34047862
12274,5,1800300,1,9,27,27,867,34047867
12275,6,1800300,4,9,27,27,873,34047873
12276,12,1800300,2,9,27,27,885,34047885
12277,6,1800300,1,9,27,27,891,34047891
12278,19,1800400,1,9,27,27,910,34047910
12279,18,1800300,1,9,27,27,928,34047928
12280,2,1800300,1,9,27,27,930,34047930
12281,15,1800400,1,9,27,27,945,34047945
12282,4,1800300,2,9,27,27,949,34047949
12283,1,1800200,1,9,27,27,950,34047950
12284,1,1800300,1,9,27,27,951,34047951
12286,10,1800200,1,9,27,27,961,34047961
12287,38,1800300,1,9,27,27,999,34047999
12288,21,1800200,2,9,27,28,20,34048020
12289,7,1800200,5,9,27,28,27,34048027
12290,2,1800200,1,9,27,28,29,34048029
12291,22,1800200,1,9,27,28,51,34048051
12292,47,1800200,1,9,27,28,98,34048098
12293,14,1800400,2,9,27,28,112,34048112
12294,43,1800200,6,9,27,28,155,34048155
12296,1,1800300,1,9,27,28,156,34048156
12297,86,1800300,2,9,27,28,242,34048242
12298,5,1800200,1,9,27,28,247,34048247
12299,84,1800300,1,9,27,28,331,34048331
12300,65,1800300,1,9,27,28,396,34048396
12301,7,1800500,1,9,27,28,403,34048403
12302,39,1800300,1,9,27,28,442,34048442
12303,13,1800500,1,9,27,28,455,34048455
12304,307,1800500,1,9,27,28,762,34048762
12305,58,1800600,1,9,27,28,820,34048820
12306,46,1800600,1,9,27,28,866,34048866
12307,726,1800600,3,9,27,29,592,34049592
12308,0,1800600,3,9,27,29,592,34049592
12310,5,1800800,2,9,27,29,597,34049597
12311,671,1800800,1,9,27,30,268,34050268
12312,661,1800800,1,9,27,30,929,34050929
12313,1041,1800700,1,9,27,31,970,34051970
12314,98,1800700,3,9,27,32,68,34052068
12315,93,1800700,1,9,27,32,161,34052161
12316,67,1800800,2,9,27,32,228,34052228
12317,494,1800900,1,9,27,32,722,34052722
12318,0,1800900,4,9,27,32,722,34052722
12319,364,1800900,1,9,27,33,86,34053086
12320,219,1800900,1,9,27,33,305,34053305
12321,580,1800800,1,9,27,33,885,34053885
12322,24,1800700,1,9,27,33,909,34053909
12323,108,1800800,1,9,27,34,17,34054017
12324,410,1800700,1,9,27,34,427,34054427
12325,180,1800800,1,9,27,34,607,34054607
12326,793,1800800,1,9,27,35,400,34055400
12327,82,1800800,1,9,27,35,482,34055482
12328,152,1800900,1,9,27,35,634,34055634
12329,167,1800900,1,9,27,35,801,34055801
12330,256,1800800,1,9,27,36,57,34056057
12331,9,1800800,1,9,27,36,66,34056066
12332,1468,1800800,1,9,27,37,534,34057534
12333,500,1800700,1,9,27,38,34,34058034
12334,131,1800800,1,9,27,38,165,34058165
12335,369,1800800,1,9,27,38,534,34058534
12336,111,1800700,4,9,27,38,645,34058645
12337,729,1800800,1,9,27,39,374,34059374
12338,204,1800900,4,9,27,39,578,34059578
12339,88,1800900,1,9,27,39,666,34059666
12341,1899,1800900,1,9,27,41,565,34061565
12342,782,1800900,1,9,27,42,347,34062347
12343,157,1800800,1,9,27,42,504,34062504
12344,722,1801000,3,9,27,43,226,34063226
12345,11,1800900,1,9,27,43,237,34063237
12346,241,1801000,1,9,27,43,478,34063478
12347,94,1800900,1,9,27,43,572,34063572
12348,63,1801100,2,9,27,43,635,34063635
12349,297,1801000,1,9,27,43,932,34063932
12350,83,1801200,1,9,27,44,15,34064015
12351,948,1801200,1,9,27,44,963,34064963
12352,302,1801200,1,9,27,45,265,34065265
12353,13,1801100,1,9,27,45,278,34065278
12354,109,1801100,1,9,27,45,387,34065387
12355,1,1801100,1,9,27,45,388,34065388
12356,32,1801200,1,9,27,45,420,34065420
12357,119,1801000,1,9,27,45,539,34065539
12358,10,1800900,1,9,27,45,549,34065549
12359,2195,1801000,2,9,27,47,744,34067744
12360,188,1801000,1,9,27,47,932,34067932
12361,410,1801000,1,9,27,48,342,34068342
12362,480,1800900,1,9,27,48,822,34068822
12363,1505,1801000,1,9,27,50,327,34070327
12364,0,1801000,1,9,27,50,327,34070327
12365,1933,1801000,1,9,27,52,260,34072260
12366,1,1801100,2,9,27,52,261,34072261
12367,300,1801200,1,9,27,52,561,34072561
12368,56,1801200,7,9,27,52,617,34072617
12370,226,1801100,1,9,27,52,843,34072843
12371,266,1801000,1,9,27,53,109,34073109
12372,718,1801100,2,9,27,53,827,34073827
12373,1132,1801100,1,9,27,54,959,34074959
12374,1293,1801300,4,9,27,56,252,34076252
12375,1,1801300,1,9,27,56,253,34076253
12376,150,1801300,1,9,27,56,403,34076403
12377,0,1801300,1,9,27,56,403,34076403
12378,84,1801200,1,9,27,56,487,34076487
12380,134,1801100,1,9,27,56,621,34076621
12381,176,1801200,1,9,27,56,797,34076797
12382,758,1801300,5,9,27,57,555,34077555
12384,313,1801100,1,9,27,57,868,34077868
12385,173,1801200,1,9,27,58,41,34078041
12386,349,1801100,1,9,27,58,390,34078390
12387,744,1801300,1,9,27,59,134,34079134
12388,136,1801300,1,9,27,59,270,34079270
12389,1064,1801300,1,9,28,0,334,34080334
12390,743,1801300,1,9,28,1,77,34081077
12391,33,1801300,1,9,28,1,110,34081110
12392,97,1801200,3,9,28,1,207,34081207
12393,1080,1801300,1,9,28,2,287,34082287
12394,4,1801300,1,9,28,2,291,34082291
12395,534,1801400,7,9,28,2,825,34082825
12396,536,1801300,1,9,28,3,361,34083361
12397,1240,1801400,1,9,28,4,601,34084601
12398,89,1801300,1,9,28,4,690,34084690
12399,169,1801500,1,9,28,4,859,34084859
12400,587,1801300,2,9,28,5,446,34085446
12401,206,1801400,1,9,28,5,652,34085652
12402,301,1801300,1,9,28,5,953,34085953
12403,184,1801400,1,9,28,6,137,34086137
12404,1211,1801400,4,9,28,7,348,34087348
12405,1052,1801300,1,9,28,8,400,34088400
12406,80,1801300,1,9,28,8,480,34088480
12407,690,1801200,4,9,28,9,170,34089170
12408,1,1801200,1,9,28,9,171,34089171
12409,1403,1801300,1,9,28,10,574,34090574
12410,429,1801200,1,9,28,11,3,34091003
12411,1284,1801200,1,9,28,12,287,34092287
12412,292,1801200,1,9,28,12,579,34092579
12413,120,1801300,3,9,28,12,699,34092699
12414,0,1801300,2,9,28,12,699,34092699
12415,0,1801300,1,9,28,12,699,34092699
12416,108,1801400,1,9,28,12,807,34092807
12417,613,1801300,3,9,28,13,420,34093420
12419,1060,1801300,1,9,28,14,480,34094480
12420,441,1801300,1,9,28,14,921,34094921
12421,0,1801300,1,9,28,14,921,34094921
12423,646,1801300,1,9,28,15,567,34095567
12424,61,1801300,1,9,28,15,628,34095628
12425,211,1801300,1,9,28,15,839,34095839
12426,62,1801400,1,9,28,15,901,34095901
12427,557,1801300,1,9,28,16,458,34096458
12428,2635,1801300,1,9,28,19,93,34099093
12429,3572,1801300,1,9,28,22,665,34102665
12430,374,1801300,1,9,28,23,39,34103039
12431,79,1801400,1,9,28,23,118,34103118
12432,196,1801300,1,9,28,23,314,34103314
12433,510,1801300,2,9,28,23,824,34103824
12434,1,1801300,1,9,28,23,825,34103825
12435,343,1801400,1,9,28,24,168,34104168
12436,708,1801200,1,9,28,24,876,34104876
12437,98,1801300,1,9,28,24,974,34104974
12438,141,1801200,3,9,28,25,115,34105115
12439,91,1801100,4,9,28,25,206,34105206
12440,0,1801100,2,9,28,25,206,34105206
12441,330,1801000,1,9,28,25,536,34105536
12442,65,1801000,1,9,28,25,601,34105601
12443,64,1801000,1,9,28,25,665,34105665
12444,227,1801000,13,9,28,25,892,34105892
12445,359,1801000,1,9,28,26,251,34106251
12446,106,1800900,1,9,28,26,357,34106357
12447,203,1800900,1,9,28,26,560,34106560
12448,8,1800900,2,9,28,26,568,34106568
12449,2,1800900,1,9,28,26,570,34106570
12450,14,1800900,1,9,28,26,584,34106584
12451,10,1800900,1,9,28,26,594,34106594
12452,0,1800900,3,9,28,26,594,34106594
12453,288,1800900,2,9,28,26,882,34106882
12454,1520,1800900,1,9,28,28,402,34108402
12455,213,1801000,1,9,28,28,615,34108615
12456,115,1801000,1,9,28,28,730,34108730
12457,3,1801000,1,9,28,28,733,34108733
12458,62,1801000,1,9,28,28,795,34108795
12459,181,1800900,1,9,28,28,976,34108976
12460,95,1801100,5,9,28,29,71,34109071
12461,111,1800900,1,9,28,29,182,34109182
12462,662,1801100,6,9,28,29,844,34109844
12463,2,1801200,2,9,28,29,846,34109846
12464,88,1801300,1,9,28,29,934,34109934
12465,606,1801300,1,9,28,30,540,34110540
12466,182,1801300,1,9,28,30,722,34110722
12467,1157,1801400,1,9,28,31,879,34111879
12468,10,1801200,1,9,28,31,889,34111889
12469,537,1801200,3,9,28,32,426,34112426
12470,361,1801200,1,9,28,32,787,34112787
12471,482,1801300,1,9,28,33,269,34113269
12472,386,1801200,1,9,28,33,655,34113655
12473,808,1801200,2,9,28,34,463,34114463
12474,554,1801300,2,9,28,35,17,34115017
12475,1410,1801300,1,9,28,36,427,34116427
12476,251,1801300,1,9,28,36,678,34116678
12477,1259,1801300,1,9,28,37,937,34117937
12478,1221,1801300,1,9,28,39,158,34119158
12479,456,1801300,1,9,28,39,614,34119614
12480,1476,1801300,1,9,28,41,90,34121090
12481,1426,1801300,1,9,28,42,516,34122516
12482,90,1801300,2,9,28,42,606,34122606
12483,1633,1801200,1,9,28,44,239,34124239
12484,2340,1801300,3,9,28,46,579,34126579
12485,55,1801400,1,9,28,46,634,34126634
12486,872,1801400,1,9,28,47,506,34127506
12487,0,1801400,2,9,28,47,506,34127506
12488,0,1801400,6,9,28,47,506,34127506
12489,0,1801400,2,9,28,47,506,34127506
12490,172,1801400,1,9,28,47,678,34127678
12491,1656,1801300,2,9,28,49,334,34129334
12492,920,1801400,1,9,28,50,254,34130254
12493,1507,1801400,1,9,28,51,761,34131761
12494,243,1801200,1,9,28,52,4,34132004
12495,123,1801200,1,9,28,52,127,34132127
12496,191,1801400,3,9,28,52,318,34132318
12497,1218,1801400,1,9,28,53,536,34133536
12498,469,1801300,1,9,28,54,5,34134005
12499,3482,1801400,1,9,28,57,487,34137487
12500,47,1801500,5,9,28,57,534,34137534
12501,0,1801500,7,9,28,57,534,34137534
12502,0,1801500,1,9,28,57,534,34137534
12503,0,1801500,1,9,28,57,534,34137534
12504,0,1801500,5,9,28,57,534,34137534
12505,504,1801500,2,9,28,58,38,34138038
12506,149,1801500,1,9,28,58,187,34138187
12507,87,1801400,1,9,28,58,274,34138274
12508,81,1801600,2,9,28,58,355,34138355
12509,131,1801600,2,9,28,58,486,34138486
12510,572,1801500,1,9,28,59,58,34139058
12511,332,1801600,1,9,28,59,390,34139390
12512,1,1801600,1,9,28,59,391,34139391
12513,702,1801500,1,9,29,0,93,34140093
12514,743,1801600,2,9,29,0,836,34140836
12515,720,1801600,1,9,29,1,556,34141556
12516,466,1801600,1,9,29,2,22,34142022
12517,398,1801600,1,9,29,2,420,34142420
12518,103,1801600,2,9,29,2,523,34142523
12519,549,1801500,1,9,29,3,72,34143072
12520,362,1801600,2,9,29,3,434,34143434
12521,1186,1801600,1,9,29,4,620,34144620
12522,735,1801600,1,9,29,5,355,34145355
12523,563,1801600,1,9,29,5,918,34145918
12524,369,1801700,2,9,29,6,287,34146287
12525,106,1801700,2,9,29,6,393,34146393
12526,1,1801700,3,9,29,6,394,34146394
12527,0,1801700,4,9,29,6,394,34146394
12528,183,1801600,1,9,29,6,577,34146577
12529,85,1801800,1,9,29,6,662,34146662
12530,75,1801700,1,9,29,6,737,34146737
12531,192,1801600,1,9,29,6,929,34146929
12532,26,1801700,1,9,29,6,955,34146955
12533,586,1801600,1,9,29,7,541,34147541
12534,710,1801600,1,9,29,8,251,34148251
12535,2924,1801700,1,9,29,11,175,34151175
12536,187,1801600,1,9,29,11,362,34151362
12537,1775,1801600,2,9,29,13,137,34153137
12538,447,1801600,1,9,29,13,584,34153584
12539,77,1801500,2,9,29,13,661,34153661
12540,626,1801500,1,9,29,14,287,34154287
12541,0,1801500,1,9,29,14,287,34154287
12542,0,1801500,3,9,29,14,287,34154287
12543,438,1801500,1,9,29,14,725,34154725
12544,599,1801400,1,9,29,15,324,34155324
12545,1050,1801300,1,9,29,16,374,34156374
12546,1041,1801400,1,9,29,17,415,34157415
12547,397,1801400,1,9,29,17,812,34157812
12548,566,1801500,3,9,29,18,378,34158378
12549,0,1801500,1,9,29,18,378,34158378
12550,688,1801500,1,9,29,19,66,34159066
12551,48,1801500,2,9,29,19,114,34159114
12552,679,1801700,5,9,29,19,793,34159793
12553,332,1801800,5,9,29,20,125,34160125
12554,0,1801800,2,9,29,20,125,34160125
12555,0,1801800,1,9,29,20,125,34160125
12556,0,1801800,4,9,29,20,125,34160125
12557,131,1801900,1,9,29,20,256,34160256
12558,150,1801900,2,9,29,20,406,34160406
12559,89,1801700,2,9,29,20,495,34160495
12560,241,1801700,3,9,29,20,736,34160736
12561,60,1801700,1,9,29,20,796,34160796
12562,450,1801700,1,9,29,21,246,34161246
12563,130,1801700,1,9,29,21,376,34161376
12564,976,1801800,1,9,29,22,352,34162352
12565,269,1801900,1,9,29,22,621,34162621
12566,860,1801800,1,9,29,23,481,34163481
12567,2383,1801900,1,9,29,25,864,34165864
12568,0,1801900,11,9,29,25,864,34165864
12569,1,1802000,1,9,29,25,865,34165865
12570,115,1802000,1,9,29,25,980,34165980
12571,5,1802000,1,9,29,25,985,34165985
12572,63,1801900,1,9,29,26,48,34166048
12573,12,1802000,2,9,29,26,60,34166060
12574,63,1801800,1,9,29,26,123,34166123
12575,116,1801800,1,9,29,26,239,34166239
12576,404,1802000,1,9,29,26,643,34166643
12577,143,1801800,1,9,29,26,786,34166786
12578,169,1801800,1,9,29,26,955,34166955
12579,69,1802000,10,9,29,27,24,34167024
12580,6,1802000,2,9,29,27,30,34167030
12581,247,1802100,1,9,29,27,277,34167277
12582,76,1802100,1,9,29,27,353,34167353
12583,227,1801900,1,9,29,27,580,34167580
12584,166,1802100,2,9,29,27,746,34167746
12585,369,1801900,1,9,29,28,115,34168115
12586,32,1801900,1,9,29,28,147,34168147
12587,57,1802000,2,9,29,28,204,34168204
12588,1015,1802100,2,9,29,29,219,34169219
12589,39,1802100,5,9,29,29,258,34169258
12590,113,1802200,14,9,29,29,371,34169371
12591,211,1802100,1,9,29,29,582,34169582
12592,144,1802300,1,9,29,29,726,34169726
12593,84,1802200,1,9,29,29,810,34169810
12594,29,1802300,12,9,29,29,839,34169839
12595,47,1802300,1,9,29,29,886,34169886
12596,0,1802400,23,9,29,29,886,34169886
12597,159,1802500,2,9,29,30,45,34170045
12598,89,1802500,1,9,29,30,134,34170134
12599,3,1802400,1,9,29,30,137,34170137
12600,120,1802400,1,9,29,30,257,34170257
12601,41,1802400,1,9,29,30,298,34170298
12602,4,1802500,2,9,29,30,302,34170302
12603,10,1802500,1,9,29,30,312,34170312
12604,36,1802500,3,9,29,30,348,34170348
12605,103,1802300,1,9,29,30,451,34170451
12606,152,1802500,1,9,29,30,603,34170603
12607,2,1802500,1,9,29,30,605,34170605
12608,248,1802500,1,9,29,30,853,34170853
12609,11,1802500,1,9,29,30,864,34170864
12610,212,1802400,1,9,29,31,76,34171076
12611,201,1802300,1,9,29,31,277,34171277
12612,47,1802400,1,9,29,31,324,34171324
12613,266,1802500,10,9,29,31,590,34171590
12614,233,1802400,1,9,29,31,823,34171823
12615,207,1802500,1,9,29,32,30,34172030
12616,121,1802500,3,9,29,32,151,34172151
12617,29,1802600,2,9,29,32,180,34172180
12618,44,1802500,1,9,29,32,224,34172224
12619,44,1802600,2,9,29,32,268,34172268
12620,2,1802600,2,9,29,32,270,34172270
12621,0,1802600,2,9,29,32,270,34172270
12622,178,1802500,1,9,29,32,448,34172448
12623,46,1802500,3,9,29,32,494,34172494
12625,43,1802500,1,9,29,32,537,34172537
12626,94,1802500,2,9,29,32,631,34172631
12627,99,1802500,2,9,29,32,730,34172730
12628,14,1802500,2,9,29,32,744,34172744
12629,42,1802500,1,9,29,32,786,34172786
12630,192,1802500,1,9,29,32,978,34172978
12631,208,1802500,1,9,29,33,186,34173186
12632,171,1802500,1,9,29,33,357,34173357
12633,727,1802400,1,9,29,34,84,34174084
12634,267,1802500,1,9,29,34,351,34174351
12635,32,1802400,1,9,29,34,383,34174383
12636,5,1802400,1,9,29,34,388,34174388
12637,199,1802400,1,9,29,34,587,34174587
12638,628,1802500,1,9,29,35,215,34175215
12639,121,1802400,1,9,29,35,336,34175336
12640,204,1802500,1,9,29,35,540,34175540
12641,330,1802300,2,9,29,35,870,34175870
12642,173,1802400,1,9,29,36,43,34176043
12643,289,1802400,1,9,29,36,332,34176332
12644,32,1802400,3,9,29,36,364,34176364
12645,0,1802400,3,9,29,36,364,34176364
12647,290,1802300,1,9,29,36,654,34176654
12648,631,1802400,1,9,29,37,285,34177285
12649,333,1802300,1,9,29,37,618,34177618
12650,1789,1802400,2,9,29,39,407,34179407
12651,1400,1802400,5,9,29,40,807,34180807
12652,104,1802400,9,9,29,40,911,34180911
12653,68,1802500,1,9,29,40,979,34180979
12654,4,1802500,1,9,29,40,983,34180983
12655,1,1802500,1,9,29,40,984,34180984
12656,10,1802400,1,9,29,40,994,34180994
12657,18,1802500,9,9,29,41,12,34181012
12658,31,1802600,1,9,29,41,43,34181043
12659,31,1802600,1,9,29,41,74,34181074
12660,244,1802500,1,9,29,41,318,34181318
12661,247,1802500,2,9,29,41,565,34181565
12662,30,1802400,1,9,29,41,595,34181595
12663,128,1802500,1,9,29,41,723,34181723
12664,8,1802600,5,9,29,41,731,34181731
12665,13,1802600,1,9,29,41,744,34181744
12666,501,1802400,1,9,29,42,245,34182245
12667,219,1802400,4,9,29,42,464,34182464
12669,771,1802300,1,9,29,43,235,34183235
12670,70,1802300,7,9,29,43,305,34183305
12671,29,1802300,1,9,29,43,334,34183334
12672,2,1802300,1,9,29,43,336,34183336
12673,53,1802200,2,9,29,43,389,34183389
12675,136,1802200,2,9,29,43,525,34183525
12677,114,1802200,1,9,29,43,639,34183639
12678,576,1802300,1,9,29,44,215,34184215
12679,281,1802300,1,9,29,44,496,34184496
12680,765,1802300,1,9,29,45,261,34185261
12681,609,1802300,1,9,29,45,870,34185870
12682,261,1802300,1,9,29,46,131,34186131
12683,50,1802400,1,9,29,46,181,34186181
12684,538,1802300,1,9,29,46,719,34186719
12685,602,1802300,1,9,29,47,321,34187321
12686,180,1802300,1,9,29,47,501,34187501
12687,467,1802200,1,9,29,47,968,34187968
12688,839,1802400,1,9,29,48,807,34188807
12689,737,1802200,2,9,29,49,544,34189544
12690,2182,1802200,1,9,29,51,726,34191726
12691,1027,1802200,18,9,29,52,753,34192753
12692,1,1802200,2,9,29,52,754,34192754
12693,0,1802200,5,9,29,52,754,34192754
12694,243,1802200,1,9,29,52,997,34192997
12695,1316,1802200,1,9,29,54,313,34194313
12696,487,1802300,2,9,29,54,800,34194800
12697,658,1802200,1,9,29,55,458,34195458
12698,572,1802200,1,9,29,56,30,34196030
12699,1310,1802200,1,9,29,57,340,34197340
12700,444,1802100,7,9,29,57,784,34197784
12701,374,1802100,2,9,29,58,158,34198158
12702,198,1802100,1,9,29,58,356,34198356
12703,1528,1802100,1,9,29,59,884,34199884
12704,197,1802200,1,9,30,0,81,34200081
12705,27,1802200,2,9,30,0,108,34200108
12706,1,1802200,1,9,30,0,109,34200109
12707,0,1802200,1,9,30,0,109,34200109
12708,0,1802300,1,9,30,0,109,34200109
12709,0,1802300,1,9,30,0,109,34200109
12710,0,1802300,1,9,30,0,109,34200109
12711,1,1802300,1,9,30,0,110,34200110
12712,376,1802100,3,9,30,0,486,34200486
12713,20,1802200,1,9,30,0,506,34200506
12714,78,1802200,1,9,30,0,584,34200584
12715,10,1802200,1,9,30,0,594,34200594
12716,58,1802200,1,9,30,0,652,34200652
12717,23,1802200,4,9,30,0,675,34200675
12719,3,1802200,1,9,30,0,678,34200678
12720,16,1802300,1,9,30,0,694,34200694
12721,65,1802300,1,9,30,0,759,34200759
12722,299,1802200,1,9,30,1,58,34201058
12723,200,1802100,2,9,30,1,258,34201258
12724,37,1802300,1,9,30,1,295,34201295
12725,103,1802300,1,9,30,1,398,34201398
12726,122,1802100,1,9,30,1,520,34201520
12727,85,1802000,1,9,30,1,605,34201605
12728,127,1802200,1,9,30,1,732,34201732
12729,165,1802200,2,9,30,1,897,34201897
12730,18,1802300,1,9,30,1,915,34201915
12731,44,1802100,1,9,30,1,959,34201959
12732,215,1802200,1,9,30,2,174,34202174
12733,348,1802100,1,9,30,2,522,34202522
12734,271,1802300,2,9,30,2,793,34202793
12735,115,1802100,1,9,30,2,908,34202908
12736,415,1802100,5,9,30,3,323,34203323
12737,271,1802100,1,9,30,3,594,34203594
12738,39,1802000,21,9,30,3,633,34203633
12739,40,1801900,5,9,30,3,673,34203673
12740,755,1802000,1,9,30,4,428,34204428
12741,181,1802000,1,9,30,4,609,34204609
12742,15,1802000,3,9,30,4,624,34204624
12743,40,1801800,1,9,30,4,664,34204664
12744,23,1801800,1,9,30,4,687,34204687
12745,333,1801800,1,9,30,5,20,34205020
12746,778,1801800,1,9,30,5,798,34205798
12747,40,1802000,2,9,30,5,838,34205838
12748,1642,1802000,1,9,30,7,480,34207480
12749,75,1801800,1,9,30,7,555,34207555
12750,165,1801900,1,9,30,7,720,34207720
12751,259,1802000,3,9,30,7,979,34207979
12752,614,1801800,1,9,30,8,593,34208593
12753,7,1801900,1,9,30,8,600,34208600
12754,1,1801900,1,9,30,8,601,34208601
12755,1153,1802000,1,9,30,9,754,34209754
12756,317,1801900,1,9,30,10,71,34210071
12757,2045,1801800,1,9,30,12,116,34212116
12758,357,1801900,1,9,30,12,473,34212473
12759,170,1801900,2,9,30,12,643,34212643
12760,76,1801800,1,9,30,12,719,34212719
12761,197,1801800,1,9,30,12,916,34212916
12762,614,1801900,1,9,30,13,530,34213530
12763,2767,1801800,5,9,30,16,297,34216297
12764,449,1802000,1,9,30,16,746,34216746
12765,1166,1801800,1,9,30,17,912,34217912
12766,64,1801900,1,9,30,17,976,34217976
12767,0,1802000,1,9,30,17,976,34217976
12768,610,1802000,15,9,30,18,586,34218586
12769,2,1802100,2,9,30,18,588,34218588
12770,160,1802100,1,9,30,18,748,34218748
12771,39,1802100,3,9,30,18,787,34218787
12773,740,1802200,1,9,30,19,527,34219527
12774,770,1802100,1,9,30,20,297,34220297
12775,128,1802100,1,9,30,20,425,34220425
12776,65,1802200,1,9,30,20,490,34220490
12777,1763,1802100,1,9,30,22,253,34222253
12778,168,1802200,1,9,30,22,421,34222421
12779,291,1802100,2,9,30,22,712,34222712
12780,846,1802000,30,9,30,23,558,34223558
12781,1,1802000,2,9,30,23,559,34223559
12782,0,1802000,1,9,30,23,559,34223559
12783,0,1802000,1,9,30,23,559,34223559
12784,0,1802000,1,9,30,23,559,34223559
12785,0,1802000,2,9,30,23,559,34223559
12786,1,1802000,1,9,30,23,560,34223560
12787,0,1802000,1,9,30,23,560,34223560
12788,14,1802000,1,9,30,23,574,34223574
12789,0,1802000,1,9,30,23,574,34223574
12790,1098,1802000,1,9,30,24,672,34224672
12791,228,1802100,1,9,30,24,900,34224900
12792,15,1802100,1,9,30,24,915,34224915
12793,208,1802000,1,9,30,25,123,34225123
12794,753,1802100,2,9,30,25,876,34225876
12795,163,1802000,1,9,30,26,39,34226039
12796,332,1802100,1,9,30,26,371,34226371
12797,118,1802200,3,9,30,26,489,34226489
12798,925,1802300,1,9,30,27,414,34227414
12799,3326,1802300,5,9,30,30,740,34230740
12800,139,1802300,1,9,30,30,879,34230879
12801,1789,1802200,1,9,30,32,668,34232668
12802,0,1802200,2,9,30,32,668,34232668
12803,6,1802200,1,9,30,32,674,34232674
12804,700,1802000,1,9,30,33,374,34233374
12805,2138,1802200,1,9,30,35,512,34235512
12806,967,1802200,2,9,30,36,479,34236479
12807,481,1802100,1,9,30,36,960,34236960
12808,181,1802000,1,9,30,37,141,34237141
12809,84,1802200,1,9,30,37,225,34237225
12810,2355,1802200,2,9,30,39,580,34239580
12811,293,1802100,1,9,30,39,873,34239873
12812,121,1802200,1,9,30,39,994,34239994
12813,67,1802200,3,9,30,40,61,34240061
12814,84,1802300,5,9,30,40,145,34240145
12815,1,1802300,2,9,30,40,146,34240146
12816,0,1802300,3,9,30,40,146,34240146
12817,17,1802300,1,9,30,40,163,34240163
12818,994,1802300,1,9,30,41,157,34241157
12819,652,1802300,2,9,30,41,809,34241809
12820,859,1802300,3,9,30,42,668,34242668
12821,390,1802300,2,9,30,43,58,34243058
12822,628,1802300,1,9,30,43,686,34243686
12823,306,1802400,65,9,30,43,992,34243992
12824,1,1802500,21,9,30,43,993,34243993
12825,1,1802500,3,9,30,43,994,34243994
12826,5,1802600,2,9,30,43,999,34243999
12827,35,1802600,5,9,30,44,34,34244034
12828,175,1802700,1,9,30,44,209,34244209
12829,0,1802700,1,9,30,44,209,34244209
12830,0,1802700,1,9,30,44,209,34244209
12831,40,1802700,4,9,30,44,249,34244249
12832,0,1802700,1,9,30,44,249,34244249
12833,2,1802700,2,9,30,44,251,34244251
12834,29,1802700,2,9,30,44,280,34244280
12835,11,1802700,5,9,30,44,291,34244291
12836,1,1802700,1,9,30,44,292,34244292
12837,0,1802700,2,9,30,44,292,34244292
12838,0,1802700,1,9,30,44,292,34244292
12839,11,1802800,2,9,30,44,303,34244303
12840,1,1802700,1,9,30,44,304,34244304
12841,1,1802800,2,9,30,44,305,34244305
12842,3,1802700,1,9,30,44,308,34244308
12843,8,1802800,3,9,30,44,316,34244316
12844,19,1802700,1,9,30,44,335,34244335
12845,11,1802800,2,9,30,44,346,34244346
12846,21,1802800,4,9,30,44,367,34244367
12847,13,1802800,1,9,30,44,380,34244380
12848,31,1802800,1,9,30,44,411,34244411
12849,77,1802800,3,9,30,44,488,34244488
12850,134,1802700,1,9,30,44,622,34244622
12851,24,1802800,1,9,30,44,646,34244646
12852,9,1802800,1,9,30,44,655,34244655
12853,8,1802700,1,9,30,44,663,34244663
12854,256,1802700,1,9,30,44,919,34244919
12855,836,1802700,1,9,30,45,755,34245755
12856,171,1802700,1,9,30,45,926,34245926
12857,222,1802800,1,9,30,46,148,34246148
12858,61,1802800,1,9,30,46,209,34246209
12859,419,1802800,1,9,30,46,628,34246628
12860,60,1802800,1,9,30,46,688,34246688
12861,102,1802700,1,9,30,46,790,34246790
12862,456,1802800,4,9,30,47,246,34247246
12863,259,1802800,5,9,30,47,505,34247505
12864,422,1802800,2,9,30,47,927,34247927
12865,77,1802800,1,9,30,48,4,34248004
12866,58,1802800,1,9,30,48,62,34248062
12867,169,1802700,1,9,30,48,231,34248231
12868,62,1802700,1,9,30,48,293,34248293
12869,325,1802800,1,9,30,48,618,34248618
12870,120,1802800,4,9,30,48,738,34248738
12872,425,1802800,1,9,30,49,163,34249163
12873,57,1802800,2,9,30,49,220,34249220
12874,223,1802900,1,9,30,49,443,34249443
12875,21,1802900,1,9,30,49,464,34249464
12876,26,1802900,1,9,30,49,490,34249490
12877,29,1802900,1,9,30,49,519,34249519
12878,614,1802900,1,9,30,50,133,34250133
12879,276,1802900,1,9,30,50,409,34250409
12880,168,1802900,1,9,30,50,577,34250577
12881,50,1802900,1,9,30,50,627,34250627
12882,54,1803000,3,9,30,50,681,34250681
12883,96,1803000,33,9,30,50,777,34250777
12885,3,1803100,2,9,30,50,780,34250780
12886,0,1803100,8,9,30,50,780,34250780
12888,1,1803200,2,9,30,50,781,34250781
12889,0,1803200,2,9,30,50,781,34250781
12890,1,1803200,20,9,30,50,782,34250782
12891,1,1803200,1,9,30,50,783,34250783
12892,20,1803300,1,9,30,50,803,34250803
12893,0,1803300,1,9,30,50,803,34250803
12894,1,1803300,1,9,30,50,804,34250804
12895,0,1803200,1,9,30,50,804,34250804
12896,45,1803300,1,9,30,50,849,34250849
12897,0,1803300,1,9,30,50,849,34250849
12898,6,1803300,2,9,30,50,855,34250855
12899,36,1803300,20,9,30,50,891,34250891
12900,2,1803300,1,9,30,50,893,34250893
12901,1,1803300,12,9,30,50,894,34250894
12902,1,1803300,8,9,30,50,895,34250895
12903,0,1803300,1,9,30,50,895,34250895
12904,0,1803300,2,9,30,50,895,34250895
12905,0,1803300,8,9,30,50,895,34250895
12906,0,1803300,1,9,30,50,895,34250895
12907,0,1803300,1,9,30,50,895,34250895
12908,1,1803300,1,9,30,50,896,34250896
12909,0,1803300,1,9,30,50,896,34250896
12910,0,1803300,1,9,30,50,896,34250896
12911,0,1803300,1,9,30,50,896,34250896
12912,6,1803300,1,9,30,50,902,34250902
12913,3,1803300,1,9,30,50,905,34250905
12914,8,1803300,1,9,30,50,913,34250913
12915,6,1803300,4,9,30,50,919,34250919
12917,2,1803400,5,9,30,50,921,34250921
12918,6,1803400,1,9,30,50,927,34250927
12919,0,1803400,2,9,30,50,927,34250927
12920,8,1803400,1,9,30,50,935,34250935
12921,9,1803400,2,9,30,50,944,34250944
12922,4,1803400,1,9,30,50,948,34250948
12923,2,1803400,2,9,30,50,950,34250950
12924,3,1803400,5,9,30,50,953,34250953
12925,10,1803400,1,9,30,50,963,34250963
12926,9,1803300,1,9,30,50,972,34250972
12927,3,1803300,3,9,30,50,975,34250975
12929,7,1803300,2,9,30,50,982,34250982
12930,6,1803300,1,9,30,50,988,34250988
12931,13,1803300,1,9,30,51,1,34251001
12932,3,1803300,1,9,30,51,4,34251004
12933,1,1803200,1,9,30,51,5,34251005
12934,1,1803300,1,9,30,51,6,34251006
12935,3,1803200,2,9,30,51,9,34251009
12936,5,1803200,1,9,30,51,14,34251014
12937,11,1803200,1,9,30,51,25,34251025
12938,1,1803200,1,9,30,51,26,34251026
12939,1,1803200,1,9,30,51,27,34251027
12940,13,1803200,1,9,30,51,40,34251040
12941,10,1803100,1,9,30,51,50,34251050
12942,0,1803100,5,9,30,51,50,34251050
12943,1,1803200,1,9,30,51,51,34251051
12944,5,1803100,2,9,30,51,56,34251056
12946,8,1803100,2,9,30,51,64,34251064
12948,5,1803100,1,9,30,51,69,34251069
12949,3,1803100,3,9,30,51,72,34251072
12951,9,1803200,1,9,30,51,81,34251081
12952,19,1803100,2,9,30,51,100,34251100
12953,2,1803000,5,9,30,51,102,34251102
12954,2,1803000,1,9,30,51,104,34251104
12955,8,1803000,2,9,30,51,112,34251112
12956,5,1803000,1,9,30,51,117,34251117
12957,21,1803000,2,9,30,51,138,34251138
12958,0,1803100,2,9,30,51,138,34251138
12959,0,1803100,1,9,30,51,138,34251138
12960,0,1803100,2,9,30,51,138,34251138
12961,3,1803100,4,9,30,51,141,34251141
12962,12,1803100,1,9,30,51,153,34251153
12963,9,1803100,1,9,30,51,162,34251162
12964,12,1802900,1,9,30,51,174,34251174
12965,9,1803100,1,9,30,51,183,34251183
12966,15,1803100,1,9,30,51,198,34251198
12967,4,1803100,1,9,30,51,202,34251202
12968,12,1803100,1,9,30,51,214,34251214
12969,7,1803100,1,9,30,51,221,34251221
12970,3,1803100,1,9,30,51,224,34251224
12971,4,1803100,1,9,30,51,228,34251228
12972,0,1803100,1,9,30,51,228,34251228
12973,1,1803100,1,9,30,51,229,34251229
12974,2,1803100,1,9,30,51,231,34251231
12975,1,1803100,1,9,30,51,232,34251232
12976,1,1803200,1,9,30,51,233,34251233
12977,8,1803100,1,9,30,51,241,34251241
12978,8,1803100,2,9,30,51,249,34251249
12979,11,1803200,4,9,30,51,260,34251260
12980,9,1803200,1,9,30,51,269,34251269
12981,0,1803200,1,9,30,51,269,34251269
12982,1,1803200,1,9,30,51,270,34251270
12983,0,1803200,1,9,30,51,270,34251270
12984,5,1803100,1,9,30,51,275,34251275
12985,3,1803100,1,9,30,51,278,34251278
12987,2,1803100,2,9,30,51,280,34251280
12989,8,1803100,2,9,30,51,288,34251288
12990,6,1803100,1,9,30,51,294,34251294
12991,2,1803100,3,9,30,51,296,34251296
12993,8,1803200,1,9,30,51,304,34251304
12994,22,1803200,1,9,30,51,326,34251326
12995,1,1803200,1,9,30,51,327,34251327
12996,18,1803100,1,9,30,51,345,34251345
12997,6,1803100,1,9,30,51,351,34251351
12998,4,1803100,1,9,30,51,355,34251355
12999,6,1803100,3,9,30,51,361,34251361
13001,4,1803200,2,9,30,51,365,34251365
13002,7,1803200,1,9,30,51,372,34251372
13003,8,1803000,4,9,30,51,380,34251380
13004,1,1803000,1,9,30,51,381,34251381
13005,1,1803100,1,9,30,51,382,34251382
13006,11,1803000,1,9,30,51,393,34251393
13007,13,1803100,3,9,30,51,406,34251406
13008,21,1803100,2,9,30,51,427,34251427
13009,3,1802900,1,9,30,51,430,34251430
13010,9,1803100,1,9,30,51,439,34251439
13011,2,1803100,4,9,30,51,441,34251441
13013,1,1803000,1,9,30,51,442,34251442
13014,30,1803100,3,9,30,51,472,34251472
13016,11,1802900,1,9,30,51,483,34251483
13017,23,1803100,1,9,30,51,506,34251506
13018,3,1803100,1,9,30,51,509,34251509
13019,6,1803100,1,9,30,51,515,34251515
13020,4,1803100,1,9,30,51,519,34251519
13021,11,1802900,1,9,30,51,530,34251530
13022,16,1803100,3,9,30,51,546,34251546
13023,23,1803100,1,9,30,51,569,34251569
13024,16,1803100,2,9,30,51,585,34251585
13025,51,1803100,2,9,30,51,636,34251636
13026,39,1802900,3,9,30,51,675,34251675
13027,44,1803000,2,9,30,51,719,34251719
13028,43,1802900,1,9,30,51,762,34251762
13029,19,1803000,1,9,30,51,781,34251781
13030,27,1803000,1,9,30,51,808,34251808
13031,5,1803000,1,9,30,51,813,34251813
13032,27,1803000,1,9,30,51,840,34251840
13033,13,1802900,1,9,30,51,853,34251853
13034,24,1802900,1,9,30,51,877,34251877
13035,11,1802900,1,9,30,51,888,34251888
13037,32,1802800,5,9,30,51,920,34251920
13038,7,1802900,1,9,30,51,927,34251927
13039,12,1802900,1,9,30,51,939,34251939
13040,1,1802900,1,9,30,51,940,34251940
13042,7,1803000,1,9,30,51,947,34251947
13043,1,1803000,1,9,30,51,948,34251948
13044,7,1802800,1,9,30,51,955,34251955
13045,2,1802900,1,9,30,51,957,34251957
13046,34,1802900,1,9,30,51,991,34251991
13047,17,1802900,1,9,30,52,8,34252008
13048,57,1802900,1,9,30,52,65,34252065
13049,17,1802900,1,9,30,52,82,34252082
13050,51,1802900,1,9,30,52,133,34252133
13051,8,1802800,1,9,30,52,141,34252141
13052,0,1802800,1,9,30,52,141,34252141
13053,96,1802900,2,9,30,52,237,34252237
13054,0,1802900,1,9,30,52,237,34252237
13055,34,1802800,2,9,30,52,271,34252271
13056,13,1802900,1,9,30,52,284,34252284
13057,19,1802900,1,9,30,52,303,34252303
13058,9,1802700,1,9,30,52,312,34252312
13059,20,1802900,1,9,30,52,332,34252332
13060,1,1802900,1,9,30,52,333,34252333
13061,33,1802700,14,9,30,52,366,34252366
13063,123,1802700,1,9,30,52,489,34252489
13064,104,1802700,1,9,30,52,593,34252593
13066,39,1802800,1,9,30,52,632,34252632
13067,66,1802700,1,9,30,52,698,34252698
13068,71,1802700,2,9,30,52,769,34252769
13070,169,1802600,2,9,30,52,938,34252938
13071,149,1802600,1,9,30,53,87,34253087
13072,100,1802600,1,9,30,53,187,34253187
13073,59,1802500,1,9,30,53,246,34253246
13075,39,1802600,1,9,30,53,285,34253285
13076,296,1802600,1,9,30,53,581,34253581
13077,126,1802600,1,9,30,53,707,34253707
13078,55,1802600,1,9,30,53,762,34253762
13079,9,1802600,1,9,30,53,771,34253771
13080,36,1802400,1,9,30,53,807,34253807
13081,150,1802400,2,9,30,53,957,34253957
13082,0,1802400,1,9,30,53,957,34253957
13083,97,1802500,1,9,30,54,54,34254054
13084,150,1802500,2,9,30,54,204,34254204
13085,161,1802400,1,9,30,54,365,34254365
13086,55,1802500,1,9,30,54,420,34254420
13087,76,1802400,1,9,30,54,496,34254496
13088,135,1802500,1,9,30,54,631,34254631
13089,94,1802300,1,9,30,54,725,34254725
13090,149,1802500,2,9,30,54,874,34254874
13091,185,1802400,1,9,30,55,59,34255059
13092,64,1802500,1,9,30,55,123,34255123
13093,28,1802500,1,9,30,55,151,34255151
13094,16,1802500,1,9,30,55,167,34255167
13095,25,1802500,1,9,30,55,192,34255192
13096,19,1802500,1,9,30,55,211,34255211
13097,796,1802500,1,9,30,56,7,34256007
13098,226,1802600,1,9,30,56,233,34256233
13099,111,1802400,5,9,30,56,344,34256344
13100,942,1802300,1,9,30,57,286,34257286
13101,359,1802300,1,9,30,57,645,34257645
13102,407,1802400,1,9,30,58,52,34258052
13103,410,1802400,1,9,30,58,462,34258462
13104,1133,1802300,1,9,30,59,595,34259595
13105,380,1802400,1,9,30,59,975,34259975
13106,33,1802400,1,9,31,0,8,34260008
13107,139,1802300,1,9,31,0,147,34260147
13108,213,1802300,1,9,31,0,360,34260360
13109,50,1802300,1,9,31,0,410,34260410
13110,332,1802300,1,9,31,0,742,34260742
13112,108,1802200,1,9,31,0,850,34260850
13113,147,1802300,6,9,31,0,997,34260997
13114,19,1802200,3,9,31,1,16,34261016
13115,75,1802400,1,9,31,1,91,34261091
13116,416,1802200,1,9,31,1,507,34261507
13117,273,1802300,1,9,31,1,780,34261780
13118,536,1802100,1,9,31,2,316,34262316
13119,261,1802100,5,9,31,2,577,34262577
13120,4,1802100,1,9,31,2,581,34262581
13121,277,1802000,1,9,31,2,858,34262858
13122,118,1802100,1,9,31,2,976,34262976
13123,19,1802100,1,9,31,2,995,34262995
13124,1,1802100,2,9,31,2,996,34262996
13125,144,1802000,10,9,31,3,140,34263140
13126,55,1802000,1,9,31,3,195,34263195
13127,464,1802000,1,9,31,3,659,34263659
13128,258,1801900,3,9,31,3,917,34263917
13130,193,1801800,5,9,31,4,110,34264110
13131,123,1801800,5,9,31,4,233,34264233
13132,1,1801800,2,9,31,4,234,34264234
13133,203,1801800,1,9,31,4,437,34264437
13134,214,1801700,1,9,31,4,651,34264651
13135,261,1801700,2,9,31,4,912,34264912
13136,272,1801600,1,9,31,5,184,34265184
13137,23,1801600,5,9,31,5,207,34265207
13138,1,1801600,1,9,31,5,208,34265208
13139,22,1801500,1,9,31,5,230,34265230
13140,4,1801500,1,9,31,5,234,34265234
13141,90,1801600,2,9,31,5,324,34265324
13142,79,1801500,1,9,31,5,403,34265403
13143,57,1801700,1,9,31,5,460,34265460
13144,0,1801700,2,9,31,5,460,34265460
13145,47,1801600,1,9,31,5,507,34265507
13146,593,1801600,1,9,31,6,100,34266100
13147,309,1801600,4,9,31,6,409,34266409
13148,65,1801600,1,9,31,6,474,34266474
13149,316,1801600,1,9,31,6,790,34266790
13150,91,1801700,2,9,31,6,881,34266881
13151,1,1801700,1,9,31,6,882,34266882
13152,264,1801700,1,9,31,7,146,34267146
13153,126,1801700,1,9,31,7,272,34267272
13154,1492,1801800,5,9,31,8,764,34268764
13155,1,1801900,2,9,31,8,765,34268765
13156,0,1801900,1,9,31,8,765,34268765
13157,0,1801900,1,9,31,8,765,34268765
13158,1,1801900,1,9,31,8,766,34268766
13159,176,1802100,2,9,31,8,942,34268942
13160,94,1802100,2,9,31,9,36,34269036
13161,74,1802100,1,9,31,9,110,34269110
13162,1526,1802100,2,9,31,10,636,34270636
13163,682,1802200,3,9,31,11,318,34271318
13164,1034,1802200,2,9,31,12,352,34272352
13165,894,1802300,3,9,31,13,246,34273246
13166,527,1802200,1,9,31,13,773,34273773
13167,1819,1802000,1,9,31,15,592,34275592
13168,0,1802000,1,9,31,15,592,34275592
13169,928,1801900,1,9,31,16,520,34276520
13170,204,1801800,5,9,31,16,724,34276724
13171,0,1801800,83,9,31,16,724,34276724
13172,1,1801700,1,9,31,16,725,34276725
13173,1,1801700,1,9,31,16,726,34276726
13174,0,1801700,4,9,31,16,726,34276726
13175,7,1801700,2,9,31,16,733,34276733
13176,33,1801600,2,9,31,16,766,34276766
13177,0,1801600,1,9,31,16,766,34276766
13178,0,1801600,1,9,31,16,766,34276766
13179,0,1801600,1,9,31,16,766,34276766
13180,180,1801700,1,9,31,16,946,34276946
13181,27,1801700,1,9,31,16,973,34276973
13182,450,1801700,1,9,31,17,423,34277423
13183,52,1801800,1,9,31,17,475,34277475
13184,1,1801800,1,9,31,17,476,34277476
13185,0,1801800,1,9,31,17,476,34277476
13186,151,1801600,1,9,31,17,627,34277627
13187,70,1801800,1,9,31,17,697,34277697
13188,618,1801700,1,9,31,18,315,34278315
13189,257,1801900,1,9,31,18,572,34278572
13190,84,1801900,7,9,31,18,656,34278656
13192,64,1801800,1,9,31,18,720,34278720
13193,302,1801800,1,9,31,19,22,34279022
13194,357,1801600,6,9,31,19,379,34279379
13195,138,1801600,1,9,31,19,517,34279517
13196,613,1801700,1,9,31,20,130,34280130
13198,309,1801600,5,9,31,20,439,34280439
13199,1,1801600,1,9,31,20,440,34280440
13200,334,1801500,1,9,31,20,774,34280774
13201,146,1801600,1,9,31,20,920,34280920
13202,70,1801500,1,9,31,20,990,34280990
13203,239,1801600,1,9,31,21,229,34281229
13204,523,1801600,5,9,31,21,752,34281752
13206,227,1801600,1,9,31,21,979,34281979
13207,36,1801600,1,9,31,22,15,34282015
13208,311,1801600,1,9,31,22,326,34282326
13209,217,1801500,5,9,31,22,543,34282543
13210,268,1801600,1,9,31,22,811,34282811
13211,30,1801700,1,9,31,22,841,34282841
13212,314,1801500,1,9,31,23,155,34283155
13213,147,1801600,1,9,31,23,302,34283302
13214,973,1801700,1,9,31,24,275,34284275
13215,17,1801600,1,9,31,24,292,34284292
13216,271,1801600,1,9,31,24,563,34284563
13217,624,1801600,2,9,31,25,187,34285187
13218,298,1801700,1,9,31,25,485,34285485
13219,216,1801700,1,9,31,25,701,34285701
13220,237,1801800,1,9,31,25,938,34285938
13221,928,1801700,1,9,31,26,866,34286866
13222,417,1801700,1,9,31,27,283,34287283
13223,419,1801900,1,9,31,27,702,34287702
13224,14,1801800,1,9,31,27,716,34287716
13225,997,1801900,1,9,31,28,713,34288713
13226,20,1801700,2,9,31,28,733,34288733
13227,32,1801900,1,9,31,28,765,34288765
13228,1505,1801800,2,9,31,30,270,34290270
13229,115,1801800,1,9,31,30,385,34290385
13230,611,1801900,1,9,31,30,996,34290996
13231,3,1802000,6,9,31,30,999,34290999
13232,3,1802000,12,9,31,31,2,34291002
13233,230,1801900,1,9,31,31,232,34291232
13234,1321,1801900,1,9,31,32,553,34292553
13235,346,1801800,2,9,31,32,899,34292899
13236,428,1801900,1,9,31,33,327,34293327
13237,1758,1801800,1,9,31,35,85,34295085
13238,25,1801900,1,9,31,35,110,34295110
13239,1974,1801800,1,9,31,37,84,34297084
13240,102,1801700,4,9,31,37,186,34297186
13241,406,1801700,1,9,31,37,592,34297592
13242,523,1801600,4,9,31,38,115,34298115
13243,43,1801600,1,9,31,38,158,34298158
13244,127,1801800,2,9,31,38,285,34298285
13245,508,1801700,1,9,31,38,793,34298793
13246,429,1801800,1,9,31,39,222,34299222
13247,89,1801700,1,9,31,39,311,34299311
13248,21,1801800,2,9,31,39,332,34299332
13249,1857,1801700,1,9,31,41,189,34301189
13250,501,1801600,6,9,31,41,690,34301690
13251,251,1801500,5,9,31,41,941,34301941
13252,0,1801500,1,9,31,41,941,34301941
13253,0,1801500,1,9,31,41,941,34301941
13254,0,1801500,21,9,31,41,941,34301941
13255,1,1801500,1,9,31,41,942,34301942
13256,0,1801500,1,9,31,41,942,34301942
13257,224,1801400,11,9,31,42,166,34302166
13258,522,1801500,1,9,31,42,688,34302688
13259,93,1801600,1,9,31,42,781,34302781
13260,1229,1801600,1,9,31,44,10,34304010
13261,1242,1801600,1,9,31,45,252,34305252
13262,237,1801500,14,9,31,45,489,34305489
13264,161,1801500,1,9,31,45,650,34305650
13265,425,1801400,1,9,31,46,75,34306075
13266,273,1801500,2,9,31,46,348,34306348
13267,0,1801500,2,9,31,46,348,34306348
13269,2,1801400,3,9,31,46,350,34306350
13270,194,1801300,1,9,31,46,544,34306544
13271,116,1801300,1,9,31,46,660,34306660
13272,11,1801300,1,9,31,46,671,34306671
13273,8,1801300,1,9,31,46,679,34306679
13274,126,1801500,1,9,31,46,805,34306805
13275,74,1801500,1,9,31,46,879,34306879
13276,185,1801300,1,9,31,47,64,34307064
13277,157,1801300,3,9,31,47,221,34307221
13279,2,1801300,2,9,31,47,223,34307223
13280,7,1801200,1,9,31,47,230,34307230
13281,5,1801200,1,9,31,47,235,34307235
13282,57,1801200,1,9,31,47,292,34307292
13283,50,1801200,1,9,31,47,342,34307342
13284,0,1801200,1,9,31,47,342,34307342
13285,4,1801300,1,9,31,47,346,34307346
13286,450,1801300,1,9,31,47,796,34307796
13287,259,1801300,2,9,31,48,55,34308055
13288,39,1801200,1,9,31,48,94,34308094
13289,0,1801200,1,9,31,48,94,34308094
13291,12,1801000,1,9,31,48,106,34308106
13292,4,1801000,1,9,31,48,110,34308110
13293,23,1801000,2,9,31,48,133,34308133
13294,10,1801000,1,9,31,48,143,34308143
13295,29,1801000,1,9,31,48,172,34308172
13296,0,1801000,1,9,31,48,172,34308172
13297,50,1801100,1,9,31,48,222,34308222
13298,43,1801000,1,9,31,48,265,34308265
13299,14,1801200,1,9,31,48,279,34308279
13300,52,1801200,1,9,31,48,331,34308331
13301,417,1801100,1,9,31,48,748,34308748
13302,384,1801100,1,9,31,49,132,34309132
13303,361,1801300,2,9,31,49,493,34309493
13304,57,1801200,1,9,31,49,550,34309550
13305,48,1801200,1,9,31,49,598,34309598
13306,819,1801100,2,9,31,50,417,34310417
13307,409,1801100,1,9,31,50,826,34310826
13308,259,1801000,1,9,31,51,85,34311085
13309,27,1801000,1,9,31,51,112,34311112
13310,409,1801100,1,9,31,51,521,34311521
13311,112,1801000,1,9,31,51,633,34311633
13312,311,1801100,1,9,31,51,944,34311944
13313,107,1801100,2,9,31,52,51,34312051
13314,393,1801100,1,9,31,52,444,34312444
13315,189,1801200,1,9,31,52,633,34312633
13316,81,1801100,1,9,31,52,714,34312714
13317,102,1801000,1,9,31,52,816,34312816
13318,19,1801000,8,9,31,52,835,34312835
13319,17,1800900,1,9,31,52,852,34312852
13320,164,1800900,2,9,31,53,16,34313016
13321,45,1801000,1,9,31,53,61,34313061
13322,211,1801000,2,9,31,53,272,34313272
13323,101,1801000,1,9,31,53,373,34313373
13324,33,1801000,1,9,31,53,406,34313406
13325,589,1801100,2,9,31,53,995,34313995
13327,217,1801000,1,9,31,54,212,34314212
13328,159,1801000,2,9,31,54,371,34314371
13329,398,1801100,1,9,31,54,769,34314769
13330,307,1801000,1,9,31,55,76,34315076
13331,247,1801200,2,9,31,55,323,34315323
13332,713,1801100,1,9,31,56,36,34316036
13333,361,1801100,1,9,31,56,397,34316397
13334,153,1801100,1,9,31,56,550,34316550
13335,303,1801000,1,9,31,56,853,34316853
13336,14,1801000,1,9,31,56,867,34316867
13337,93,1801100,1,9,31,56,960,34316960
13338,668,1801100,1,9,31,57,628,34317628
13339,600,1801100,1,9,31,58,228,34318228
13340,391,1801000,1,9,31,58,619,34318619
13341,18,1801100,1,9,31,58,637,34318637
13342,31,1801100,1,9,31,58,668,34318668
13343,639,1801100,1,9,31,59,307,34319307
13344,549,1801100,1,9,31,59,856,34319856
13345,138,1801200,1,9,31,59,994,34319994
13346,34,1801200,1,9,32,0,28,34320028
13347,236,1801100,1,9,32,0,264,34320264
13348,449,1801100,1,9,32,0,713,34320713
13349,321,1801000,1,9,32,1,34,34321034
13350,179,1801000,3,9,32,1,213,34321213
13351,1,1801000,1,9,32,1,214,34321214
13352,0,1801000,1,9,32,1,214,34321214
13353,2,1801100,1,9,32,1,216,34321216
13354,158,1800900,18,9,32,1,374,34321374
13355,1,1800900,1,9,32,1,375,34321375
13356,0,1800800,6,9,32,1,375,34321375
13357,2,1800800,5,9,32,1,377,34321377
13358,50,1800900,1,9,32,1,427,34321427
13359,34,1800900,6,9,32,1,461,34321461
13360,304,1800800,1,9,32,1,765,34321765
13361,10,1801000,1,9,32,1,775,34321775
13362,2,1801000,2,9,32,1,777,34321777
13363,25,1800900,2,9,32,1,802,34321802
13364,38,1800900,1,9,32,1,840,34321840
13365,23,1801100,8,9,32,1,863,34321863
13366,61,1801100,1,9,32,1,924,34321924
13367,119,1801100,2,9,32,2,43,34322043
13368,104,1801000,1,9,32,2,147,34322147
13369,9,1801000,1,9,32,2,156,34322156
13370,331,1801000,2,9,32,2,487,34322487
13372,718,1801000,1,9,32,3,205,34323205
13373,1,1801000,1,9,32,3,206,34323206
13374,41,1801000,1,9,32,3,247,34323247
13375,105,1801100,1,9,32,3,352,34323352
13376,121,1800900,5,9,32,3,473,34323473
13378,68,1800800,1,9,32,3,541,34323541
13379,213,1801000,2,9,32,3,754,34323754
13380,37,1801000,1,9,32,3,791,34323791
13381,127,1801000,1,9,32,3,918,34323918
13383,239,1800900,1,9,32,4,157,34324157
13384,152,1800900,10,9,32,4,309,34324309
13385,352,1801100,1,9,32,4,661,34324661
13386,152,1801000,1,9,32,4,813,34324813
13387,88,1801000,1,9,32,4,901,34324901
13388,182,1801000,1,9,32,5,83,34325083
13389,85,1801000,1,9,32,5,168,34325168
13390,726,1800900,2,9,32,5,894,34325894
13391,192,1801100,1,9,32,6,86,34326086
13392,0,1801100,1,9,32,6,86,34326086
13393,0,1801100,2,9,32,6,86,34326086
13394,370,1801100,1,9,32,6,456,34326456
13395,34,1801100,1,9,32,6,490,34326490
13396,500,1801200,4,9,32,6,990,34326990
13397,24,1801100,1,9,32,7,14,34327014
13398,86,1801100,2,9,32,7,100,34327100
13399,137,1801200,1,9,32,7,237,34327237
13400,17,1801100,1,9,32,7,254,34327254
13401,49,1801100,2,9,32,7,303,34327303
13402,534,1801000,3,9,32,7,837,34327837
13403,426,1801000,1,9,32,8,263,34328263
13404,40,1800900,2,9,32,8,303,34328303
13405,623,1801000,1,9,32,8,926,34328926
13406,480,1800900,1,9,32,9,406,34329406
13407,86,1800900,4,9,32,9,492,34329492
13408,1,1801000,8,9,32,9,493,34329493
13409,230,1800900,1,9,32,9,723,34329723
13410,467,1800900,3,9,32,10,190,34330190
13411,30,1800800,1,9,32,10,220,34330220
13412,27,1800800,1,9,32,10,247,34330247
13413,59,1800900,1,9,32,10,306,34330306
13414,622,1800900,1,9,32,10,928,34330928
13415,505,1800900,1,9,32,11,433,34331433
13416,534,1800900,6,9,32,11,967,34331967
13417,0,1800900,6,9,32,11,967,34331967
13419,42,1800800,2,9,32,12,9,34332009
13420,2,1800800,2,9,32,12,11,34332011
13421,4,1800800,2,9,32,12,15,34332015
13422,20,1800700,2,9,32,12,35,34332035
13423,54,1800800,4,9,32,12,89,34332089
13424,6,1800700,3,9,32,12,95,34332095
13425,29,1800700,1,9,32,12,124,34332124
13426,439,1800700,1,9,32,12,563,34332563
13427,35,1800700,1,9,32,12,598,34332598
13428,148,1800700,1,9,32,12,746,34332746
13429,54,1800700,1,9,32,12,800,34332800
13430,151,1800800,2,9,32,12,951,34332951
13431,394,1800600,5,9,32,13,345,34333345
13432,0,1800600,10,9,32,13,345,34333345
13433,177,1800700,1,9,32,13,522,34333522
13434,1,1800700,5,9,32,13,523,34333523
13435,72,1800600,2,9,32,13,595,34333595
13436,184,1800500,1,9,32,13,779,34333779
13437,76,1800500,1,9,32,13,855,34333855
13438,4,1800500,1,9,32,13,859,34333859
13439,210,1800500,1,9,32,14,69,34334069
13440,351,1800600,5,9,32,14,420,34334420
13441,0,1800600,5,9,32,14,420,34334420
13443,60,1800500,1,9,32,14,480,34334480
13444,9,1800700,1,9,32,14,489,34334489
13445,129,1800600,1,9,32,14,618,34334618
13446,179,1800600,2,9,32,14,797,34334797
13448,185,1800500,1,9,32,14,982,34334982
13449,60,1800700,1,9,32,15,42,34335042
13450,226,1800500,1,9,32,15,268,34335268
13451,95,1800700,1,9,32,15,363,34335363
13452,18,1800500,4,9,32,15,381,34335381
13453,3,1800600,1,9,32,15,384,34335384
13454,201,1800500,5,9,32,15,585,34335585
13455,69,1800600,2,9,32,15,654,34335654
13456,468,1800600,1,9,32,16,122,34336122
13457,150,1800600,1,9,32,16,272,34336272
13458,11,1800500,1,9,32,16,283,34336283
13459,66,1800500,1,9,32,16,349,34336349
13460,74,1800500,1,9,32,16,423,34336423
13461,180,1800600,1,9,32,16,603,34336603
13463,90,1800600,1,9,32,16,693,34336693
13464,234,1800600,1,9,32,16,927,34336927
13465,199,1800600,1,9,32,17,126,34337126
13466,96,1800800,2,9,32,17,222,34337222
13467,97,1800800,1,9,32,17,319,34337319
13468,611,1800600,1,9,32,17,930,34337930
13469,381,1800600,1,9,32,18,311,34338311
13470,240,1800500,1,9,32,18,551,34338551
13471,253,1800600,1,9,32,18,804,34338804
13472,180,1800400,5,9,32,18,984,34338984
13473,0,1800400,2,9,32,18,984,34338984
13474,1,1800400,1,9,32,18,985,34338985
13475,0,1800400,1,9,32,18,985,34338985
13476,14,1800500,1,9,32,18,999,34338999
13477,274,1800500,1,9,32,19,273,34339273
13478,660,1800500,1,9,32,19,933,34339933
13479,368,1800600,2,9,32,20,301,34340301
13480,345,1800600,1,9,32,20,646,34340646
13481,148,1800400,2,9,32,20,794,34340794
13482,539,1800500,1,9,32,21,333,34341333
13483,2,1800500,3,9,32,21,335,34341335
13484,1,1800500,1,9,32,21,336,34341336
13485,2,1800400,1,9,32,21,338,34341338
13486,211,1800600,7,9,32,21,549,34341549
13487,4,1800600,1,9,32,21,553,34341553
13488,31,1800500,3,9,32,21,584,34341584
13489,1,1800500,2,9,32,21,585,34341585
13490,69,1800500,1,9,32,21,654,34341654
13491,209,1800500,1,9,32,21,863,34341863
13492,575,1800500,1,9,32,22,438,34342438
13493,188,1800400,2,9,32,22,626,34342626
13494,259,1800600,1,9,32,22,885,34342885
13495,24,1800700,1,9,32,22,909,34342909
13496,46,1800600,1,9,32,22,955,34342955
13498,1100,1800500,4,9,32,24,55,34344055
13499,13,1800400,1,9,32,24,68,34344068
13500,316,1800500,2,9,32,24,384,34344384
13501,575,1800500,2,9,32,24,959,34344959
13502,458,1800500,1,9,32,25,417,34345417
13503,415,1800400,6,9,32,25,832,34345832
13504,483,1800500,1,9,32,26,315,34346315
13505,312,1800500,1,9,32,26,627,34346627
13506,331,1800500,2,9,32,26,958,34346958
13507,286,1800500,1,9,32,27,244,34347244
13508,9,1800500,1,9,32,27,253,34347253
13509,14,1800500,1,9,32,27,267,34347267
13510,114,1800500,1,9,32,27,381,34347381
13511,35,1800500,1,9,32,27,416,34347416
13512,168,1800400,1,9,32,27,584,34347584
13513,533,1800500,1,9,32,28,117,34348117
13514,1445,1800500,1,9,32,29,562,34349562
13515,193,1800400,1,9,32,29,755,34349755
13516,539,1800500,2,9,32,30,294,34350294
13517,281,1800400,1,9,32,30,575,34350575
13518,63,1800500,1,9,32,30,638,34350638
13519,317,1800500,1,9,32,30,955,34350955
13520,38,1800400,2,9,32,30,993,34350993
13522,130,1800300,1,9,32,31,123,34351123
13523,29,1800300,5,9,32,31,152,34351152
13524,173,1800400,3,9,32,31,325,34351325
13525,69,1800300,1,9,32,31,394,34351394
13526,745,1800400,1,9,32,32,139,34352139
13527,218,1800400,1,9,32,32,357,34352357
13528,131,1800400,1,9,32,32,488,34352488
13529,291,1800400,1,9,32,32,779,34352779
13530,12,1800500,1,9,32,32,791,34352791
13531,5,1800500,1,9,32,32,796,34352796
13532,71,1800500,1,9,32,32,867,34352867
13533,649,1800500,1,9,32,33,516,34353516
13534,1279,1800300,8,9,32,34,795,34354795
13535,799,1800500,1,9,32,35,594,34355594
13536,136,1800400,1,9,32,35,730,34355730
13537,218,1800300,1,9,32,35,948,34355948
13538,319,1800500,19,9,32,36,267,34356267
13540,3,1800700,1,9,32,36,270,34356270
13541,0,1800700,3,9,32,36,270,34356270
13542,0,1800600,1,9,32,36,270,34356270
13543,0,1800700,1,9,32,36,270,34356270
13544,0,1800700,6,9,32,36,270,34356270
13545,1,1800700,1,9,32,36,271,34356271
13546,0,1800700,2,9,32,36,271,34356271
13547,1,1800800,1,9,32,36,272,34356272
13548,67,1800800,2,9,32,36,339,34356339
13549,509,1800800,1,9,32,36,848,34356848
13551,21,1800700,1,9,32,36,869,34356869
13552,31,1800700,1,9,32,36,900,34356900
13553,508,1800900,7,9,32,37,408,34357408
13554,208,1800800,1,9,32,37,616,34357616
13555,185,1800800,1,9,32,37,801,34357801
13556,220,1801000,5,9,32,38,21,34358021
13557,468,1800800,2,9,32,38,489,34358489
13558,382,1800900,1,9,32,38,871,34358871
13560,195,1801000,1,9,32,39,66,34359066
13561,2,1801000,1,9,32,39,68,34359068
13562,16,1801000,1,9,32,39,84,34359084
13563,12,1801000,2,9,32,39,96,34359096
13564,606,1800800,1,9,32,39,702,34359702
13565,1079,1801000,1,9,32,40,781,34360781
13566,25,1801000,1,9,32,40,806,34360806
13567,276,1800800,1,9,32,41,82,34361082
13568,61,1801000,1,9,32,41,143,34361143
13569,260,1800900,1,9,32,41,403,34361403
13570,1414,1800900,1,9,32,42,817,34362817
13571,231,1800900,1,9,32,43,48,34363048
13572,284,1801000,1,9,32,43,332,34363332
13573,356,1800900,1,9,32,43,688,34363688
13574,117,1801000,1,9,32,43,805,34363805
13575,171,1801000,2,9,32,43,976,34363976
13577,403,1801000,1,9,32,44,379,34364379
13578,142,1801100,1,9,32,44,521,34364521
13579,315,1801000,1,9,32,44,836,34364836
13580,0,1801000,1,9,32,44,836,34364836
13582,60,1801000,1,9,32,44,896,34364896
13583,208,1801000,1,9,32,45,104,34365104
13584,1586,1801100,1,9,32,46,690,34366690
13585,14,1801100,1,9,32,46,704,34366704
13586,1573,1801000,3,9,32,48,277,34368277
13587,1207,1801000,1,9,32,49,484,34369484
13588,1071,1800900,1,9,32,50,555,34370555
13589,0,1800900,1,9,32,50,555,34370555
13590,0,1800900,1,9,32,50,555,34370555
13591,855,1800800,1,9,32,51,410,34371410
13592,0,1800800,3,9,32,51,410,34371410
13593,0,1800800,3,9,32,51,410,34371410
13594,335,1800900,1,9,32,51,745,34371745
13595,83,1800900,1,9,32,51,828,34371828
13596,741,1800900,1,9,32,52,569,34372569
13597,1975,1800800,1,9,32,54,544,34374544
13598,0,1800800,1,9,32,54,544,34374544
13599,94,1800900,1,9,32,54,638,34374638
13600,275,1800800,1,9,32,54,913,34374913
13601,196,1800900,1,9,32,55,109,34375109
13602,232,1800900,1,9,32,55,341,34375341
13603,0,1800900,1,9,32,55,341,34375341
13604,1,1800900,2,9,32,55,342,34375342
13605,90,1800900,1,9,32,55,432,34375432
13606,19,1800800,5,9,32,55,451,34375451
13608,180,1800700,1,9,32,55,631,34375631
13609,364,1800700,2,9,32,55,995,34375995
13610,989,1800900,3,9,32,56,984,34376984
13611,51,1800800,3,9,32,57,35,34377035
13612,494,1800700,2,9,32,57,529,34377529
13613,1249,1800900,1,9,32,58,778,34378778
13614,1,1800900,1,9,32,58,779,34378779
13615,1212,1801000,1,9,32,59,991,34379991
13616,403,1801000,3,9,33,0,394,34380394
13617,111,1801000,2,9,33,0,505,34380505
13618,54,1801000,1,9,33,0,559,34380559
13619,24,1801000,1,9,33,0,583,34380583
13620,34,1801100,1,9,33,0,617,34380617
13621,0,1801100,1,9,33,0,617,34380617
13622,0,1801100,2,9,33,0,617,34380617
13623,698,1801200,2,9,33,1,315,34381315
13624,826,1801200,1,9,33,2,141,34382141
13625,61,1801200,1,9,33,2,202,34382202
13626,276,1801200,2,9,33,2,478,34382478
13627,1,1801200,1,9,33,2,479,34382479
13628,251,1801100,1,9,33,2,730,34382730
13629,1818,1801300,5,9,33,4,548,34384548
13630,168,1801400,1,9,33,4,716,34384716
13631,30,1801400,1,9,33,4,746,34384746
13632,469,1801300,1,9,33,5,215,34385215
13633,239,1801400,1,9,33,5,454,34385454
13634,161,1801400,2,9,33,5,615,34385615
13635,52,1801400,1,9,33,5,667,34385667
13636,1,1801400,1,9,33,5,668,34385668
13637,291,1801300,1,9,33,5,959,34385959
13638,603,1801400,1,9,33,6,562,34386562
13639,44,1801300,1,9,33,6,606,34386606
13640,583,1801300,1,9,33,7,189,34387189
13641,1,1801300,10,9,33,7,190,34387190
13642,741,1801200,1,9,33,7,931,34387931
13643,5,1801300,4,9,33,7,936,34387936
13644,519,1801300,1,9,33,8,455,34388455
13645,1512,1801400,4,9,33,9,967,34389967
13646,504,1801400,1,9,33,10,471,34390471
13647,180,1801500,1,9,33,10,651,34390651
13648,39,1801500,1,9,33,10,690,34390690
13649,1,1801500,2,9,33,10,691,34390691
13650,80,1801400,2,9,33,10,771,34390771
13651,122,1801400,1,9,33,10,893,34390893
13652,1598,1801500,1,9,33,12,491,34392491
13653,845,1801400,1,9,33,13,336,34393336
13654,139,1801300,1,9,33,13,475,34393475
13655,1864,1801400,1,9,33,15,339,34395339
13656,302,1801400,1,9,33,15,641,34395641
13657,1207,1801500,1,9,33,16,848,34396848
13658,190,1801500,1,9,33,17,38,34397038
13659,164,1801500,1,9,33,17,202,34397202
13660,0,1801500,2,9,33,17,202,34397202
13661,0,1801500,1,9,33,17,202,34397202
13662,0,1801500,1,9,33,17,202,34397202
13663,197,1801600,1,9,33,17,399,34397399
13664,470,1801600,1,9,33,17,869,34397869
13665,127,1801600,3,9,33,17,996,34397996
13666,0,1801600,5,9,33,17,996,34397996
13667,0,1801600,4,9,33,17,996,34397996
13668,1,1801600,1,9,33,17,997,34397997
13669,0,1801600,2,9,33,17,997,34397997
13670,547,1801600,2,9,33,18,544,34398544
13671,750,1801600,1,9,33,19,294,34399294
13672,430,1801700,5,9,33,19,724,34399724
13673,1,1801700,5,9,33,19,725,34399725
13674,530,1801600,6,9,33,20,255,34400255
13675,0,1801600,6,9,33,20,255,34400255
13677,112,1801500,1,9,33,20,367,34400367
13678,1,1801500,1,9,33,20,368,34400368
13679,2310,1801400,1,9,33,22,678,34402678
13680,208,1801300,1,9,33,22,886,34402886
13681,0,1801300,1,9,33,22,886,34402886
13682,1,1801300,11,9,33,22,887,34402887
13683,100,1801200,2,9,33,22,987,34402987
13684,41,1801300,1,9,33,23,28,34403028
13685,356,1801200,1,9,33,23,384,34403384
13686,1013,1801200,2,9,33,24,397,34404397
13687,244,1801200,1,9,33,24,641,34404641
13688,1174,1801300,1,9,33,25,815,34405815
13689,442,1801200,4,9,33,26,257,34406257
13690,275,1801200,1,9,33,26,532,34406532
13691,39,1801300,1,9,33,26,571,34406571
13692,2728,1801200,1,9,33,29,299,34409299
13693,126,1801200,1,9,33,29,425,34409425
13694,1035,1801200,1,9,33,30,460,34410460
13695,352,1801100,1,9,33,30,812,34410812
13696,114,1801100,1,9,33,30,926,34410926
13697,360,1801100,10,9,33,31,286,34411286
13698,583,1801200,1,9,33,31,869,34411869
13699,83,1801000,1,9,33,31,952,34411952
13700,214,1801000,1,9,33,32,166,34412166
13701,294,1801000,1,9,33,32,460,34412460
13702,129,1801100,1,9,33,32,589,34412589
13703,13,1801100,1,9,33,32,602,34412602
13704,1161,1801000,1,9,33,33,763,34413763
13705,1043,1801100,1,9,33,34,806,34414806
13706,10,1801000,1,9,33,34,816,34414816
13707,1078,1801100,1,9,33,35,894,34415894
13708,509,1801100,1,9,33,36,403,34416403
13709,220,1801000,1,9,33,36,623,34416623
13710,1249,1801000,1,9,33,37,872,34417872
13711,166,1801000,1,9,33,38,38,34418038
13712,362,1800900,1,9,33,38,400,34418400
13713,333,1800900,1,9,33,38,733,34418733
13714,878,1800800,2,9,33,39,611,34419611
13715,287,1800800,1,9,33,39,898,34419898
13716,354,1800800,1,9,33,40,252,34420252
13717,156,1800900,1,9,33,40,408,34420408
13718,3119,1800900,2,9,33,43,527,34423527
13719,353,1800900,1,9,33,43,880,34423880
13720,2264,1801000,1,9,33,46,144,34426144
13721,1621,1801100,8,9,33,47,765,34427765
13722,210,1801000,1,9,33,47,975,34427975
13723,77,1801100,1,9,33,48,52,34428052
13724,734,1801000,1,9,33,48,786,34428786
13725,439,1801100,1,9,33,49,225,34429225
13726,869,1801000,2,9,33,50,94,34430094
13727,397,1801100,1,9,33,50,491,34430491
13728,585,1801200,1,9,33,51,76,34431076
13729,0,1801200,1,9,33,51,76,34431076
13730,0,1801200,2,9,33,51,76,34431076
13731,0,1801200,5,9,33,51,76,34431076
13732,0,1801200,1,9,33,51,76,34431076
13733,367,1801200,1,9,33,51,443,34431443
13734,192,1801200,1,9,33,51,635,34431635
13735,241,1801100,1,9,33,51,876,34431876
13736,837,1801300,1,9,33,52,713,34432713
13737,70,1801300,1,9,33,52,783,34432783
13738,90,1801400,1,9,33,52,873,34432873
13739,45,1801400,1,9,33,52,918,34432918
13740,351,1801300,1,9,33,53,269,34433269
13741,290,1801400,2,9,33,53,559,34433559
13742,4204,1801300,1,9,33,57,763,34437763
13743,1591,1801400,2,9,33,59,354,34439354
13744,321,1801400,1,9,33,59,675,34439675
13745,157,1801400,1,9,33,59,832,34439832
13746,1159,1801400,1,9,34,0,991,34440991
13747,296,1801300,1,9,34,1,287,34441287
13748,2,1801300,1,9,34,1,289,34441289
13749,23,1801200,1,9,34,1,312,34441312
13750,15,1801300,2,9,34,1,327,34441327
13751,1381,1801300,1,9,34,2,708,34442708
13752,526,1801400,4,9,34,3,234,34443234
13753,128,1801500,5,9,34,3,362,34443362
13754,4,1801600,5,9,34,3,366,34443366
13755,1,1801600,1,9,34,3,367,34443367
13756,0,1801600,1,9,34,3,367,34443367
13757,234,1801500,1,9,34,3,601,34443601
13758,552,1801500,2,9,34,4,153,34444153
13759,190,1801500,1,9,34,4,343,34444343
13760,43,1801400,4,9,34,4,386,34444386
13761,181,1801500,1,9,34,4,567,34444567
13762,11,1801600,1,9,34,4,578,34444578
13763,623,1801400,1,9,34,5,201,34445201
13764,419,1801600,2,9,34,5,620,34445620
13765,702,1801400,1,9,34,6,322,34446322
13766,835,1801400,1,9,34,7,157,34447157
13767,231,1801400,1,9,34,7,388,34447388
13768,2245,1801400,1,9,34,9,633,34449633
13769,291,1801400,1,9,34,9,924,34449924
13770,954,1801500,1,9,34,10,878,34450878
13771,2572,1801400,1,9,34,13,450,34453450
13772,423,1801400,1,9,34,13,873,34453873
13773,516,1801300,2,9,34,14,389,34454389
13774,690,1801300,2,9,34,15,79,34455079
13775,4582,1801200,1,9,34,19,661,34459661
13776,2417,1801200,2,9,34,22,78,34462078
13777,0,1801200,1,9,34,22,78,34462078
13778,176,1801200,1,9,34,22,254,34462254
13779,363,1801100,1,9,34,22,617,34462617
13780,1004,1801300,2,9,34,23,621,34463621
13781,174,1801400,3,9,34,23,795,34463795
13782,117,1801500,1,9,34,23,912,34463912
13783,128,1801300,3,9,34,24,40,34464040
13784,1019,1801300,1,9,34,25,59,34465059
13785,3779,1801300,1,9,34,28,838,34468838
13786,590,1801300,1,9,34,29,428,34469428
13787,827,1801100,3,9,34,30,255,34470255
13788,341,1801000,5,9,34,30,596,34470596
13789,977,1801000,1,9,34,31,573,34471573
13790,1431,1801000,1,9,34,33,4,34473004
13791,1999,1801200,1,9,34,35,3,34475003
13792,3663,1801200,1,9,34,38,666,34478666
13793,2399,1801200,2,9,34,41,65,34481065
13794,1735,1801100,1,9,34,42,800,34482800
13795,1590,1801000,1,9,34,44,390,34484390
13796,31,1801000,1,9,34,44,421,34484421
13797,320,1801000,1,9,34,44,741,34484741
13798,75,1801100,1,9,34,44,816,34484816
13799,243,1801000,1,9,34,45,59,34485059
13800,345,1801000,1,9,34,45,404,34485404
13801,51,1801100,1,9,34,45,455,34485455
13802,959,1801000,1,9,34,46,414,34486414
13803,459,1801200,1,9,34,46,873,34486873
13804,1226,1801200,2,9,34,48,99,34488099
13805,112,1801200,2,9,34,48,211,34488211
13806,309,1801300,2,9,34,48,520,34488520
13807,2,1801400,3,9,34,48,522,34488522
13808,411,1801200,1,9,34,48,933,34488933
13809,198,1801100,2,9,34,49,131,34489131
13810,257,1801200,2,9,34,49,388,34489388
13811,2853,1801200,1,9,34,52,241,34492241
13812,924,1801200,1,9,34,53,165,34493165
13813,40,1801200,1,9,34,53,205,34493205
13814,880,1801300,1,9,34,54,85,34494085
13815,267,1801300,2,9,34,54,352,34494352
13817,276,1801200,1,9,34,54,628,34494628
13818,845,1801200,1,9,34,55,473,34495473
13819,362,1801200,1,9,34,55,835,34495835
13820,42,1801100,1,9,34,55,877,34495877
13821,3840,1801000,1,9,34,59,717,34499717
13822,186,1801000,1,9,34,59,903,34499903
13823,295,1801000,2,9,35,0,198,34500198
13824,76,1801000,1,9,35,0,274,34500274
13825,33,1801000,2,9,35,0,307,34500307
13826,3,1801000,3,9,35,0,310,34500310
13827,217,1800900,2,9,35,0,527,34500527
13828,203,1800900,1,9,35,0,730,34500730
13829,0,1800900,4,9,35,0,730,34500730
13830,132,1800900,2,9,35,0,862,34500862
13831,204,1800900,1,9,35,1,66,34501066
13832,29,1800800,2,9,35,1,95,34501095
13833,65,1800800,1,9,35,1,160,34501160
13834,11,1800800,1,9,35,1,171,34501171
13835,13,1800800,1,9,35,1,184,34501184
13836,638,1800800,2,9,35,1,822,34501822
13837,140,1800800,1,9,35,1,962,34501962
13838,582,1801000,2,9,35,2,544,34502544
13839,920,1801100,1,9,35,3,464,34503464
13840,37,1801100,8,9,35,3,501,34503501
13841,52,1800900,1,9,35,3,553,34503553
13842,295,1801000,1,9,35,3,848,34503848
13843,846,1801200,1,9,35,4,694,34504694
13844,182,1801200,1,9,35,4,876,34504876
13845,18,1801000,1,9,35,4,894,34504894
13846,371,1800900,1,9,35,5,265,34505265
13847,155,1800900,2,9,35,5,420,34505420
13848,1352,1801000,2,9,35,6,772,34506772
13849,1424,1801200,1,9,35,8,196,34508196
13850,1058,1801200,3,9,35,9,254,34509254
13851,518,1801300,1,9,35,9,772,34509772
13852,226,1801300,2,9,35,9,998,34509998
13853,3,1801200,1,9,35,10,1,34510001
13854,53,1801200,3,9,35,10,54,34510054
13855,30,1801200,1,9,35,10,84,34510084
13856,212,1801200,1,9,35,10,296,34510296
13857,162,1801400,1,9,35,10,458,34510458
13858,2263,1801100,1,9,35,12,721,34512721
13859,72,1801000,1,9,35,12,793,34512793
13860,92,1801100,1,9,35,12,885,34512885
13861,39,1801000,2,9,35,12,924,34512924
13862,46,1801000,1,9,35,12,970,34512970
13863,988,1800900,1,9,35,13,958,34513958
13864,687,1800900,1,9,35,14,645,34514645
13865,1334,1800900,1,9,35,15,979,34515979
13866,231,1800900,1,9,35,16,210,34516210
13867,58,1800900,1,9,35,16,268,34516268
13868,256,1800900,1,9,35,16,524,34516524
13869,120,1801000,8,9,35,16,644,34516644
13871,209,1800900,1,9,35,16,853,34516853
13873,1254,1800900,1,9,35,18,107,34518107
13874,2,1800900,1,9,35,18,109,34518109
13875,86,1801000,8,9,35,18,195,34518195
13877,581,1800900,1,9,35,18,776,34518776
13878,1060,1800900,1,9,35,19,836,34519836
13879,3047,1801000,1,9,35,22,883,34522883
13880,1746,1801000,1,9,35,24,629,34524629
13881,415,1800900,1,9,35,25,44,34525044
13882,9,1800800,6,9,35,25,53,34525053
13883,1,1800800,1,9,35,25,54,34525054
13884,0,1800800,1,9,35,25,54,34525054
13885,0,1800800,1,9,35,25,54,34525054
13886,0,1800800,1,9,35,25,54,34525054
13887,30,1800700,5,9,35,25,84,34525084
13888,0,1800700,1,9,35,25,84,34525084
13889,0,1800700,1,9,35,25,84,34525084
13890,3,1800700,1,9,35,25,87,34525087
13891,45,1800600,1,9,35,25,132,34525132
13892,185,1800700,1,9,35,25,317,34525317
13893,1,1800700,3,9,35,25,318,34525318
13894,488,1800800,1,9,35,25,806,34525806
13895,246,1800800,1,9,35,26,52,34526052
13896,528,1800600,1,9,35,26,580,34526580
13897,541,1800600,1,9,35,27,121,34527121
13898,287,1800600,1,9,35,27,408,34527408
13899,0,1800600,1,9,35,27,408,34527408
13900,591,1800500,4,9,35,27,999,34527999
13901,125,1800500,1,9,35,28,124,34528124
13902,290,1800500,5,9,35,28,414,34528414
13903,47,1800500,1,9,35,28,461,34528461
13904,23,1800500,1,9,35,28,484,34528484
13905,5,1800400,1,9,35,28,489,34528489
13906,5,1800400,1,9,35,28,494,34528494
13907,69,1800400,1,9,35,28,563,34528563
13908,79,1800400,2,9,35,28,642,34528642
13909,30,1800400,1,9,35,28,672,34528672
13910,0,1800400,1,9,35,28,672,34528672
13911,8,1800400,2,9,35,28,680,34528680
13912,151,1800400,5,9,35,28,831,34528831
13913,18,1800500,6,9,35,28,849,34528849
13914,93,1800400,1,9,35,28,942,34528942
13915,198,1800400,2,9,35,29,140,34529140
13916,129,1800400,1,9,35,29,269,34529269
13917,11,1800400,1,9,35,29,280,34529280
13918,74,1800400,3,9,35,29,354,34529354
13919,97,1800400,2,9,35,29,451,34529451
13920,559,1800600,1,9,35,30,10,34530010
13921,160,1800400,1,9,35,30,170,34530170
13922,405,1800400,1,9,35,30,575,34530575
13923,175,1800400,2,9,35,30,750,34530750
13924,368,1800300,1,9,35,31,118,34531118
13925,127,1800400,1,9,35,31,245,34531245
13926,59,1800400,1,9,35,31,304,34531304
13927,0,1800400,1,9,35,31,304,34531304
13928,73,1800300,1,9,35,31,377,34531377
13929,83,1800300,1,9,35,31,460,34531460
13930,45,1800300,5,9,35,31,505,34531505
13931,153,1800300,1,9,35,31,658,34531658
13932,642,1800400,1,9,35,32,300,34532300
13933,1320,1800500,1,9,35,33,620,34533620
13934,487,1800600,1,9,35,34,107,34534107
13935,41,1800700,1,9,35,34,148,34534148
13936,1,1800800,1,9,35,34,149,34534149
13937,91,1800800,1,9,35,34,240,34534240
13938,134,1800600,1,9,35,34,374,34534374
13939,1775,1800700,1,9,35,36,149,34536149
13940,34,1800600,2,9,35,36,183,34536183
13941,102,1800600,1,9,35,36,285,34536285
13942,2659,1800700,1,9,35,38,944,34538944
13943,376,1800800,1,9,35,39,320,34539320
13944,1032,1800900,2,9,35,40,352,34540352
13945,105,1800800,1,9,35,40,457,34540457
13946,448,1800900,1,9,35,40,905,34540905
13947,850,1800900,2,9,35,41,755,34541755
13948,129,1800800,1,9,35,41,884,34541884
13949,1505,1800800,1,9,35,43,389,34543389
13950,1,1800800,1,9,35,43,390,34543390
13951,377,1800700,1,9,35,43,767,34543767
13952,0,1800700,1,9,35,43,767,34543767
13953,1201,1800900,1,9,35,44,968,34544968
13954,219,1800700,1,9,35,45,187,34545187
13955,2301,1800700,1,9,35,47,488,34547488
13956,687,1800700,1,9,35,48,175,34548175
13957,1,1800700,2,9,35,48,176,34548176
13958,448,1800700,1,9,35,48,624,34548624
13959,3571,1800600,10,9,35,52,195,34552195
13960,9,1800600,1,9,35,52,204,34552204
13961,182,1800600,1,9,35,52,386,34552386
13962,340,1800500,1,9,35,52,726,34552726
13963,194,1800500,2,9,35,52,920,34552920
13964,1631,1800500,1,9,35,54,551,34554551
13965,590,1800600,1,9,35,55,141,34555141
13966,1537,1800700,1,9,35,56,678,34556678
13967,1046,1800600,1,9,35,57,724,34557724
13968,1215,1800600,1,9,35,58,939,34558939
13969,130,1800500,2,9,35,59,69,34559069
13970,451,1800600,1,9,35,59,520,34559520
13971,598,1800600,1,9,36,0,118,34560118
13973,719,1800700,1,9,36,0,837,34560837
13974,771,1800600,1,9,36,1,608,34561608
13975,1,1800600,1,9,36,1,609,34561609
13976,585,1800500,1,9,36,2,194,34562194
13977,288,1800600,1,9,36,2,482,34562482
13978,290,1800600,1,9,36,2,772,34562772
13979,708,1800600,1,9,36,3,480,34563480
13980,561,1800800,1,9,36,4,41,34564041
13981,224,1800700,1,9,36,4,265,34564265
13982,687,1800700,1,9,36,4,952,34564952
13983,322,1800700,1,9,36,5,274,34565274
13984,429,1800700,1,9,36,5,703,34565703
13985,724,1800600,1,9,36,6,427,34566427
13986,989,1800500,1,9,36,7,416,34567416
13987,1249,1800800,1,9,36,8,665,34568665
13988,30,1800800,1,9,36,8,695,34568695
13989,688,1800900,1,9,36,9,383,34569383
13990,253,1800900,5,9,36,9,636,34569636
13991,1,1800900,8,9,36,9,637,34569637
13992,0,1800900,1,9,36,9,637,34569637
13993,0,1800900,1,9,36,9,637,34569637
13994,19,1800800,1,9,36,9,656,34569656
13995,1320,1800800,4,9,36,10,976,34570976
13996,166,1800800,1,9,36,11,142,34571142
13997,3374,1800700,1,9,36,14,516,34574516
13998,1243,1800600,4,9,36,15,759,34575759
13999,1196,1800700,1,9,36,16,955,34576955
14000,3839,1800500,1,9,36,20,794,34580794
14001,396,1800600,1,9,36,21,190,34581190
14003,287,1800600,1,9,36,21,477,34581477
14004,674,1800600,1,9,36,22,151,34582151
14005,24,1800700,2,9,36,22,175,34582175
14006,408,1800700,1,9,36,22,583,34582583
14007,929,1800500,15,9,36,23,512,34583512
14008,1,1800500,1,9,36,23,513,34583513
14009,0,1800500,1,9,36,23,513,34583513
14010,0,1800500,2,9,36,23,513,34583513
14011,0,1800500,1,9,36,23,513,34583513
14012,91,1800400,1,9,36,23,604,34583604
14013,95,1800500,1,9,36,23,699,34583699
14014,1250,1800500,1,9,36,24,949,34584949
14015,100,1800500,9,9,36,25,49,34585049
14016,0,1800500,2,9,36,25,49,34585049
14017,1,1800500,1,9,36,25,50,34585050
14018,46,1800500,1,9,36,25,96,34585096
14019,405,1800600,1,9,36,25,501,34585501
14020,249,1800500,1,9,36,25,750,34585750
14021,443,1800500,1,9,36,26,193,34586193
14022,816,1800600,1,9,36,27,9,34587009
14023,1399,1800500,1,9,36,28,408,34588408
14024,167,1800500,1,9,36,28,575,34588575
14025,19,1800400,1,9,36,28,594,34588594
14026,366,1800500,1,9,36,28,960,34588960
14027,0,1800500,1,9,36,28,960,34588960
14028,6,1800400,27,9,36,28,966,34588966
14029,0,1800400,2,9,36,28,966,34588966
14030,63,1800300,2,9,36,29,29,34589029
14031,0,1800300,1,9,36,29,29,34589029
14032,0,1800300,1,9,36,29,29,34589029
14033,0,1800300,5,9,36,29,29,34589029
14034,1,1800300,1,9,36,29,30,34589030
14035,0,1800300,1,9,36,29,30,34589030
14036,0,1800300,1,9,36,29,30,34589030
14037,2,1800300,18,9,36,29,32,34589032
14038,410,1800300,1,9,36,29,442,34589442
14039,178,1800400,1,9,36,29,620,34589620
14040,925,1800300,2,9,36,30,545,34590545
14041,508,1800300,1,9,36,31,53,34591053
14042,194,1800300,5,9,36,31,247,34591247
14043,140,1800300,1,9,36,31,387,34591387
14044,1,1800300,2,9,36,31,388,34591388
14045,122,1800300,1,9,36,31,510,34591510
14046,576,1800200,1,9,36,32,86,34592086
14047,33,1800200,2,9,36,32,119,34592119
14048,8,1800200,2,9,36,32,127,34592127
14049,25,1800200,9,9,36,32,152,34592152
14050,1,1800200,10,9,36,32,153,34592153
14051,7,1800100,2,9,36,32,160,34592160
14052,97,1800200,1,9,36,32,257,34592257
14053,20,1800100,1,9,36,32,277,34592277
14054,0,1800100,1,9,36,32,277,34592277
14055,18,1800100,2,9,36,32,295,34592295
14056,182,1800100,1,9,36,32,477,34592477
14057,163,1800100,1,9,36,32,640,34592640
14058,31,1800100,1,9,36,32,671,34592671
14059,29,1800200,1,9,36,32,700,34592700
14060,21,1800200,1,9,36,32,721,34592721
14061,19,1800100,1,9,36,32,740,34592740
14062,6,1800100,1,9,36,32,746,34592746
14063,2,1800100,1,9,36,32,748,34592748
14064,317,1800100,1,9,36,33,65,34593065
14065,584,1800100,1,9,36,33,649,34593649
14066,82,1800100,1,9,36,33,731,34593731
14067,227,1800200,1,9,36,33,958,34593958
14068,200,1800100,1,9,36,34,158,34594158
14069,255,1800200,1,9,36,34,413,34594413
14070,356,1800100,1,9,36,34,769,34594769
14071,0,1800100,5,9,36,34,769,34594769
14072,1,1800100,1,9,36,34,770,34594770
14073,0,1800100,4,9,36,34,770,34594770
14074,219,1800200,1,9,36,34,989,34594989
14075,427,1800100,1,9,36,35,416,34595416
14076,50,1800100,1,9,36,35,466,34595466
14077,54,1800100,5,9,36,35,520,34595520
14078,295,1800000,1,9,36,35,815,34595815
14079,39,1800000,1,9,36,35,854,34595854
14080,4,1800000,1,9,36,35,858,34595858
14081,20,1800000,1,9,36,35,878,34595878
14082,28,1800000,3,9,36,35,906,34595906
14083,8,1800000,1,9,36,35,914,34595914
14084,11,1800000,20,9,36,35,925,34595925
14085,2,1800000,1,9,36,35,927,34595927
14086,0,1800000,18,9,36,35,927,34595927
14087,12,1799900,5,9,36,35,939,34595939
14088,25,1799900,1,9,36,35,964,34595964
14089,21,1799900,1,9,36,35,985,34595985
14090,4,1799900,1,9,36,35,989,34595989
14091,1,1799900,1,9,36,35,990,34595990
14092,19,1799900,2,9,36,36,9,34596009
14093,22,1800000,1,9,36,36,31,34596031
14094,20,1799900,1,9,36,36,51,34596051
14095,11,1799900,1,9,36,36,62,34596062
14096,268,1799900,2,9,36,36,330,34596330
14097,231,1800000,1,9,36,36,561,34596561
14098,130,1799900,2,9,36,36,691,34596691
14099,40,1799900,1,9,36,36,731,34596731
14100,36,1799900,1,9,36,36,767,34596767
14101,34,1800100,1,9,36,36,801,34596801
14102,1505,1800100,1,9,36,38,306,34598306
14103,187,1800100,1,9,36,38,493,34598493
14104,246,1800100,4,9,36,38,739,34598739
14105,0,1800100,4,9,36,38,739,34598739
14107,1,1799900,5,9,36,38,740,34598740
14108,1,1799900,1,9,36,38,741,34598741
14109,0,1799900,1,9,36,38,741,34598741
14110,0,1799900,1,9,36,38,741,34598741
14111,10,1799900,1,9,36,38,751,34598751
14112,30,1799800,2,9,36,38,781,34598781
14113,124,1799800,1,9,36,38,905,34598905
14114,16,1799800,1,9,36,38,921,34598921
14115,1,1799900,1,9,36,38,922,34598922
14116,45,1799800,2,9,36,38,967,34598967
14117,32,1799800,2,9,36,38,999,34598999
14118,5,1799800,2,9,36,39,4,34599004
14119,147,1799800,1,9,36,39,151,34599151
14120,549,1799900,1,9,36,39,700,34599700
14121,2,1799800,1,9,36,39,702,34599702
14122,83,1800000,1,9,36,39,785,34599785
14123,50,1799800,1,9,36,39,835,34599835
14124,58,1799800,1,9,36,39,893,34599893
14125,78,1799800,1,9,36,39,971,34599971
14126,76,1799900,1,9,36,40,47,34600047
14127,53,1799800,1,9,36,40,100,34600100
14128,305,1799800,5,9,36,40,405,34600405
14129,70,1800000,1,9,36,40,475,34600475
14130,235,1800000,2,9,36,40,710,34600710
14131,12,1800000,1,9,36,40,722,34600722
14132,165,1800000,1,9,36,40,887,34600887
14133,58,1800000,1,9,36,40,945,34600945
14135,103,1800100,3,9,36,41,48,34601048
14136,4,1800200,1,9,36,41,52,34601052
14137,68,1800200,1,9,36,41,120,34601120
14138,653,1800000,1,9,36,41,773,34601773
14139,292,1800000,1,9,36,42,65,34602065
14140,553,1800000,1,9,36,42,618,34602618
14141,487,1800000,1,9,36,43,105,34603105
14142,638,1800100,3,9,36,43,743,34603743
14143,0,1800100,1,9,36,43,743,34603743
14144,223,1800200,1,9,36,43,966,34603966
14145,1,1800200,3,9,36,43,967,34603967
14146,0,1800200,2,9,36,43,967,34603967
14147,0,1800200,5,9,36,43,967,34603967
14148,0,1800200,6,9,36,43,967,34603967
14149,259,1800300,1,9,36,44,226,34604226
14150,353,1800200,1,9,36,44,579,34604579
14151,554,1800300,5,9,36,45,133,34605133
14152,67,1800200,2,9,36,45,200,34605200
14153,240,1800300,1,9,36,45,440,34605440
14154,14,1800200,5,9,36,45,454,34605454
14156,34,1800200,2,9,36,45,488,34605488
14157,149,1800200,3,9,36,45,637,34605637
14158,193,1800200,1,9,36,45,830,34605830
14159,501,1800200,1,9,36,46,331,34606331
14160,256,1800100,1,9,36,46,587,34606587
14161,304,1800200,1,9,36,46,891,34606891
14162,117,1800100,1,9,36,47,8,34607008
14163,1,1800100,1,9,36,47,9,34607009
14164,0,1800100,1,9,36,47,9,34607009
14165,1050,1800100,1,9,36,48,59,34608059
14166,536,1800100,1,9,36,48,595,34608595
14167,182,1800100,1,9,36,48,777,34608777
14168,928,1800100,1,9,36,49,705,34609705
14169,625,1800000,2,9,36,50,330,34610330
14170,545,1800000,1,9,36,50,875,34610875
14171,498,1800000,1,9,36,51,373,34611373
14172,265,1800000,1,9,36,51,638,34611638
14173,1103,1799900,1,9,36,52,741,34612741
14174,128,1799900,1,9,36,52,869,34612869
14175,81,1800000,1,9,36,52,950,34612950
14176,254,1799900,1,9,36,53,204,34613204
14177,444,1800000,1,9,36,53,648,34613648
14178,9,1800100,2,9,36,53,657,34613657
14179,524,1800000,1,9,36,54,181,34614181
14180,1335,1800100,3,9,36,55,516,34615516
14181,0,1800100,1,9,36,55,516,34615516
14182,0,1800100,1,9,36,55,516,34615516
14183,214,1800100,1,9,36,55,730,34615730
14184,789,1800200,1,9,36,56,519,34616519
14185,436,1800100,1,9,36,56,955,34616955
14186,159,1800300,4,9,36,57,114,34617114
14187,190,1800200,1,9,36,57,304,34617304
14188,254,1800200,1,9,36,57,558,34617558
14189,456,1800300,1,9,36,58,14,34618014
14190,53,1800200,1,9,36,58,67,34618067
14191,38,1800400,2,9,36,58,105,34618105
14192,240,1800200,1,9,36,58,345,34618345
14193,240,1800300,1,9,36,58,585,34618585
14195,232,1800200,1,9,36,58,817,34618817
14196,367,1800400,3,9,36,59,184,34619184
14197,7,1800500,3,9,36,59,191,34619191
14198,74,1800600,4,9,36,59,265,34619265
14199,37,1800500,1,9,36,59,302,34619302
14200,391,1800400,1,9,36,59,693,34619693
14201,206,1800300,1,9,36,59,899,34619899
14202,251,1800400,1,9,37,0,150,34620150
14203,534,1800300,1,9,37,0,684,34620684
14204,10,1800300,1,9,37,0,694,34620694
14205,167,1800300,1,9,37,0,861,34620861
14206,73,1800300,1,9,37,0,934,34620934
14207,125,1800400,1,9,37,1,59,34621059
14208,306,1800300,1,9,37,1,365,34621365
14209,154,1800400,2,9,37,1,519,34621519
14210,34,1800400,1,9,37,1,553,34621553
14211,31,1800400,1,9,37,1,584,34621584
14212,1052,1800400,1,9,37,2,636,34622636
14213,536,1800500,3,9,37,3,172,34623172
14214,400,1800600,8,9,37,3,572,34623572
14215,6,1800600,1,9,37,3,578,34623578
14216,165,1800700,6,9,37,3,743,34623743
14217,157,1800600,1,9,37,3,900,34623900
14218,36,1800600,1,9,37,3,936,34623936
14219,475,1800800,18,9,37,4,411,34624411
14220,42,1800900,2,9,37,4,453,34624453
14221,0,1800900,3,9,37,4,453,34624453
14222,0,1800900,2,9,37,4,453,34624453
14223,77,1801000,1,9,37,4,530,34624530
14224,169,1801000,1,9,37,4,699,34624699
14225,52,1801000,1,9,37,4,751,34624751
14226,51,1801000,1,9,37,4,802,34624802
14227,17,1800800,1,9,37,4,819,34624819
14228,39,1800800,3,9,37,4,858,34624858
14229,12,1800800,1,9,37,4,870,34624870
14230,4,1800800,1,9,37,4,874,34624874
14231,31,1800800,1,9,37,4,905,34624905
14232,78,1800800,1,9,37,4,983,34624983
14233,115,1801000,3,9,37,5,98,34625098
14234,26,1800800,1,9,37,5,124,34625124
14235,34,1800800,1,9,37,5,158,34625158
14236,133,1801000,2,9,37,5,291,34625291
14237,0,1801000,1,9,37,5,291,34625291
14238,257,1801000,1,9,37,5,548,34625548
14239,404,1801000,1,9,37,5,952,34625952
14240,482,1801100,1,9,37,6,434,34626434
14241,1,1801100,4,9,37,6,435,34626435
14242,0,1801100,2,9,37,6,435,34626435
14243,62,1801200,1,9,37,6,497,34626497
14244,7,1801000,1,9,37,6,504,34626504
14245,262,1801000,1,9,37,6,766,34626766
14246,101,1801100,3,9,37,6,867,34626867
14247,87,1801200,1,9,37,6,954,34626954
14248,224,1801000,4,9,37,7,178,34627178
14250,48,1801100,1,9,37,7,226,34627226
14251,253,1800900,1,9,37,7,479,34627479
14252,102,1801100,1,9,37,7,581,34627581
14253,1013,1800900,4,9,37,8,594,34628594
14254,419,1800900,3,9,37,9,13,34629013
14255,271,1800800,2,9,37,9,284,34629284
14256,29,1800900,2,9,37,9,313,34629313
14257,250,1800900,1,9,37,9,563,34629563
14258,270,1800900,1,9,37,9,833,34629833
14259,263,1800900,1,9,37,10,96,34630096
14260,17,1800900,2,9,37,10,113,34630113
14261,170,1800800,1,9,37,10,283,34630283
14262,733,1800800,1,9,37,11,16,34631016
14263,1526,1800700,1,9,37,12,542,34632542
14264,827,1800600,1,9,37,13,369,34633369
14265,514,1800700,1,9,37,13,883,34633883
14266,423,1800800,1,9,37,14,306,34634306
14267,1397,1800900,1,9,37,15,703,34635703
14268,128,1800900,3,9,37,15,831,34635831
14269,1,1800900,1,9,37,15,832,34635832
14270,0,1800900,2,9,37,15,832,34635832
14271,0,1800900,2,9,37,15,832,34635832
14272,200,1800900,1,9,37,16,32,34636032
14273,59,1801000,4,9,37,16,91,34636091
14274,105,1801000,1,9,37,16,196,34636196
14275,60,1801100,3,9,37,16,256,34636256
14276,67,1801000,1,9,37,16,323,34636323
14277,827,1801200,7,9,37,17,150,34637150
14278,315,1801100,2,9,37,17,465,34637465
14279,471,1801100,1,9,37,17,936,34637936
14280,1125,1801100,1,9,37,19,61,34639061
14281,455,1801100,1,9,37,19,516,34639516
14282,299,1801100,1,9,37,19,815,34639815
14283,28,1801200,1,9,37,19,843,34639843
14284,96,1801000,1,9,37,19,939,34639939
14285,423,1801000,2,9,37,20,362,34640362
14286,205,1801100,1,9,37,20,567,34640567
14287,253,1801100,1,9,37,20,820,34640820
14288,985,1801100,1,9,37,21,805,34641805
14289,657,1801100,1,9,37,22,462,34642462
14290,1870,1801100,1,9,37,24,332,34644332
14291,200,1801200,2,9,37,24,532,34644532
14292,801,1801300,13,9,37,25,333,34645333
14293,79,1801400,3,9,37,25,412,34645412
14294,47,1801300,1,9,37,25,459,34645459
14295,52,1801300,1,9,37,25,511,34645511
14296,58,1801400,1,9,37,25,569,34645569
14297,480,1801400,1,9,37,26,49,34646049
14298,57,1801400,1,9,37,26,106,34646106
14299,3,1801400,1,9,37,26,109,34646109
14300,407,1801400,1,9,37,26,516,34646516
14301,519,1801300,1,9,37,27,35,34647035
14302,66,1801400,1,9,37,27,101,34647101
14303,0,1801400,1,9,37,27,101,34647101
14304,413,1801300,1,9,37,27,514,34647514
14305,1461,1801400,1,9,37,28,975,34648975
14306,489,1801400,3,9,37,29,464,34649464
14307,116,1801400,1,9,37,29,580,34649580
14308,0,1801400,2,9,37,29,580,34649580
14309,233,1801300,1,9,37,29,813,34649813
14310,104,1801300,7,9,37,29,917,34649917
14312,608,1801200,1,9,37,30,525,34650525
14313,485,1801200,2,9,37,31,10,34651010
14314,947,1801200,1,9,37,31,957,34651957
14315,374,1801200,1,9,37,32,331,34652331
14316,892,1801200,1,9,37,33,223,34653223
14317,1209,1801300,1,9,37,34,432,34654432
14318,1633,1801200,1,9,37,36,65,34656065
14319,233,1801200,5,9,37,36,298,34656298
14320,118,1801100,1,9,37,36,416,34656416
14321,104,1801300,1,9,37,36,520,34656520
14322,918,1801300,1,9,37,37,438,34657438
14323,38,1801300,1,9,37,37,476,34657476
14324,500,1801100,1,9,37,37,976,34657976
14325,169,1801100,1,9,37,38,145,34658145
14326,2240,1801200,1,9,37,40,385,34660385
14327,330,1801100,1,9,37,40,715,34660715
14328,534,1801200,4,9,37,41,249,34661249
14329,350,1801200,1,9,37,41,599,34661599
14330,250,1801300,6,9,37,41,849,34661849
14331,424,1801400,9,9,37,42,273,34662273
14332,254,1801300,1,9,37,42,527,34662527
14333,607,1801500,1,9,37,43,134,34663134
14334,437,1801300,1,9,37,43,571,34663571
14335,88,1801300,1,9,37,43,659,34663659
14336,0,1801400,3,9,37,43,659,34663659
14337,1152,1801400,7,9,37,44,811,34664811
14339,673,1801500,1,9,37,45,484,34665484
14340,12,1801500,9,9,37,45,496,34665496
14341,264,1801500,3,9,37,45,760,34665760
14342,76,1801600,10,9,37,45,836,34665836
14343,174,1801700,2,9,37,46,10,34666010
14344,53,1801600,1,9,37,46,63,34666063
14345,40,1801700,3,9,37,46,103,34666103
14346,0,1801700,3,9,37,46,103,34666103
14347,4,1801600,4,9,37,46,107,34666107
14348,122,1801500,1,9,37,46,229,34666229
14349,201,1801700,1,9,37,46,430,34666430
14350,88,1801700,1,9,37,46,518,34666518
14351,127,1801600,1,9,37,46,645,34666645
14352,49,1801700,1,9,37,46,694,34666694
14353,96,1801700,5,9,37,46,790,34666790
14354,143,1801600,1,9,37,46,933,34666933
14355,116,1801800,10,9,37,47,49,34667049
14356,73,1801800,1,9,37,47,122,34667122
14357,68,1801800,1,9,37,47,190,34667190
14358,280,1801800,2,9,37,47,470,34667470
14359,114,1801800,2,9,37,47,584,34667584
14360,47,1801800,5,9,37,47,631,34667631
14361,0,1801800,4,9,37,47,631,34667631
14362,1,1801800,1,9,37,47,632,34667632
14363,645,1801800,1,9,37,48,277,34668277
14364,95,1801900,1,9,37,48,372,34668372
14365,152,1801800,1,9,37,48,524,34668524
14367,46,1801800,1,9,37,48,570,34668570
14368,58,1801900,1,9,37,48,628,34668628
14369,344,1801800,1,9,37,48,972,34668972
14370,214,1801800,1,9,37,49,186,34669186
14371,18,1801800,1,9,37,49,204,34669204
14373,51,1801800,1,9,37,49,255,34669255
14374,77,1801800,2,9,37,49,332,34669332
14375,78,1801900,1,9,37,49,410,34669410
14376,178,1801900,1,9,37,49,588,34669588
14377,812,1801800,3,9,37,50,400,34670400
14378,297,1801900,2,9,37,50,697,34670697
14379,272,1801900,1,9,37,50,969,34670969
14380,57,1801900,2,9,37,51,26,34671026
14381,164,1801900,1,9,37,51,190,34671190
14382,4,1802000,1,9,37,51,194,34671194
14383,115,1802000,1,9,37,51,309,34671309
14384,135,1802000,1,9,37,51,444,34671444
14385,0,1802000,1,9,37,51,444,34671444
14386,0,1802000,1,9,37,51,444,34671444
14387,334,1801900,1,9,37,51,778,34671778
14388,33,1802000,3,9,37,51,811,34671811
14389,63,1801900,1,9,37,51,874,34671874
14390,351,1802000,1,9,37,52,225,34672225
14391,30,1801900,2,9,37,52,255,34672255
14392,224,1801900,1,9,37,52,479,34672479
14393,16,1802000,1,9,37,52,495,34672495
14394,425,1801800,1,9,37,52,920,34672920
14395,49,1801800,8,9,37,52,969,34672969
14396,140,1801800,3,9,37,53,109,34673109
14397,475,1801900,1,9,37,53,584,34673584
14398,466,1801900,1,9,37,54,50,34674050
14399,129,1802000,1,9,37,54,179,34674179
14400,204,1801800,1,9,37,54,383,34674383
14401,463,1801800,1,9,37,54,846,34674846
14402,667,1801800,1,9,37,55,513,34675513
14403,187,1802000,1,9,37,55,700,34675700
14404,217,1802000,1,9,37,55,917,34675917
14405,253,1801900,3,9,37,56,170,34676170
14406,742,1801800,1,9,37,56,912,34676912
14407,2205,1801900,2,9,37,59,117,34679117
14408,333,1801800,2,9,37,59,450,34679450
14409,545,1801800,1,9,37,59,995,34679995
14410,30,1801800,2,9,38,0,25,34680025
14411,34,1801800,1,9,38,0,59,34680059
14412,69,1801800,1,9,38,0,128,34680128
14413,177,1801800,1,9,38,0,305,34680305
14414,548,1801800,3,9,38,0,853,34680853
14415,122,1801900,1,9,38,0,975,34680975
14416,120,1801700,1,9,38,1,95,34681095
14417,229,1801800,1,9,38,1,324,34681324
14418,465,1801800,3,9,38,1,789,34681789
14419,327,1801700,1,9,38,2,116,34682116
14420,334,1801800,1,9,38,2,450,34682450
14421,115,1801800,1,9,38,2,565,34682565
14422,310,1801800,1,9,38,2,875,34682875
14423,1002,1801800,2,9,38,3,877,34683877
14424,764,1801700,1,9,38,4,641,34684641
14425,317,1801700,1,9,38,4,958,34684958
14426,35,1801800,1,9,38,4,993,34684993
14427,15,1801900,1,9,38,5,8,34685008
14428,109,1801700,1,9,38,5,117,34685117
14429,207,1801800,1,9,38,5,324,34685324
14430,67,1801700,2,9,38,5,391,34685391
14431,283,1801800,1,9,38,5,674,34685674
14432,554,1801800,1,9,38,6,228,34686228
14433,263,1801800,1,9,38,6,491,34686491
14434,37,1801700,1,9,38,6,528,34686528
14435,0,1801700,7,9,38,6,528,34686528
14436,42,1801600,2,9,38,6,570,34686570
14437,0,1801600,1,9,38,6,570,34686570
14438,1,1801500,1,9,38,6,571,34686571
14439,1,1801500,1,9,38,6,572,34686572
14440,0,1801500,1,9,38,6,572,34686572
14441,69,1801600,1,9,38,6,641,34686641
14442,175,1801500,1,9,38,6,816,34686816
14443,0,1801500,1,9,38,6,816,34686816
14444,0,1801500,1,9,38,6,816,34686816
14445,297,1801600,4,9,38,7,113,34687113
14446,2,1801700,3,9,38,7,115,34687115
14447,1971,1801600,1,9,38,9,86,34689086
14448,0,1801600,1,9,38,9,86,34689086
14449,1,1801600,1,9,38,9,87,34689087
14450,635,1801600,1,9,38,9,722,34689722
14451,183,1801800,1,9,38,9,905,34689905
14452,320,1801600,1,9,38,10,225,34690225
14453,147,1801800,1,9,38,10,372,34690372
14454,344,1801600,1,9,38,10,716,34690716
14455,3222,1801700,1,9,38,13,938,34693938
14456,1032,1801800,1,9,38,14,970,34694970
14457,49,1801600,1,9,38,15,19,34695019
14458,316,1801600,1,9,38,15,335,34695335
14459,203,1801700,1,9,38,15,538,34695538
14460,1016,1801700,1,9,38,16,554,34696554
14461,27,1801800,9,9,38,16,581,34696581
14462,946,1801900,1,9,38,17,527,34697527
14463,23,1801900,1,9,38,17,550,34697550
14464,254,1801900,1,9,38,17,804,34697804
14465,122,1801900,1,9,38,17,926,34697926
14466,3,1801900,4,9,38,17,929,34697929
14467,505,1802000,1,9,38,18,434,34698434
14468,0,1802000,1,9,38,18,434,34698434
14469,0,1802000,1,9,38,18,434,34698434
14470,0,1802000,20,9,38,18,434,34698434
14471,27,1802000,1,9,38,18,461,34698461
14473,60,1801900,1,9,38,18,521,34698521
14474,548,1801900,1,9,38,19,69,34699069
14475,724,1802000,2,9,38,19,793,34699793
14476,516,1802000,1,9,38,20,309,34700309
14477,1,1802000,3,9,38,20,310,34700310
14478,381,1802000,1,9,38,20,691,34700691
14479,1801,1802000,1,9,38,22,492,34702492
14480,98,1802100,1,9,38,22,590,34702590
14481,293,1802100,1,9,38,22,883,34702883
14482,6,1802000,1,9,38,22,889,34702889
14483,1023,1802100,1,9,38,23,912,34703912
14484,120,1802000,2,9,38,24,32,34704032
14485,216,1802100,3,9,38,24,248,34704248
14486,354,1802000,1,9,38,24,602,34704602
14487,0,1802000,1,9,38,24,602,34704602
14488,302,1802000,4,9,38,24,904,34704904
14490,34,1801900,4,9,38,24,938,34704938
14491,23,1801900,1,9,38,24,961,34704961
14492,51,1801900,1,9,38,25,12,34705012
14493,149,1801900,1,9,38,25,161,34705161
14494,81,1801900,1,9,38,25,242,34705242
14495,243,1801900,1,9,38,25,485,34705485
14496,99,1801900,1,9,38,25,584,34705584
14497,248,1801900,1,9,38,25,832,34705832
14499,177,1802000,9,9,38,26,9,34706009
14501,87,1801900,5,9,38,26,96,34706096
14502,1495,1802000,3,9,38,27,591,34707591
14503,10,1802000,1,9,38,27,601,34707601
14504,390,1802000,2,9,38,27,991,34707991
14505,885,1802000,2,9,38,28,876,34708876
14506,391,1802000,3,9,38,29,267,34709267
14507,259,1801900,2,9,38,29,526,34709526
14508,487,1802000,1,9,38,30,13,34710013
14509,208,1802100,1,9,38,30,221,34710221
14510,192,1802000,1,9,38,30,413,34710413
14511,563,1802000,1,9,38,30,976,34710976
14512,112,1802000,1,9,38,31,88,34711088
14513,15,1801900,1,9,38,31,103,34711103
14514,41,1802000,1,9,38,31,144,34711144
14515,160,1802000,1,9,38,31,304,34711304
14516,75,1802000,1,9,38,31,379,34711379
14518,233,1802000,2,9,38,31,612,34711612
14519,100,1801900,1,9,38,31,712,34711712
14520,968,1801800,5,9,38,32,680,34712680
14521,372,1801900,1,9,38,33,52,34713052
14522,726,1802000,1,9,38,33,778,34713778
14523,6,1802000,1,9,38,33,784,34713784
14524,2553,1801900,1,9,38,36,337,34716337
14525,1159,1801800,1,9,38,37,496,34717496
14526,220,1801900,8,9,38,37,716,34717716
14528,1093,1801800,1,9,38,38,809,34718809
14529,194,1802000,2,9,38,39,3,34719003
14530,397,1802000,1,9,38,39,400,34719400
14531,11,1802000,1,9,38,39,411,34719411
14532,1,1802000,1,9,38,39,412,34719412
14533,1585,1802000,1,9,38,40,997,34720997
14534,407,1802000,1,9,38,41,404,34721404
14535,39,1802000,1,9,38,41,443,34721443
14536,1165,1802100,1,9,38,42,608,34722608
14537,0,1802100,1,9,38,42,608,34722608
14538,0,1802100,1,9,38,42,608,34722608
14539,0,1802100,3,9,38,42,608,34722608
14540,0,1802100,1,9,38,42,608,34722608
14541,27,1802100,3,9,38,42,635,34722635
14542,686,1802100,2,9,38,43,321,34723321
14544,340,1802100,1,9,38,43,661,34723661
14545,129,1802100,1,9,38,43,790,34723790
14546,253,1802100,1,9,38,44,43,34724043
14547,411,1801900,2,9,38,44,454,34724454
14548,21,1801900,1,9,38,44,475,34724475
14549,0,1801900,2,9,38,44,475,34724475
14550,0,1801900,5,9,38,44,475,34724475
14551,611,1801800,1,9,38,45,86,34725086
14552,487,1801900,1,9,38,45,573,34725573
14553,109,1801900,1,9,38,45,682,34725682
14554,1803,1802000,1,9,38,47,485,34727485
14555,76,1802000,1,9,38,47,561,34727561
14556,1,1802000,2,9,38,47,562,34727562
14557,123,1801900,2,9,38,47,685,34727685
14558,2296,1802000,1,9,38,49,981,34729981
14560,612,1802000,10,9,38,50,593,34730593
14561,1393,1802000,1,9,38,51,986,34731986
14563,95,1802100,1,9,38,52,81,34732081
14564,1488,1802100,1,9,38,53,569,34733569
14565,284,1802100,2,9,38,53,853,34733853
14566,252,1802100,1,9,38,54,105,34734105
14567,216,1802100,1,9,38,54,321,34734321
14568,552,1802000,1,9,38,54,873,34734873
14569,1058,1802100,1,9,38,55,931,34735931
14570,803,1802100,8,9,38,56,734,34736734
14571,565,1802100,1,9,38,57,299,34737299
14572,145,1802100,1,9,38,57,444,34737444
14573,261,1802200,1,9,38,57,705,34737705
14574,1641,1802200,1,9,38,59,346,34739346
14575,477,1802200,1,9,38,59,823,34739823
14576,58,1802000,1,9,38,59,881,34739881
14577,157,1802200,28,9,39,0,38,34740038
14579,4,1802300,1,9,39,0,42,34740042
14580,0,1802300,1,9,39,0,42,34740042
14581,0,1802300,1,9,39,0,42,34740042
14582,0,1802300,4,9,39,0,42,34740042
14583,0,1802300,3,9,39,0,42,34740042
14584,89,1802200,1,9,39,0,131,34740131
14585,77,1802200,1,9,39,0,208,34740208
14586,6,1802300,1,9,39,0,214,34740214
14587,99,1802300,1,9,39,0,313,34740313
14588,235,1802300,1,9,39,0,548,34740548
14589,440,1802300,1,9,39,0,988,34740988
14590,42,1802300,1,9,39,1,30,34741030
14591,209,1802300,1,9,39,1,239,34741239
14592,68,1802400,1,9,39,1,307,34741307
14593,7,1802200,1,9,39,1,314,34741314
14594,44,1802400,2,9,39,1,358,34741358
14595,462,1802400,1,9,39,1,820,34741820
14596,173,1802300,1,9,39,1,993,34741993
14597,0,1802300,1,9,39,1,993,34741993
14598,1,1802400,4,9,39,1,994,34741994
14599,125,1802300,3,9,39,2,119,34742119
14600,136,1802200,1,9,39,2,255,34742255
14601,504,1802300,1,9,39,2,759,34742759
14602,205,1802200,1,9,39,2,964,34742964
14603,214,1802200,1,9,39,3,178,34743178
14604,0,1802200,1,9,39,3,178,34743178
14605,35,1802200,1,9,39,3,213,34743213
14606,39,1802200,2,9,39,3,252,34743252
14607,53,1802200,1,9,39,3,305,34743305
14608,92,1802100,2,9,39,3,397,34743397
14609,304,1802000,1,9,39,3,701,34743701
14610,100,1802100,1,9,39,3,801,34743801
14611,638,1802100,1,9,39,4,439,34744439
14612,96,1802100,1,9,39,4,535,34744535
14613,526,1802100,1,9,39,5,61,34745061
14614,724,1802100,3,9,39,5,785,34745785
14615,1475,1802200,1,9,39,7,260,34747260
14616,1317,1802200,1,9,39,8,577,34748577
14617,913,1802100,1,9,39,9,490,34749490
14618,749,1802100,1,9,39,10,239,34750239
14619,150,1802200,3,9,39,10,389,34750389
14621,313,1802200,1,9,39,10,702,34750702
14622,86,1802100,1,9,39,10,788,34750788
14623,128,1802000,3,9,39,10,916,34750916
14624,548,1802000,5,9,39,11,464,34751464
14625,6,1801900,1,9,39,11,470,34751470
14626,374,1802000,1,9,39,11,844,34751844
14627,507,1801800,1,9,39,12,351,34752351
14628,141,1801800,1,9,39,12,492,34752492
14629,163,1801800,1,9,39,12,655,34752655
14630,350,1801800,5,9,39,13,5,34753005
14631,159,1801800,1,9,39,13,164,34753164
14632,1436,1801700,1,9,39,14,600,34754600
14633,154,1801700,1,9,39,14,754,34754754
14634,122,1801600,2,9,39,14,876,34754876
14635,48,1801600,1,9,39,14,924,34754924
14636,13,1801800,7,9,39,14,937,34754937
14638,35,1801700,1,9,39,14,972,34754972
14639,308,1801700,5,9,39,15,280,34755280
14640,143,1801700,2,9,39,15,423,34755423
14641,355,1801700,2,9,39,15,778,34755778
14643,111,1801600,1,9,39,15,889,34755889
14644,754,1801600,1,9,39,16,643,34756643
14645,1,1801600,1,9,39,16,644,34756644
14646,538,1801700,1,9,39,17,182,34757182
14647,477,1801500,2,9,39,17,659,34757659
14648,530,1801600,1,9,39,18,189,34758189
14649,168,1801600,1,9,39,18,357,34758357
14650,326,1801500,1,9,39,18,683,34758683
14651,812,1801700,7,9,39,19,495,34759495
14653,234,1801800,3,9,39,19,729,34759729
14654,834,1801600,3,9,39,20,563,34760563
14655,34,1801700,1,9,39,20,597,34760597
14656,176,1801800,4,9,39,20,773,34760773
14657,1244,1801800,1,9,39,22,17,34762017
14658,1568,1801800,1,9,39,23,585,34763585
14659,418,1801800,5,9,39,24,3,34764003
14660,9,1801800,4,9,39,24,12,34764012
14661,762,1801800,1,9,39,24,774,34764774
14662,0,1801800,2,9,39,24,774,34764774
14663,1,1801900,3,9,39,24,775,34764775
14664,108,1801800,1,9,39,24,883,34764883
14665,58,1801900,1,9,39,24,941,34764941
14666,621,1801800,1,9,39,25,562,34765562
14667,688,1802000,1,9,39,26,250,34766250
14668,119,1801800,1,9,39,26,369,34766369
14669,620,1802000,1,9,39,26,989,34766989
14670,2377,1801700,1,9,39,29,366,34769366
14671,328,1801800,5,9,39,29,694,34769694
14672,114,1801800,1,9,39,29,808,34769808
14673,199,1801900,1,9,39,30,7,34770007
14674,2776,1801900,2,9,39,32,783,34772783
14675,0,1801900,1,9,39,32,783,34772783
14676,59,1801900,1,9,39,32,842,34772842
14677,2234,1802000,1,9,39,35,76,34775076
14678,810,1802000,2,9,39,35,886,34775886
14679,94,1802000,1,9,39,35,980,34775980
14680,2063,1801900,1,9,39,38,43,34778043
14681,2890,1801900,2,9,39,40,933,34780933
14682,1830,1801900,2,9,39,42,763,34782763
14683,316,1801900,1,9,39,43,79,34783079
14684,220,1802000,3,9,39,43,299,34783299
14685,23,1802000,2,9,39,43,322,34783322
14686,0,1802000,11,9,39,43,322,34783322
14687,0,1802000,1,9,39,43,322,34783322
14688,0,1802000,12,9,39,43,322,34783322
14689,0,1802000,3,9,39,43,322,34783322
14690,0,1802000,1,9,39,43,322,34783322
14691,0,1802000,4,9,39,43,322,34783322
14692,126,1802100,1,9,39,43,448,34783448
14693,54,1802000,1,9,39,43,502,34783502
14694,5,1802100,1,9,39,43,507,34783507
14695,330,1802000,1,9,39,43,837,34783837
14696,948,1802000,2,9,39,44,785,34784785
14697,50,1802000,2,9,39,44,835,34784835
14698,576,1801900,1,9,39,45,411,34785411
14699,1831,1801900,1,9,39,47,242,34787242
14700,778,1802000,1,9,39,48,20,34788020
14701,1,1802000,1,9,39,48,21,34788021
14702,47,1801900,3,9,39,48,68,34788068
14703,1559,1802000,2,9,39,49,627,34789627
14704,798,1801900,4,9,39,50,425,34790425
14705,3,1801800,5,9,39,50,428,34790428
14706,251,1801700,3,9,39,50,679,34790679
14707,47,1801700,1,9,39,50,726,34790726
14708,40,1801800,2,9,39,50,766,34790766
14709,1122,1801700,2,9,39,51,888,34791888
14710,1336,1801800,1,9,39,53,224,34793224
14711,1733,1801800,1,9,39,54,957,34794957
14712,1315,1801600,7,9,39,56,272,34796272
14713,1272,1801500,8,9,39,57,544,34797544
14714,0,1801500,5,9,39,57,544,34797544
14715,332,1801500,2,9,39,57,876,34797876
14717,2,1801700,1,9,39,57,878,34797878
14718,0,1801700,1,9,39,57,878,34797878
14719,0,1801700,1,9,39,57,878,34797878
14720,0,1801700,2,9,39,57,878,34797878
14721,0,1801700,3,9,39,57,878,34797878
14722,1,1801700,2,9,39,57,879,34797879
14724,1,1801700,1,9,39,57,880,34797880
14725,0,1801700,1,9,39,57,880,34797880
14726,0,1801700,1,9,39,57,880,34797880
14727,1,1801700,1,9,39,57,881,34797881
14728,1,1801700,1,9,39,57,882,34797882
14729,3,1801700,1,9,39,57,885,34797885
14730,39,1801700,1,9,39,57,924,34797924
14731,399,1801700,1,9,39,58,323,34798323
14732,138,1801700,2,9,39,58,461,34798461
14733,22,1801800,1,9,39,58,483,34798483
14734,733,1801900,1,9,39,59,216,34799216
14735,1,1801900,2,9,39,59,217,34799217
14736,0,1802000,1,9,39,59,217,34799217
14737,1,1802000,3,9,39,59,218,34799218
14738,162,1802100,1,9,39,59,380,34799380
14739,548,1802000,2,9,39,59,928,34799928
14740,117,1801900,2,9,40,0,45,34800045
14741,166,1801900,1,9,40,0,211,34800211
14742,183,1801900,1,9,40,0,394,34800394
14743,31,1802000,2,9,40,0,425,34800425
14744,567,1802000,1,9,40,0,992,34800992
14745,182,1801900,1,9,40,1,174,34801174
14746,5,1801900,1,9,40,1,179,34801179
14747,3,1801900,1,9,40,1,182,34801182
14748,304,1801900,1,9,40,1,486,34801486
14749,230,1801900,1,9,40,1,716,34801716
14750,1033,1801700,1,9,40,2,749,34802749
14751,369,1801700,1,9,40,3,118,34803118
14752,1429,1801600,1,9,40,4,547,34804547
14753,138,1801600,1,9,40,4,685,34804685
14754,270,1801700,4,9,40,4,955,34804955
14755,207,1801800,1,9,40,5,162,34805162
14756,124,1801900,4,9,40,5,286,34805286
14757,219,1801900,2,9,40,5,505,34805505
14759,3316,1801900,2,9,40,8,821,34808821
14760,331,1802000,1,9,40,9,152,34809152
14761,772,1801900,1,9,40,9,924,34809924
14762,500,1801900,2,9,40,10,424,34810424
14763,499,1801900,1,9,40,10,923,34810923
14764,169,1802000,1,9,40,11,92,34811092
14765,179,1801900,2,9,40,11,271,34811271
14766,0,1801900,1,9,40,11,271,34811271
14767,59,1801800,3,9,40,11,330,34811330
14768,0,1801800,3,9,40,11,330,34811330
14769,1,1801700,9,9,40,11,331,34811331
14770,323,1801600,1,9,40,11,654,34811654
14771,97,1801600,83,9,40,11,751,34811751
14772,1,1801500,1,9,40,11,752,34811752
14773,1,1801500,7,9,40,11,753,34811753
14774,50,1801400,5,9,40,11,803,34811803
14775,13,1801500,1,9,40,11,816,34811816
14776,41,1801400,2,9,40,11,857,34811857
14778,150,1801500,4,9,40,12,7,34812007
14779,59,1801400,1,9,40,12,66,34812066
14780,22,1801600,8,9,40,12,88,34812088
14781,52,1801400,1,9,40,12,140,34812140
14782,1190,1801300,1,9,40,13,330,34813330
14783,107,1801400,5,9,40,13,437,34813437
14784,98,1801400,2,9,40,13,535,34813535
14785,1242,1801500,1,9,40,14,777,34814777
14787,873,1801400,11,9,40,15,650,34815650
14788,0,1801400,11,9,40,15,650,34815650
14789,0,1801400,11,9,40,15,650,34815650
14790,0,1801400,11,9,40,15,650,34815650
14792,6,1801100,1,9,40,15,656,34815656
14793,1,1801100,5,9,40,15,657,34815657
14794,2,1801100,6,9,40,15,659,34815659
14795,0,1801100,1,9,40,15,659,34815659
14796,1,1801200,6,9,40,15,660,34815660
14797,2,1801300,1,9,40,15,662,34815662
14798,2,1801300,2,9,40,15,664,34815664
14799,28,1801200,2,9,40,15,692,34815692
14800,0,1801200,2,9,40,15,692,34815692
14801,1,1801200,2,9,40,15,693,34815693
14802,6,1801200,2,9,40,15,699,34815699
14803,8,1801100,1,9,40,15,707,34815707
14804,45,1801200,3,9,40,15,752,34815752
14805,27,1801100,3,9,40,15,779,34815779
14806,727,1801100,1,9,40,16,506,34816506
14807,1,1801200,2,9,40,16,507,34816507
14808,20,1801300,1,9,40,16,527,34816527
14809,791,1801300,1,9,40,17,318,34817318
14810,72,1801300,1,9,40,17,390,34817390
14811,468,1801300,2,9,40,17,858,34817858
14812,1435,1801300,2,9,40,19,293,34819293
14813,644,1801300,1,9,40,19,937,34819937
14814,30,1801300,2,9,40,19,967,34819967
14815,1401,1801300,1,9,40,21,368,34821368
14816,164,1801200,8,9,40,21,532,34821532
14817,703,1801100,1,9,40,22,235,34822235
14818,203,1801100,1,9,40,22,438,34822438
14819,95,1801000,2,9,40,22,533,34822533
14820,16,1801100,1,9,40,22,549,34822549
14821,1149,1801000,3,9,40,23,698,34823698
14822,393,1801000,1,9,40,24,91,34824091
14823,149,1801000,1,9,40,24,240,34824240
14824,8,1801000,2,9,40,24,248,34824248
14825,453,1801000,1,9,40,24,701,34824701
14826,12,1801100,1,9,40,24,713,34824713
14827,85,1801100,3,9,40,24,798,34824798
14829,328,1801200,2,9,40,25,126,34825126
14831,202,1801200,1,9,40,25,328,34825328
14832,723,1801300,1,9,40,26,51,34826051
14833,848,1801200,1,9,40,26,899,34826899
14834,130,1801400,1,9,40,27,29,34827029
14835,396,1801400,1,9,40,27,425,34827425
14836,1,1801400,1,9,40,27,426,34827426
14837,0,1801400,1,9,40,27,426,34827426
14838,909,1801500,1,9,40,28,335,34828335
14839,184,1801600,2,9,40,28,519,34828519
14840,357,1801600,1,9,40,28,876,34828876
14841,225,1801600,1,9,40,29,101,34829101
14842,948,1801700,1,9,40,30,49,34830049
14843,285,1801600,1,9,40,30,334,34830334
14844,1560,1801600,1,9,40,31,894,34831894
14845,962,1801700,2,9,40,32,856,34832856
14846,256,1801800,4,9,40,33,112,34833112
14847,373,1801900,2,9,40,33,485,34833485
14848,512,1802000,1,9,40,33,997,34833997
14849,173,1801900,1,9,40,34,170,34834170
14850,657,1801900,1,9,40,34,827,34834827
14851,1624,1802000,5,9,40,36,451,34836451
14852,238,1802000,5,9,40,36,689,34836689
14853,325,1802000,2,9,40,37,14,34837014
14854,220,1802000,4,9,40,37,234,34837234
14855,38,1802000,2,9,40,37,272,34837272
14856,444,1802000,1,9,40,37,716,34837716
14857,228,1802000,1,9,40,37,944,34837944
14858,785,1802000,1,9,40,38,729,34838729
14859,26,1802000,1,9,40,38,755,34838755
14860,1,1802100,1,9,40,38,756,34838756
14861,1427,1802000,1,9,40,40,183,34840183
14862,61,1802000,2,9,40,40,244,34840244
14863,0,1802000,1,9,40,40,244,34840244
14864,646,1802000,1,9,40,40,890,34840890
14865,11,1802000,1,9,40,40,901,34840901
14866,378,1802000,1,9,40,41,279,34841279
14867,1201,1801900,1,9,40,42,480,34842480
14868,20,1801900,1,9,40,42,500,34842500
14869,1832,1801900,1,9,40,44,332,34844332
14870,2790,1801900,1,9,40,47,122,34847122
14871,209,1801900,1,9,40,47,331,34847331
14872,268,1801800,2,9,40,47,599,34847599
14873,1,1801800,4,9,40,47,600,34847600
14874,0,1801800,1,9,40,47,600,34847600
14875,0,1801800,1,9,40,47,600,34847600
14876,974,1801800,1,9,40,48,574,34848574
14878,1599,1802000,1,9,40,50,173,34850173
14879,1747,1801900,1,9,40,51,920,34851920
14880,1781,1801700,1,9,40,53,701,34853701
14881,80,1801700,2,9,40,53,781,34853781
14882,188,1801700,1,9,40,53,969,34853969
14883,0,1801700,1,9,40,53,969,34853969
14884,1646,1801800,1,9,40,55,615,34855615
14885,1104,1801700,1,9,40,56,719,34856719
14886,1204,1801600,1,9,40,57,923,34857923
14887,267,1801700,4,9,40,58,190,34858190
14888,1276,1801700,1,9,40,59,466,34859466
14889,544,1801700,1,9,41,0,10,34860010
14890,71,1801600,7,9,41,0,81,34860081
14891,7,1801500,2,9,41,0,88,34860088
14892,28,1801400,2,9,41,0,116,34860116
14893,2,1801500,1,9,41,0,118,34860118
14894,108,1801600,1,9,41,0,226,34860226
14895,1660,1801300,1,9,41,1,886,34861886
14896,536,1801300,1,9,41,2,422,34862422
14897,1690,1801400,1,9,41,4,112,34864112
14898,809,1801500,1,9,41,4,921,34864921
14899,216,1801700,1,9,41,5,137,34865137
14900,172,1801700,1,9,41,5,309,34865309
14901,1786,1801700,1,9,41,7,95,34867095
14902,1511,1801600,1,9,41,8,606,34868606
14903,439,1801700,5,9,41,9,45,34869045
14905,415,1801800,2,9,41,9,460,34869460
14906,0,1801800,2,9,41,9,460,34869460
14908,86,1801800,5,9,41,9,546,34869546
14910,450,1801700,1,9,41,9,996,34869996
14911,587,1801800,3,9,41,10,583,34870583
14913,3539,1801900,3,9,41,14,122,34874122
14914,1522,1802000,1,9,41,15,644,34875644
14915,311,1801800,2,9,41,15,955,34875955
14916,696,1802000,1,9,41,16,651,34876651
14917,145,1802000,2,9,41,16,796,34876796
14918,1078,1802000,17,9,41,17,874,34877874
14919,4,1802100,3,9,41,17,878,34877878
14920,528,1802100,2,9,41,18,406,34878406
14921,809,1802000,1,9,41,19,215,34879215
14922,823,1802100,13,9,41,20,38,34880038
14923,419,1802200,1,9,41,20,457,34880457
14924,64,1802200,7,9,41,20,521,34880521
14925,1,1802200,1,9,41,20,522,34880522
14926,0,1802200,1,9,41,20,522,34880522
14927,0,1802200,9,9,41,20,522,34880522
14928,0,1802200,5,9,41,20,522,34880522
14929,0,1802200,1,9,41,20,522,34880522
14930,0,1802200,4,9,41,20,522,34880522
14931,955,1802300,1,9,41,21,477,34881477
14932,79,1802200,1,9,41,21,556,34881556
14933,397,1802200,4,9,41,21,953,34881953
14934,163,1802200,3,9,41,22,116,34882116
14935,250,1802200,2,9,41,22,366,34882366
14936,11,1802200,1,9,41,22,377,34882377
14937,89,1802100,1,9,41,22,466,34882466
14939,10,1802000,2,9,41,22,476,34882476
14940,84,1802000,1,9,41,22,560,34882560
14941,594,1802000,1,9,41,23,154,34883154
14942,557,1801900,1,9,41,23,711,34883711
14943,892,1801900,3,9,41,24,603,34884603
14945,546,1802000,52,9,41,25,149,34885149
14946,2,1802100,1,9,41,25,151,34885151
14947,0,1802100,1,9,41,25,151,34885151
14948,354,1802100,1,9,41,25,505,34885505
14949,2473,1802200,2,9,41,27,978,34887978
14950,125,1802200,12,9,41,28,103,34888103
14951,124,1802200,1,9,41,28,227,34888227
14952,148,1802200,2,9,41,28,375,34888375
14954,673,1802200,1,9,41,29,48,34889048
14955,22,1802200,1,9,41,29,70,34889070
14956,273,1802100,1,9,41,29,343,34889343
14957,176,1802100,2,9,41,29,519,34889519
14958,31,1802300,1,9,41,29,550,34889550
14959,127,1802100,3,9,41,29,677,34889677
14961,3,1802000,46,9,41,29,680,34889680
14962,3,1801900,5,9,41,29,683,34889683
14963,548,1801800,14,9,41,30,231,34890231
14964,351,1801800,1,9,41,30,582,34890582
14965,501,1801700,1,9,41,31,83,34891083
14966,1079,1801800,1,9,41,32,162,34892162
14967,223,1801800,3,9,41,32,385,34892385
14968,1,1801800,2,9,41,32,386,34892386
14969,1092,1801900,1,9,41,33,478,34893478
14970,751,1801900,1,9,41,34,229,34894229
14971,17,1801900,1,9,41,34,246,34894246
14973,481,1801800,4,9,41,34,727,34894727
14975,1046,1801800,3,9,41,35,773,34895773
14977,1357,1801900,1,9,41,37,130,34897130
14978,72,1801800,1,9,41,37,202,34897202
14979,1061,1802000,1,9,41,38,263,34898263
14980,347,1802000,1,9,41,38,610,34898610
14981,74,1802100,1,9,41,38,684,34898684
14982,1010,1802100,2,9,41,39,694,34899694
14983,45,1802100,5,9,41,39,739,34899739
14984,222,1802000,1,9,41,39,961,34899961
14985,752,1802100,1,9,41,40,713,34900713
14986,346,1802100,1,9,41,41,59,34901059
14987,1354,1802100,2,9,41,42,413,34902413
14988,695,1802100,1,9,41,43,108,34903108
14989,40,1802100,1,9,41,43,148,34903148
14990,215,1802200,1,9,41,43,363,34903363
14991,571,1802200,1,9,41,43,934,34903934
14992,1,1802200,7,9,41,43,935,34903935
14993,2043,1802100,1,9,41,45,978,34905978
14994,406,1802100,2,9,41,46,384,34906384
14995,391,1802100,4,9,41,46,775,34906775
14997,42,1801900,2,9,41,46,817,34906817
14998,0,1801900,1,9,41,46,817,34906817
14999,0,1801800,2,9,41,46,817,34906817
15000,1,1801800,1,9,41,46,818,34906818
15001,7,1801900,1,9,41,46,825,34906825
15002,199,1801800,1,9,41,47,24,34907024
15003,145,1801900,2,9,41,47,169,34907169
15004,37,1801800,1,9,41,47,206,34907206
15005,2038,1802000,4,9,41,49,244,34909244
15006,2,1802000,43,9,41,49,246,34909246
15007,2,1802100,1,9,41,49,248,34909248
15008,0,1802100,1,9,41,49,248,34909248
15009,1861,1801900,1,9,41,51,109,34911109
15010,2482,1802000,1,9,41,53,591,34913591
15011,44,1802100,2,9,41,53,635,34913635
15012,708,1802000,1,9,41,54,343,34914343
15013,3230,1802000,3,9,41,57,573,34917573
15014,1118,1802000,1,9,41,58,691,34918691
15015,1296,1802000,1,9,41,59,987,34919987
15016,3848,1801900,4,9,42,3,835,34923835
15017,109,1801900,1,9,42,3,944,34923944
15018,1095,1801800,5,9,42,5,39,34925039
15019,173,1801700,1,9,42,5,212,34925212
15020,271,1801800,1,9,42,5,483,34925483
15021,50,1801900,1,9,42,5,533,34925533
15022,1789,1802000,1,9,42,7,322,34927322
15024,232,1801900,1,9,42,7,554,34927554
15025,4199,1801900,1,9,42,11,753,34931753
15026,810,1801900,1,9,42,12,563,34932563
15027,971,1801900,3,9,42,13,534,34933534
15028,1305,1801800,2,9,42,14,839,34934839
15029,2053,1801900,4,9,42,16,892,34936892
15030,1,1801800,1,9,42,16,893,34936893
15031,0,1801800,1,9,42,16,893,34936893
15032,2,1801900,1,9,42,16,895,34936895
15033,334,1801800,1,9,42,17,229,34937229
15034,719,1801800,1,9,42,17,948,34937948
15035,0,1801800,1,9,42,17,948,34937948
15036,292,1801800,1,9,42,18,240,34938240
15037,1797,1801800,1,9,42,20,37,34940037
15038,1364,1801800,1,9,42,21,401,34941401
15039,7,1801700,7,9,42,21,408,34941408
15040,12,1801700,1,9,42,21,420,34941420
15041,0,1801700,1,9,42,21,420,34941420
15042,3140,1801600,6,9,42,24,560,34944560
15043,1,1801600,1,9,42,24,561,34944561
15044,20,1801500,1,9,42,24,581,34944581
15045,1,1801500,1,9,42,24,582,34944582
15046,0,1801500,1,9,42,24,582,34944582
15047,0,1801500,1,9,42,24,582,34944582
15048,0,1801500,1,9,42,24,582,34944582
15049,44,1801600,1,9,42,24,626,34944626
15050,50,1801500,1,9,42,24,676,34944676
15051,0,1801400,4,9,42,24,676,34944676
15052,141,1801500,1,9,42,24,817,34944817
15053,33,1801500,1,9,42,24,850,34944850
15054,546,1801600,3,9,42,25,396,34945396
15055,1,1801600,3,9,42,25,397,34945397
15056,1938,1801400,3,9,42,27,335,34947335
15057,0,1801400,2,9,42,27,335,34947335
15058,802,1801500,2,9,42,28,137,34948137
15059,1,1801500,1,9,42,28,138,34948138
15060,28,1801400,5,9,42,28,166,34948166
15061,24,1801400,1,9,42,28,190,34948190
15062,306,1801500,1,9,42,28,496,34948496
15063,126,1801500,1,9,42,28,622,34948622
15064,44,1801600,1,9,42,28,666,34948666
15065,1629,1801700,1,9,42,30,295,34950295
15066,378,1801700,2,9,42,30,673,34950673
15067,628,1801800,3,9,42,31,301,34951301
15068,782,1801600,1,9,42,32,83,34952083
15069,117,1801700,1,9,42,32,200,34952200
15070,2999,1801700,1,9,42,35,199,34955199
15071,1,1801600,1,9,42,35,200,34955200
15072,2499,1801600,1,9,42,37,699,34957699
15073,2293,1801600,4,9,42,39,992,34959992
15074,53,1801600,2,9,42,40,45,34960045
15076,41,1801400,2,9,42,40,86,34960086
15077,1,1801400,4,9,42,40,87,34960087
15078,837,1801600,2,9,42,40,924,34960924
15079,0,1801600,4,9,42,40,924,34960924
15080,1848,1801500,2,9,42,42,772,34962772
15081,381,1801400,3,9,42,43,153,34963153
15083,263,1801500,1,9,42,43,416,34963416
15084,461,1801400,2,9,42,43,877,34963877
15085,1541,1801500,1,9,42,45,418,34965418
15086,3,1801500,1,9,42,45,421,34965421
15087,201,1801400,5,9,42,45,622,34965622
15088,295,1801500,1,9,42,45,917,34965917
15089,728,1801300,1,9,42,46,645,34966645
15090,3,1801300,2,9,42,46,648,34966648
15091,49,1801300,1,9,42,46,697,34966697
15092,309,1801300,1,9,42,47,6,34967006
15093,83,1801300,1,9,42,47,89,34967089
15094,261,1801200,2,9,42,47,350,34967350
15095,51,1801300,1,9,42,47,401,34967401
15096,1,1801100,7,9,42,47,402,34967402
15097,78,1801200,1,9,42,47,480,34967480
15098,95,1801200,1,9,42,47,575,34967575
15099,42,1801200,1,9,42,47,617,34967617
15100,101,1801200,1,9,42,47,718,34967718
15101,201,1801200,2,9,42,47,919,34967919
15102,1147,1801300,1,9,42,49,66,34969066
15103,697,1801400,2,9,42,49,763,34969763
15104,90,1801300,2,9,42,49,853,34969853
15105,1572,1801300,5,9,42,51,425,34971425
15106,2,1801300,1,9,42,51,427,34971427
15107,2,1801300,1,9,42,51,429,34971429
15108,2,1801300,1,9,42,51,431,34971431
15109,145,1801400,1,9,42,51,576,34971576
15110,314,1801400,1,9,42,51,890,34971890
15111,375,1801300,1,9,42,52,265,34972265
15112,500,1801300,1,9,42,52,765,34972765
15113,402,1801300,1,9,42,53,167,34973167
15114,44,1801500,1,9,42,53,211,34973211
15115,1513,1801500,7,9,42,54,724,34974724
15116,1524,1801400,2,9,42,56,248,34976248
15117,1968,1801500,1,9,42,58,216,34978216
15118,1260,1801400,1,9,42,59,476,34979476
15119,301,1801500,1,9,42,59,777,34979777
15120,266,1801600,1,9,43,0,43,34980043
15121,164,1801600,1,9,43,0,207,34980207
15122,154,1801600,1,9,43,0,361,34980361
15123,62,1801400,1,9,43,0,423,34980423
15124,209,1801600,1,9,43,0,632,34980632
15125,265,1801400,3,9,43,0,897,34980897
15126,729,1801300,1,9,43,1,626,34981626
15127,189,1801300,1,9,43,1,815,34981815
15128,171,1801300,1,9,43,1,986,34981986
15129,180,1801500,1,9,43,2,166,34982166
15130,567,1801500,3,9,43,2,733,34982733
15131,355,1801400,1,9,43,3,88,34983088
15132,537,1801500,2,9,43,3,625,34983625
15133,540,1801500,1,9,43,4,165,34984165
15134,196,1801500,2,9,43,4,361,34984361
15135,166,1801600,2,9,43,4,527,34984527
15136,393,1801500,1,9,43,4,920,34984920
15137,87,1801500,1,9,43,5,7,34985007
15138,770,1801500,1,9,43,5,777,34985777
15139,699,1801500,1,9,43,6,476,34986476
15140,1034,1801400,1,9,43,7,510,34987510
15141,2657,1801600,1,9,43,10,167,34990167
15142,771,1801400,1,9,43,10,938,34990938
15143,330,1801600,1,9,43,11,268,34991268
15144,737,1801400,5,9,43,12,5,34992005
15145,125,1801500,1,9,43,12,130,34992130
15146,42,1801500,1,9,43,12,172,34992172
15147,537,1801500,1,9,43,12,709,34992709
15148,2607,1801500,1,9,43,15,316,34995316
15149,858,1801600,1,9,43,16,174,34996174
15150,501,1801500,1,9,43,16,675,34996675
15151,257,1801500,1,9,43,16,932,34996932
15152,182,1801400,1,9,43,17,114,34997114
15153,596,1801600,1,9,43,17,710,34997710
15154,0,1801600,6,9,43,17,710,34997710
15155,289,1801600,1,9,43,17,999,34997999
15156,2178,1801600,1,9,43,20,177,35000177
15157,1136,1801800,6,9,43,21,313,35001313
15158,77,1801900,1,9,43,21,390,35001390
15159,45,1801800,1,9,43,21,435,35001435
15160,2197,1801800,2,9,43,23,632,35003632
15161,0,1801800,2,9,43,23,632,35003632
15163,297,1801800,5,9,43,23,929,35003929
15164,644,1801700,1,9,43,24,573,35004573
15165,1758,1801800,6,9,43,26,331,35006331
15167,2,1801800,1,9,43,26,333,35006333
15168,1208,1801900,9,9,43,27,541,35007541
15170,191,1801700,1,9,43,27,732,35007732
15171,1500,1801900,1,9,43,29,232,35009232
15172,667,1801800,1,9,43,29,899,35009899
15173,1688,1801800,1,9,43,31,587,35011587
15174,985,1801900,1,9,43,32,572,35012572
15175,2057,1802000,1,9,43,34,629,35014629
15176,0,1802000,1,9,43,34,629,35014629
15177,0,1802000,1,9,43,34,629,35014629
15178,0,1802000,1,9,43,34,629,35014629
15179,0,1802000,1,9,43,34,629,35014629
15180,0,1802000,2,9,43,34,629,35014629
15181,0,1802000,9,9,43,34,629,35014629
15182,716,1802100,1,9,43,35,345,35015345
15183,228,1802000,1,9,43,35,573,35015573
15184,0,1802100,3,9,43,35,573,35015573
15185,1254,1802100,1,9,43,36,827,35016827
15186,10,1802100,5,9,43,36,837,35016837
15187,205,1802200,1,9,43,37,42,35017042
15188,131,1802000,1,9,43,37,173,35017173
15189,386,1802000,1,9,43,37,559,35017559
15190,588,1802100,1,9,43,38,147,35018147
15191,156,1802100,6,9,43,38,303,35018303
15192,699,1802200,1,9,43,39,2,35019002
15193,387,1802100,1,9,43,39,389,35019389
15194,938,1802200,1,9,43,40,327,35020327
15195,735,1802100,1,9,43,41,62,35021062
15196,1,1802200,1,9,43,41,63,35021063
15197,1,1802100,1,9,43,41,64,35021064
15198,560,1802100,1,9,43,41,624,35021624
15199,207,1802000,1,9,43,41,831,35021831
15200,458,1802000,2,9,43,42,289,35022289
15201,0,1802000,1,9,43,42,289,35022289
15202,0,1802000,1,9,43,42,289,35022289
15203,0,1802000,5,9,43,42,289,35022289
15204,1,1802000,1,9,43,42,290,35022290
15205,0,1802000,2,9,43,42,290,35022290
15206,75,1802000,1,9,43,42,365,35022365
15207,164,1802000,1,9,43,42,529,35022529
15208,1634,1802000,1,9,43,44,163,35024163
15209,1008,1802000,1,9,43,45,171,35025171
15210,679,1802000,1,9,43,45,850,35025850
15211,1392,1802000,1,9,43,47,242,35027242
15212,844,1802000,2,9,43,48,86,35028086
15213,1505,1802000,1,9,43,49,591,35029591
15214,23,1802000,1,9,43,49,614,35029614
15215,659,1802000,1,9,43,50,273,35030273
15216,2014,1802000,1,9,43,52,287,35032287
15217,0,1802000,1,9,43,52,287,35032287
15218,2062,1801900,1,9,43,54,349,35034349
15219,178,1801900,5,9,43,54,527,35034527
15220,3416,1802000,1,9,43,57,943,35037943
15221,17,1802100,1,9,43,57,960,35037960
15222,17,1802000,1,9,43,57,977,35037977
15223,670,1802100,1,9,43,58,647,35038647
15224,538,1802000,1,9,43,59,185,35039185
15225,352,1802100,1,9,43,59,537,35039537
15226,92,1801900,1,9,43,59,629,35039629
15227,204,1802000,4,9,43,59,833,35039833
15228,428,1802000,1,9,44,0,261,35040261
15229,450,1802100,1,9,44,0,711,35040711
15230,329,1802100,16,9,44,1,40,35041040
15231,105,1802100,1,9,44,1,145,35041145
15232,335,1802100,1,9,44,1,480,35041480
15233,53,1802200,1,9,44,1,533,35041533
15234,632,1802200,5,9,44,2,165,35042165
15235,0,1802200,3,9,44,2,165,35042165
15236,0,1802200,11,9,44,2,165,35042165
15237,1,1802200,1,9,44,2,166,35042166
15238,0,1802200,3,9,44,2,166,35042166
15239,43,1802200,5,9,44,2,209,35042209
15240,0,1802200,1,9,44,2,209,35042209
15241,0,1802200,1,9,44,2,209,35042209
15242,0,1802200,1,9,44,2,209,35042209
15243,412,1802200,5,9,44,2,621,35042621
15244,1,1802200,2,9,44,2,622,35042622
15245,70,1802300,4,9,44,2,692,35042692
15246,0,1802300,3,9,44,2,692,35042692
15247,0,1802300,1,9,44,2,692,35042692
15248,0,1802300,1,9,44,2,692,35042692
15249,1,1802300,7,9,44,2,693,35042693
15250,0,1802300,8,9,44,2,693,35042693
15251,1,1802300,11,9,44,2,694,35042694
15252,0,1802300,1,9,44,2,694,35042694
15253,0,1802300,1,9,44,2,694,35042694
15254,0,1802300,4,9,44,2,694,35042694
15255,1,1802300,3,9,44,2,695,35042695
15256,0,1802300,1,9,44,2,695,35042695
15257,0,1802300,3,9,44,2,695,35042695
15258,27,1802400,1,9,44,2,722,35042722
15259,0,1802400,4,9,44,2,722,35042722
15260,0,1802400,8,9,44,2,722,35042722
15261,0,1802400,1,9,44,2,722,35042722
15262,1,1802400,7,9,44,2,723,35042723
15263,0,1802400,1,9,44,2,723,35042723
15264,0,1802400,1,9,44,2,723,35042723
15265,0,1802400,1,9,44,2,723,35042723
15266,0,1802400,1,9,44,2,723,35042723
15267,0,1802400,1,9,44,2,723,35042723
15268,2,1802400,2,9,44,2,725,35042725
15269,5,1802400,5,9,44,2,730,35042730
15270,1,1802400,1,9,44,2,731,35042731
15271,19,1802400,1,9,44,2,750,35042750
15272,0,1802400,1,9,44,2,750,35042750
15273,1,1802400,1,9,44,2,751,35042751
15274,0,1802400,1,9,44,2,751,35042751
15275,0,1802400,1,9,44,2,751,35042751
15276,0,1802400,1,9,44,2,751,35042751
15277,0,1802400,1,9,44,2,751,35042751
15278,1,1802400,1,9,44,2,752,35042752
15279,87,1802400,1,9,44,2,839,35042839
15280,19,1802300,1,9,44,2,858,35042858
15281,0,1802400,1,9,44,2,858,35042858
15282,97,1802500,2,9,44,2,955,35042955
15283,50,1802500,2,9,44,3,5,35043005
15284,6,1802400,1,9,44,3,11,35043011
15285,2,1802500,1,9,44,3,13,35043013
15286,4,1802500,1,9,44,3,17,35043017
15287,33,1802500,5,9,44,3,50,35043050
15288,182,1802500,1,9,44,3,232,35043232
15289,39,1802500,2,9,44,3,271,35043271
15290,79,1802500,1,9,44,3,350,35043350
15291,7,1802500,1,9,44,3,357,35043357
15292,178,1802400,1,9,44,3,535,35043535
15293,114,1802500,1,9,44,3,649,35043649
15294,26,1802500,1,9,44,3,675,35043675
15295,29,1802500,1,9,44,3,704,35043704
15296,18,1802400,1,9,44,3,722,35043722
15297,85,1802500,1,9,44,3,807,35043807
15298,22,1802500,2,9,44,3,829,35043829
15299,90,1802500,1,9,44,3,919,35043919
15300,20,1802500,1,9,44,3,939,35043939
15301,66,1802500,1,9,44,4,5,35044005
15302,63,1802500,1,9,44,4,68,35044068
15303,4,1802500,1,9,44,4,72,35044072
15304,6,1802500,1,9,44,4,78,35044078
15305,2,1802500,1,9,44,4,80,35044080
15306,3,1802500,1,9,44,4,83,35044083
15307,5,1802500,1,9,44,4,88,35044088
15308,0,1802500,2,9,44,4,88,35044088
15309,279,1802400,1,9,44,4,367,35044367
15310,236,1802500,1,9,44,4,603,35044603
15311,0,1802500,1,9,44,4,603,35044603
15312,8,1802500,1,9,44,4,611,35044611
15313,266,1802500,1,9,44,4,877,35044877
15314,210,1802500,1,9,44,5,87,35045087
15316,52,1802300,1,9,44,5,139,35045139
15317,239,1802400,2,9,44,5,378,35045378
15318,91,1802400,1,9,44,5,469,35045469
15319,1,1802400,1,9,44,5,470,35045470
15320,1,1802400,1,9,44,5,471,35045471
15321,0,1802500,1,9,44,5,471,35045471
15322,7,1802500,1,9,44,5,478,35045478
15323,60,1802300,3,9,44,5,538,35045538
15324,618,1802300,2,9,44,6,156,35046156
15325,93,1802400,1,9,44,6,249,35046249
15326,35,1802400,4,9,44,6,284,35046284
15328,448,1802500,1,9,44,6,732,35046732
15329,524,1802500,1,9,44,7,256,35047256
15330,651,1802500,1,9,44,7,907,35047907
15331,601,1802500,1,9,44,8,508,35048508
15332,75,1802500,2,9,44,8,583,35048583
15333,16,1802600,5,9,44,8,599,35048599
15334,151,1802600,3,9,44,8,750,35048750
15335,3,1802700,1,9,44,8,753,35048753
15336,75,1802700,1,9,44,8,828,35048828
15337,1,1802700,1,9,44,8,829,35048829
15338,16,1802600,1,9,44,8,845,35048845
15340,34,1802700,2,9,44,8,879,35048879
15341,2,1802700,1,9,44,8,881,35048881
15342,12,1802700,2,9,44,8,893,35048893
15343,2,1802700,2,9,44,8,895,35048895
15344,1,1802700,2,9,44,8,896,35048896
15345,150,1802700,4,9,44,9,46,35049046
15346,134,1802700,1,9,44,9,180,35049180
15347,5,1802700,1,9,44,9,185,35049185
15348,1,1802500,1,9,44,9,186,35049186
15349,518,1802500,1,9,44,9,704,35049704
15350,93,1802700,1,9,44,9,797,35049797
15351,283,1802500,1,9,44,10,80,35050080
15352,32,1802600,1,9,44,10,112,35050112
15353,198,1802700,5,9,44,10,310,35050310
15354,151,1802600,1,9,44,10,461,35050461
15355,144,1802700,2,9,44,10,605,35050605
15356,470,1802700,1,9,44,11,75,35051075
15357,0,1802700,2,9,44,11,75,35051075
15358,445,1802700,1,9,44,11,520,35051520
15359,34,1802700,1,9,44,11,554,35051554
15360,6,1802700,1,9,44,11,560,35051560
15361,198,1802700,1,9,44,11,758,35051758
15362,173,1802700,3,9,44,11,931,35051931
15363,0,1802700,7,9,44,11,931,35051931
15364,273,1802700,1,9,44,12,204,35052204
15365,51,1802600,1,9,44,12,255,35052255
15366,153,1802600,1,9,44,12,408,35052408
15367,0,1802600,1,9,44,12,408,35052408
15368,0,1802600,6,9,44,12,408,35052408
15369,8,1802600,1,9,44,12,416,35052416
15370,356,1802600,1,9,44,12,772,35052772
15371,6,1802600,1,9,44,12,778,35052778
15372,364,1802600,1,9,44,13,142,35053142
15373,131,1802500,1,9,44,13,273,35053273
15374,137,1802500,1,9,44,13,410,35053410
15375,374,1802500,1,9,44,13,784,35053784
15376,92,1802600,2,9,44,13,876,35053876
15377,263,1802600,3,9,44,14,139,35054139
15378,1549,1802600,1,9,44,15,688,35055688
15379,571,1802600,1,9,44,16,259,35056259
15380,0,1802600,3,9,44,16,259,35056259
15381,1,1802600,1,9,44,16,260,35056260
15382,1154,1802700,2,9,44,17,414,35057414
15383,39,1802500,1,9,44,17,453,35057453
15384,9,1802500,2,9,44,17,462,35057462
15385,38,1802600,1,9,44,17,500,35057500
15386,20,1802700,1,9,44,17,520,35057520
15387,809,1802700,1,9,44,18,329,35058329
15388,545,1802600,9,9,44,18,874,35058874
15389,0,1802600,9,9,44,18,874,35058874
15391,39,1802500,1,9,44,18,913,35058913
15392,82,1802600,1,9,44,18,995,35058995
15393,220,1802600,1,9,44,19,215,35059215
15394,1010,1802500,1,9,44,20,225,35060225
15395,472,1802500,1,9,44,20,697,35060697
15396,27,1802500,1,9,44,20,724,35060724
15397,376,1802400,1,9,44,21,100,35061100
15398,105,1802300,1,9,44,21,205,35061205
15399,170,1802400,1,9,44,21,375,35061375
15400,261,1802400,1,9,44,21,636,35061636
15401,349,1802300,1,9,44,21,985,35061985
15402,1350,1802500,3,9,44,23,335,35063335
15403,35,1802500,2,9,44,23,370,35063370
15405,848,1802600,1,9,44,24,218,35064218
15406,853,1802600,1,9,44,25,71,35065071
15407,278,1802600,1,9,44,25,349,35065349
15408,634,1802500,1,9,44,25,983,35065983
15409,315,1802500,1,9,44,26,298,35066298
15410,665,1802500,1,9,44,26,963,35066963
15411,557,1802400,1,9,44,27,520,35067520
15412,725,1802400,2,9,44,28,245,35068245
15413,274,1802400,1,9,44,28,519,35068519
15414,552,1802300,1,9,44,29,71,35069071
15415,2873,1802300,1,9,44,31,944,35071944
15416,540,1802400,1,9,44,32,484,35072484
15417,2963,1802400,1,9,44,35,447,35075447
15418,1646,1802400,1,9,44,37,93,35077093
15419,1554,1802400,1,9,44,38,647,35078647
15420,399,1802500,1,9,44,39,46,35079046
15421,852,1802500,1,9,44,39,898,35079898
15422,85,1802500,1,9,44,39,983,35079983
15423,864,1802500,5,9,44,40,847,35080847
15425,281,1802500,1,9,44,41,128,35081128
15426,211,1802500,1,9,44,41,339,35081339
15427,767,1802400,1,9,44,42,106,35082106
15428,487,1802500,1,9,44,42,593,35082593
15429,759,1802400,1,9,44,43,352,35083352
15430,90,1802500,1,9,44,43,442,35083442
15431,592,1802500,1,9,44,44,34,35084034
15432,1675,1802500,1,9,44,45,709,35085709
15433,258,1802600,1,9,44,45,967,35085967
15434,824,1802500,1,9,44,46,791,35086791
15435,186,1802600,1,9,44,46,977,35086977
15436,1410,1802600,1,9,44,48,387,35088387
15437,1176,1802600,1,9,44,49,563,35089563
15438,372,1802600,1,9,44,49,935,35089935
15439,651,1802600,8,9,44,50,586,35090586
15440,413,1802700,10,9,44,50,999,35090999
15441,447,1802800,1,9,44,51,446,35091446
15442,88,1802700,1,9,44,51,534,35091534
15443,18,1802800,21,9,44,51,552,35091552
15444,0,1802800,1,9,44,51,552,35091552
15445,1,1802800,1,9,44,51,553,35091553
15446,0,1802800,2,9,44,51,553,35091553
15447,0,1802800,4,9,44,51,553,35091553
15448,0,1802800,1,9,44,51,553,35091553
15449,579,1802800,5,9,44,52,132,35092132
15450,0,1802800,5,9,44,52,132,35092132
15451,0,1802800,5,9,44,52,132,35092132
15452,0,1802800,5,9,44,52,132,35092132
15454,10,1802500,2,9,44,52,142,35092142
15455,0,1802500,1,9,44,52,142,35092142
15456,0,1802500,1,9,44,52,142,35092142
15457,19,1802600,8,9,44,52,161,35092161
15459,44,1802600,2,9,44,52,205,35092205
15460,552,1802500,1,9,44,52,757,35092757
15461,37,1802600,5,9,44,52,794,35092794
15462,734,1802500,1,9,44,53,528,35093528
15463,504,1802600,2,9,44,54,32,35094032
15464,1140,1802600,1,9,44,55,172,35095172
15465,893,1802500,1,9,44,56,65,35096065
15466,55,1802600,1,9,44,56,120,35096120
15467,62,1802600,1,9,44,56,182,35096182
15468,125,1802700,1,9,44,56,307,35096307
15469,28,1802700,1,9,44,56,335,35096335
15470,886,1802600,2,9,44,57,221,35097221
15471,745,1802700,3,9,44,57,966,35097966
15472,0,1802700,2,9,44,57,966,35097966
15473,347,1802600,1,9,44,58,313,35098313
15474,335,1802800,2,9,44,58,648,35098648
15475,472,1802700,5,9,44,59,120,35099120
15476,332,1802800,4,9,44,59,452,35099452
15477,26,1802800,2,9,44,59,478,35099478
15478,779,1802800,2,9,45,0,257,35100257
15479,16,1802800,1,9,45,0,273,35100273
15480,134,1802900,2,9,45,0,407,35100407
15481,2,1802900,6,9,45,0,409,35100409
15482,1,1802900,2,9,45,0,410,35100410
15483,0,1802900,7,9,45,0,410,35100410
15484,70,1803000,4,9,45,0,480,35100480
15485,54,1803000,1,9,45,0,534,35100534
15486,46,1803000,1,9,45,0,580,35100580
15487,37,1802800,1,9,45,0,617,35100617
15488,4,1803000,1,9,45,0,621,35100621
15489,15,1802800,1,9,45,0,636,35100636
15490,7,1802800,1,9,45,0,643,35100643
15491,3,1802800,3,9,45,0,646,35100646
15492,1,1803000,1,9,45,0,647,35100647
15493,1,1802800,1,9,45,0,648,35100648
15494,6,1803000,3,9,45,0,654,35100654
15495,3,1803000,1,9,45,0,657,35100657
15496,6,1803000,1,9,45,0,663,35100663
15497,23,1803000,1,9,45,0,686,35100686
15498,3,1803000,2,9,45,0,689,35100689
15499,7,1802800,1,9,45,0,696,35100696
15500,32,1802800,5,9,45,0,728,35100728
15502,11,1802800,3,9,45,0,739,35100739
15503,0,1802800,3,9,45,0,739,35100739
15505,7,1802800,4,9,45,0,746,35100746
15506,18,1802800,1,9,45,0,764,35100764
15507,3,1802700,1,9,45,0,767,35100767
15508,6,1802800,1,9,45,0,773,35100773
15509,31,1802900,2,9,45,0,804,35100804
15510,25,1802800,1,9,45,0,829,35100829
15511,3,1802700,1,9,45,0,832,35100832
15512,23,1802800,1,9,45,0,855,35100855
15513,15,1802900,1,9,45,0,870,35100870
15514,18,1802900,4,9,45,0,888,35100888
15515,6,1802900,1,9,45,0,894,35100894
15516,5,1802900,2,9,45,0,899,35100899
15517,33,1802900,2,9,45,0,932,35100932
15518,13,1803000,2,9,45,0,945,35100945
15519,49,1802900,2,9,45,0,994,35100994
15520,4,1802900,1,9,45,0,998,35100998
15521,8,1802900,1,9,45,1,6,35101006
15522,25,1802900,2,9,45,1,31,35101031
15523,18,1802900,1,9,45,1,49,35101049
15524,26,1802800,1,9,45,1,75,35101075
15525,1,1802800,1,9,45,1,76,35101076
15526,3,1802900,3,9,45,1,79,35101079
15527,14,1802900,1,9,45,1,93,35101093
15528,23,1802900,1,9,45,1,116,35101116
15529,6,1802900,1,9,45,1,122,35101122
15530,1,1803000,1,9,45,1,123,35101123
15531,93,1803000,1,9,45,1,216,35101216
15532,54,1803000,5,9,45,1,270,35101270
15533,5,1803000,1,9,45,1,275,35101275
15534,2,1802900,1,9,45,1,277,35101277
15535,18,1803000,1,9,45,1,295,35101295
15536,8,1802800,1,9,45,1,303,35101303
15537,27,1803000,1,9,45,1,330,35101330
15538,9,1803000,2,9,45,1,339,35101339
15539,20,1803000,1,9,45,1,359,35101359
15540,10,1803000,2,9,45,1,369,35101369
15541,27,1803000,2,9,45,1,396,35101396
15542,0,1802800,2,9,45,1,396,35101396
15543,61,1802800,2,9,45,1,457,35101457
15544,2,1802800,1,9,45,1,459,35101459
15545,71,1802900,1,9,45,1,530,35101530
15546,0,1802800,1,9,45,1,530,35101530
15547,5,1802700,5,9,45,1,535,35101535
15548,23,1802700,1,9,45,1,558,35101558
15549,65,1802800,1,9,45,1,623,35101623
15550,32,1802900,5,9,45,1,655,35101655
15551,61,1802700,1,9,45,1,716,35101716
15552,1,1802800,1,9,45,1,717,35101717
15553,43,1802600,1,9,45,1,760,35101760
15554,6,1802800,2,9,45,1,766,35101766
15555,5,1802900,1,9,45,1,771,35101771
15556,47,1802600,1,9,45,1,818,35101818
15557,108,1802800,1,9,45,1,926,35101926
15558,1,1802800,1,9,45,1,927,35101927
15559,46,1802900,1,9,45,1,973,35101973
15560,133,1802900,2,9,45,2,106,35102106
15561,57,1802900,5,9,45,2,163,35102163
15562,157,1802900,1,9,45,2,320,35102320
15563,204,1802600,2,9,45,2,524,35102524
15564,58,1802600,1,9,45,2,582,35102582
15565,36,1802800,2,9,45,2,618,35102618
15566,77,1802800,2,9,45,2,695,35102695
15567,17,1802800,2,9,45,2,712,35102712
15568,383,1802800,1,9,45,3,95,35103095
15569,42,1802700,4,9,45,3,137,35103137
15570,0,1802700,4,9,45,3,137,35103137
15572,3,1802600,1,9,45,3,140,35103140
15573,0,1802600,1,9,45,3,140,35103140
15574,0,1802600,1,9,45,3,140,35103140
15575,46,1802600,2,9,45,3,186,35103186
15576,72,1802700,1,9,45,3,258,35103258
15577,252,1802700,1,9,45,3,510,35103510
15578,16,1802500,2,9,45,3,526,35103526
15579,137,1802700,2,9,45,3,663,35103663
15580,418,1802700,5,9,45,4,81,35104081
15581,110,1802800,2,9,45,4,191,35104191
15582,363,1802700,1,9,45,4,554,35104554
15583,1211,1802600,1,9,45,5,765,35105765
15584,29,1802600,1,9,45,5,794,35105794
15585,344,1802500,1,9,45,6,138,35106138
15586,32,1802700,1,9,45,6,170,35106170
15587,53,1802500,1,9,45,6,223,35106223
15588,52,1802700,1,9,45,6,275,35106275
15589,836,1802700,1,9,45,7,111,35107111
15590,1,1802700,4,9,45,7,112,35107112
15591,474,1802800,1,9,45,7,586,35107586
15592,0,1802900,1,9,45,7,586,35107586
15593,102,1802900,1,9,45,7,688,35107688
15594,261,1802900,1,9,45,7,949,35107949
15595,832,1802800,1,9,45,8,781,35108781
15596,0,1802800,1,9,45,8,781,35108781
15597,338,1802800,1,9,45,9,119,35109119
15598,1498,1802700,1,9,45,10,617,35110617
15599,380,1802800,6,9,45,10,997,35110997
15600,1,1802800,9,9,45,10,998,35110998
15601,1314,1802800,3,9,45,12,312,35112312
15603,313,1802700,1,9,45,12,625,35112625
15604,274,1802800,1,9,45,12,899,35112899
15605,680,1802700,1,9,45,13,579,35113579
15606,2,1802900,10,9,45,13,581,35113581
15607,272,1802900,33,9,45,13,853,35113853
15608,23,1803000,7,9,45,13,876,35113876
15609,1,1803000,1,9,45,13,877,35113877
15610,18,1803100,3,9,45,13,895,35113895
15611,0,1803100,1,9,45,13,895,35113895
15612,176,1803100,1,9,45,14,71,35114071
15613,57,1803100,1,9,45,14,128,35114128
15614,61,1803000,1,9,45,14,189,35114189
15615,0,1803100,8,9,45,14,189,35114189
15616,442,1803200,1,9,45,14,631,35114631
15617,132,1803200,6,9,45,14,763,35114763
15618,19,1803200,1,9,45,14,782,35114782
15619,109,1803200,2,9,45,14,891,35114891
15620,125,1803200,20,9,45,15,16,35115016
15621,1,1803200,2,9,45,15,17,35115017
15622,1,1803200,3,9,45,15,18,35115018
15623,0,1803200,3,9,45,15,18,35115018
15624,7,1803100,1,9,45,15,25,35115025
15625,88,1803100,2,9,45,15,113,35115113
15626,81,1803200,1,9,45,15,194,35115194
15627,529,1803100,3,9,45,15,723,35115723
15628,64,1803200,1,9,45,15,787,35115787
15629,8,1803200,2,9,45,15,795,35115795
15630,32,1803200,1,9,45,15,827,35115827
15631,213,1803300,1,9,45,16,40,35116040
15632,101,1803300,2,9,45,16,141,35116141
15633,2,1803300,2,9,45,16,143,35116143
15634,0,1803300,2,9,45,16,143,35116143
15635,128,1803300,1,9,45,16,271,35116271
15636,60,1803300,1,9,45,16,331,35116331
15637,51,1803300,1,9,45,16,382,35116382
15638,153,1803200,1,9,45,16,535,35116535
15639,291,1803300,5,9,45,16,826,35116826
15640,46,1803300,3,9,45,16,872,35116872
15641,1,1803300,3,9,45,16,873,35116873
15642,67,1803400,1,9,45,16,940,35116940
15643,34,1803400,8,9,45,16,974,35116974
15644,1,1803400,4,9,45,16,975,35116975
15645,25,1803400,1,9,45,17,0,35117000
15646,1,1803400,3,9,45,17,1,35117001
15647,4,1803400,2,9,45,17,5,35117005
15648,5,1803400,1,9,45,17,10,35117010
15649,39,1803400,1,9,45,17,49,35117049
15650,2,1803400,5,9,45,17,51,35117051
15651,6,1803400,4,9,45,17,57,35117057
15652,1,1803400,1,9,45,17,58,35117058
15653,5,1803400,2,9,45,17,63,35117063
15654,26,1803400,1,9,45,17,89,35117089
15655,1,1803400,1,9,45,17,90,35117090
15656,4,1803400,2,9,45,17,94,35117094
15657,7,1803400,1,9,45,17,101,35117101
15658,5,1803400,1,9,45,17,106,35117106
15659,36,1803400,2,9,45,17,142,35117142
15660,6,1803400,1,9,45,17,148,35117148
15661,5,1803400,1,9,45,17,153,35117153
15662,2,1803400,2,9,45,17,155,35117155
15663,3,1803400,2,9,45,17,158,35117158
15664,90,1803400,1,9,45,17,248,35117248
15665,15,1803400,2,9,45,17,263,35117263
15666,5,1803400,1,9,45,17,268,35117268
15667,18,1803400,2,9,45,17,286,35117286
15668,21,1803400,2,9,45,17,307,35117307
15669,31,1803400,3,9,45,17,338,35117338
15670,0,1803400,1,9,45,17,338,35117338
15671,1,1803400,4,9,45,17,339,35117339
15672,1,1803400,1,9,45,17,340,35117340
15673,15,1803400,1,9,45,17,355,35117355
15674,20,1803400,1,9,45,17,375,35117375
15675,63,1803400,2,9,45,17,438,35117438
15676,1,1803400,1,9,45,17,439,35117439
15677,0,1803400,1,9,45,17,439,35117439
15678,0,1803500,1,9,45,17,439,35117439
15679,0,1803500,1,9,45,17,439,35117439
15680,0,1803500,1,9,45,17,439,35117439
15681,7,1803500,1,9,45,17,446,35117446
15682,7,1803500,1,9,45,17,453,35117453
15683,14,1803500,1,9,45,17,467,35117467
15684,11,1803500,22,9,45,17,478,35117478
15685,2,1803500,1,9,45,17,480,35117480
15686,0,1803500,1,9,45,17,480,35117480
15687,0,1803500,1,9,45,17,480,35117480
15688,0,1803500,1,9,45,17,480,35117480
15689,0,1803500,1,9,45,17,480,35117480
15690,0,1803500,7,9,45,17,480,35117480
15691,0,1803500,4,9,45,17,480,35117480
15692,8,1803600,2,9,45,17,488,35117488
15693,8,1803600,3,9,45,17,496,35117496
15694,11,1803600,8,9,45,17,507,35117507
15695,1,1803600,16,9,45,17,508,35117508
15696,0,1803600,1,9,45,17,508,35117508
15697,0,1803600,1,9,45,17,508,35117508
15698,0,1803600,1,9,45,17,508,35117508
15699,6,1803700,1,9,45,17,514,35117514
15700,17,1803500,1,9,45,17,531,35117531
15701,7,1803700,1,9,45,17,538,35117538
15702,2,1803700,1,9,45,17,540,35117540
15703,2,1803700,1,9,45,17,542,35117542
15704,2,1803700,1,9,45,17,544,35117544
15705,8,1803600,1,9,45,17,552,35117552
15706,10,1803700,2,9,45,17,562,35117562
15707,3,1803600,1,9,45,17,565,35117565
15708,1,1803500,1,9,45,17,566,35117566
15709,1,1803500,1,9,45,17,567,35117567
15710,1,1803500,1,9,45,17,568,35117568
15711,4,1803600,1,9,45,17,572,35117572
15712,7,1803500,1,9,45,17,579,35117579
15713,5,1803600,1,9,45,17,584,35117584
15714,2,1803500,1,9,45,17,586,35117586
15715,6,1803600,1,9,45,17,592,35117592
15717,14,1803600,2,9,45,17,606,35117606
15718,6,1803600,2,9,45,17,612,35117612
15719,1,1803500,1,9,45,17,613,35117613
15720,12,1803600,1,9,45,17,625,35117625
15721,4,1803600,3,9,45,17,629,35117629
15722,5,1803600,1,9,45,17,634,35117634
15723,3,1803600,1,9,45,17,637,35117637
15724,7,1803500,3,9,45,17,644,35117644
15726,2,1803500,1,9,45,17,646,35117646
15727,2,1803600,1,9,45,17,648,35117648
15728,1,1803600,1,9,45,17,649,35117649
15729,21,1803600,2,9,45,17,670,35117670
15730,22,1803600,2,9,45,17,692,35117692
15731,14,1803600,2,9,45,17,706,35117706
15732,16,1803400,1,9,45,17,722,35117722
15733,11,1803500,2,9,45,17,733,35117733
15735,25,1803400,1,9,45,17,758,35117758
15736,3,1803400,1,9,45,17,761,35117761
15737,5,1803600,1,9,45,17,766,35117766
15738,12,1803500,1,9,45,17,778,35117778
15739,1,1803500,3,9,45,17,779,35117779
15740,5,1803600,1,9,45,17,784,35117784
15741,48,1803500,1,9,45,17,832,35117832
15742,21,1803500,2,9,45,17,853,35117853
15743,1,1803500,2,9,45,17,854,35117854
15744,40,1803500,1,9,45,17,894,35117894
15745,0,1803600,1,9,45,17,894,35117894
15746,11,1803400,1,9,45,17,905,35117905
15747,2,1803500,6,9,45,17,907,35117907
15749,12,1803500,2,9,45,17,919,35117919
15750,29,1803500,1,9,45,17,948,35117948
15751,7,1803500,2,9,45,17,955,35117955
15752,15,1803400,1,9,45,17,970,35117970
15753,38,1803500,2,9,45,18,8,35118008
15754,1,1803400,1,9,45,18,9,35118009
15755,5,1803500,1,9,45,18,14,35118014
15756,6,1803500,1,9,45,18,20,35118020
15757,38,1803500,1,9,45,18,58,35118058
15758,1,1803500,1,9,45,18,59,35118059
15759,9,1803500,2,9,45,18,68,35118068
15760,17,1803400,1,9,45,18,85,35118085
15761,30,1803500,3,9,45,18,115,35118115
15763,5,1803400,1,9,45,18,120,35118120
15764,8,1803500,3,9,45,18,128,35118128
15766,19,1803600,1,9,45,18,147,35118147
15767,5,1803400,2,9,45,18,152,35118152
15768,3,1803300,1,9,45,18,155,35118155
15769,37,1803300,1,9,45,18,192,35118192
15770,28,1803400,3,9,45,18,220,35118220
15771,36,1803400,1,9,45,18,256,35118256
15772,30,1803400,3,9,45,18,286,35118286
15773,12,1803400,1,9,45,18,298,35118298
15774,52,1803500,1,9,45,18,350,35118350
15775,1,1803500,1,9,45,18,351,35118351
15776,17,1803500,1,9,45,18,368,35118368
15777,150,1803500,2,9,45,18,518,35118518
15778,2,1803500,1,9,45,18,520,35118520
15780,10,1803600,1,9,45,18,530,35118530
15781,52,1803400,1,9,45,18,582,35118582
15782,91,1803300,1,9,45,18,673,35118673
15783,15,1803500,1,9,45,18,688,35118688
15784,1,1803500,1,9,45,18,689,35118689
15785,27,1803500,1,9,45,18,716,35118716
15786,14,1803500,6,9,45,18,730,35118730
15787,0,1803500,6,9,45,18,730,35118730
15789,138,1803600,1,9,45,18,868,35118868
15791,45,1803700,1,9,45,18,913,35118913
15792,49,1803500,2,9,45,18,962,35118962
15793,39,1803500,1,9,45,19,1,35119001
15794,21,1803600,1,9,45,19,22,35119022
15795,29,1803400,1,9,45,19,51,35119051
15796,108,1803600,1,9,45,19,159,35119159
15797,28,1803500,1,9,45,19,187,35119187
15798,0,1803500,1,9,45,19,187,35119187
15799,9,1803400,1,9,45,19,196,35119196
15800,12,1803500,2,9,45,19,208,35119208
15801,92,1803500,1,9,45,19,300,35119300
15802,46,1803500,1,9,45,19,346,35119346
15803,40,1803500,2,9,45,19,386,35119386
15804,113,1803500,1,9,45,19,499,35119499
15805,27,1803300,1,9,45,19,526,35119526
15806,61,1803500,2,9,45,19,587,35119587
15807,24,1803500,1,9,45,19,611,35119611
15808,25,1803500,2,9,45,19,636,35119636
15809,120,1803500,1,9,45,19,756,35119756
15810,9,1803500,2,9,45,19,765,35119765
15812,83,1803400,5,9,45,19,848,35119848
15813,21,1803500,1,9,45,19,869,35119869
15814,56,1803300,8,9,45,19,925,35119925
15815,56,1803300,1,9,45,19,981,35119981
15816,30,1803300,1,9,45,20,11,35120011
15817,219,1803300,1,9,45,20,230,35120230
15818,9,1803300,1,9,45,20,239,35120239
15819,95,1803300,1,9,45,20,334,35120334
15820,331,1803300,1,9,45,20,665,35120665
15821,6,1803300,6,9,45,20,671,35120671
15822,84,1803200,5,9,45,20,755,35120755
15823,166,1803400,1,9,45,20,921,35120921
15824,32,1803400,1,9,45,20,953,35120953
15825,31,1803400,1,9,45,20,984,35120984
15826,37,1803400,1,9,45,21,21,35121021
15827,21,1803400,2,9,45,21,42,35121042
15828,105,1803400,1,9,45,21,147,35121147
15829,98,1803400,2,9,45,21,245,35121245
15830,64,1803400,1,9,45,21,309,35121309
15831,7,1803400,1,9,45,21,316,35121316
15832,105,1803200,1,9,45,21,421,35121421
15833,110,1803400,1,9,45,21,531,35121531
15834,57,1803400,1,9,45,21,588,35121588
15835,32,1803200,1,9,45,21,620,35121620
15836,79,1803300,1,9,45,21,699,35121699
15837,153,1803300,2,9,45,21,852,35121852
15838,22,1803300,1,9,45,21,874,35121874
15839,217,1803300,2,9,45,22,91,35122091
15840,0,1803300,2,9,45,22,91,35122091
15841,0,1803300,2,9,45,22,91,35122091
15843,2,1803000,3,9,45,22,93,35122093
15844,1,1803000,1,9,45,22,94,35122094
15845,0,1803000,8,9,45,22,94,35122094
15846,0,1803000,1,9,45,22,94,35122094
15847,30,1803000,1,9,45,22,124,35122124
15848,42,1803100,1,9,45,22,166,35122166
15849,22,1803100,1,9,45,22,188,35122188
15850,2,1803100,1,9,45,22,190,35122190
15851,31,1803200,1,9,45,22,221,35122221
15852,3,1803200,1,9,45,22,224,35122224
15853,18,1803000,3,9,45,22,242,35122242
15854,24,1803200,1,9,45,22,266,35122266
15855,130,1803200,1,9,45,22,396,35122396
15856,74,1803000,1,9,45,22,470,35122470
15857,115,1803200,1,9,45,22,585,35122585
15858,84,1803200,1,9,45,22,669,35122669
15859,53,1803200,1,9,45,22,722,35122722
15860,42,1803000,3,9,45,22,764,35122764
15861,2,1802900,1,9,45,22,766,35122766
15862,0,1802900,1,9,45,22,766,35122766
15863,1,1802900,2,9,45,22,767,35122767
15864,126,1802900,1,9,45,22,893,35122893
15865,168,1802900,1,9,45,23,61,35123061
15866,205,1802800,1,9,45,23,266,35123266
15867,0,1802800,1,9,45,23,266,35123266
15868,42,1802800,3,9,45,23,308,35123308
15869,3,1802700,1,9,45,23,311,35123311
15870,64,1802900,9,9,45,23,375,35123375
15872,16,1802900,1,9,45,23,391,35123391
15873,28,1802800,1,9,45,23,419,35123419
15874,78,1802700,2,9,45,23,497,35123497
15875,104,1802700,1,9,45,23,601,35123601
15876,64,1802700,1,9,45,23,665,35123665
15877,262,1802700,1,9,45,23,927,35123927
15878,20,1802900,4,9,45,23,947,35123947
15879,399,1802700,1,9,45,24,346,35124346
15880,18,1802700,3,9,45,24,364,35124364
15881,105,1802700,1,9,45,24,469,35124469
15882,422,1802900,4,9,45,24,891,35124891
15883,225,1802900,1,9,45,25,116,35125116
15884,757,1802800,1,9,45,25,873,35125873
15885,658,1802800,1,9,45,26,531,35126531
15886,125,1802900,1,9,45,26,656,35126656
15887,106,1802900,2,9,45,26,762,35126762
15888,103,1802900,1,9,45,26,865,35126865
15889,453,1802800,1,9,45,27,318,35127318
15890,315,1802900,1,9,45,27,633,35127633
15891,279,1802900,1,9,45,27,912,35127912
15892,95,1802900,1,9,45,28,7,35128007
15893,1,1803000,6,9,45,28,8,35128008
15894,447,1802900,1,9,45,28,455,35128455
15895,366,1802800,8,9,45,28,821,35128821
15896,0,1802800,8,9,45,28,821,35128821
15898,464,1802700,1,9,45,29,285,35129285
15899,21,1802800,1,9,45,29,306,35129306
15900,442,1802700,1,9,45,29,748,35129748
15901,229,1802700,4,9,45,29,977,35129977
15902,515,1802700,1,9,45,30,492,35130492
15903,164,1802700,1,9,45,30,656,35130656
15904,670,1802600,4,9,45,31,326,35131326
15905,151,1802600,1,9,45,31,477,35131477
15906,186,1802500,1,9,45,31,663,35131663
15907,6,1802500,5,9,45,31,669,35131669
15908,1,1802500,1,9,45,31,670,35131670
15909,301,1802400,1,9,45,31,971,35131971
15910,123,1802400,2,9,45,32,94,35132094
15911,545,1802400,1,9,45,32,639,35132639
15912,1310,1802400,1,9,45,33,949,35133949
15913,141,1802600,1,9,45,34,90,35134090
15914,219,1802600,4,9,45,34,309,35134309
15915,745,1802500,1,9,45,35,54,35135054
15916,211,1802700,1,9,45,35,265,35135265
15917,58,1802700,9,9,45,35,323,35135323
15919,222,1802600,1,9,45,35,545,35135545
15920,465,1802700,1,9,45,36,10,35136010
15921,47,1802800,1,9,45,36,57,35136057
15922,151,1802800,1,9,45,36,208,35136208
15923,755,1802800,1,9,45,36,963,35136963
15924,1,1802800,5,9,45,36,964,35136964
15925,133,1802700,1,9,45,37,97,35137097
15926,276,1802900,2,9,45,37,373,35137373
15927,908,1802700,1,9,45,38,281,35138281
15928,477,1802700,2,9,45,38,758,35138758
15929,168,1802600,2,9,45,38,926,35138926
15930,320,1802700,1,9,45,39,246,35139246
15931,1195,1802700,1,9,45,40,441,35140441
15932,260,1802800,1,9,45,40,701,35140701
15933,1851,1802700,1,9,45,42,552,35142552
15934,379,1802800,1,9,45,42,931,35142931
15935,58,1802800,3,9,45,42,989,35142989
15936,594,1802800,1,9,45,43,583,35143583
15937,822,1802800,1,9,45,44,405,35144405
15938,413,1802800,1,9,45,44,818,35144818
15939,328,1802700,1,9,45,45,146,35145146
15940,812,1802700,2,9,45,45,958,35145958
15941,293,1802700,1,9,45,46,251,35146251
15942,545,1802700,1,9,45,46,796,35146796
15943,428,1802800,1,9,45,47,224,35147224
15944,2409,1802700,1,9,45,49,633,35149633
15945,43,1802800,2,9,45,49,676,35149676
15946,77,1802700,1,9,45,49,753,35149753
15947,373,1802800,1,9,45,50,126,35150126
15948,37,1802600,6,9,45,50,163,35150163
15949,328,1802700,1,9,45,50,491,35150491
15950,111,1802600,10,9,45,50,602,35150602
15951,169,1802600,1,9,45,50,771,35150771
15952,834,1802500,14,9,45,51,605,35151605
15953,1,1802500,1,9,45,51,606,35151606
15954,0,1802500,3,9,45,51,606,35151606
15955,128,1802600,1,9,45,51,734,35151734
15956,358,1802400,1,9,45,52,92,35152092
15957,725,1802400,4,9,45,52,817,35152817
15958,83,1802400,15,9,45,52,900,35152900
15959,98,1802400,1,9,45,52,998,35152998
15960,52,1802500,1,9,45,53,50,35153050
15961,16,1802400,1,9,45,53,66,35153066
15962,48,1802400,1,9,45,53,114,35153114
15963,48,1802400,1,9,45,53,162,35153162
15964,37,1802400,1,9,45,53,199,35153199
15965,359,1802500,3,9,45,53,558,35153558
15966,1258,1802400,1,9,45,54,816,35154816
15967,987,1802500,2,9,45,55,803,35155803
15968,0,1802500,1,9,45,55,803,35155803
15969,83,1802500,1,9,45,55,886,35155886
15970,119,1802500,3,9,45,56,5,35156005
15971,0,1802500,3,9,45,56,5,35156005
15972,0,1802500,3,9,45,56,5,35156005
15974,5,1802800,1,9,45,56,10,35156010
15975,1,1802800,1,9,45,56,11,35156011
15976,0,1802800,1,9,45,56,11,35156011
15977,0,1802800,1,9,45,56,11,35156011
15978,6,1802800,2,9,45,56,17,35156017
15979,88,1802800,3,9,45,56,105,35156105
15980,36,1802800,1,9,45,56,141,35156141
15981,281,1802600,1,9,45,56,422,35156422
15982,818,1802700,1,9,45,57,240,35157240
15983,960,1802700,1,9,45,58,200,35158200
15984,1935,1802600,1,9,46,0,135,35160135
15985,563,1802600,7,9,46,0,698,35160698
15986,1,1802600,1,9,46,0,699,35160699
15987,60,1802700,3,9,46,0,759,35160759
15988,859,1802700,1,9,46,1,618,35161618
15989,53,1802700,2,9,46,1,671,35161671
15990,152,1802700,1,9,46,1,823,35161823
15991,1199,1802600,2,9,46,3,22,35163022
15992,35,1802700,1,9,46,3,57,35163057
15993,693,1802600,2,9,46,3,750,35163750
15994,0,1802500,10,9,46,3,750,35163750
15995,118,1802600,8,9,46,3,868,35163868
15996,0,1802600,8,9,46,3,868,35163868
15998,4,1802700,3,9,46,3,872,35163872
15999,32,1802700,2,9,46,3,904,35163904
16001,560,1802700,1,9,46,4,464,35164464
16002,189,1802800,1,9,46,4,653,35164653
16003,377,1802800,1,9,46,5,30,35165030
16004,371,1802900,1,9,46,5,401,35165401
16005,941,1802800,1,9,46,6,342,35166342
16006,13,1802900,1,9,46,6,355,35166355
16007,432,1802900,4,9,46,6,787,35166787
16008,1,1802900,1,9,46,6,788,35166788
16009,52,1802800,1,9,46,6,840,35166840
16010,1020,1802800,1,9,46,7,860,35167860
16011,44,1802800,2,9,46,7,904,35167904
16012,0,1802800,6,9,46,7,904,35167904
16013,287,1802900,2,9,46,8,191,35168191
16014,403,1802900,1,9,46,8,594,35168594
16015,344,1802800,1,9,46,8,938,35168938
16016,1711,1802700,1,9,46,10,649,35170649
16017,219,1802700,1,9,46,10,868,35170868
16018,1397,1802800,1,9,46,12,265,35172265
16019,48,1802800,2,9,46,12,313,35172313
16020,0,1802800,2,9,46,12,313,35172313
16021,1,1802800,1,9,46,12,314,35172314
16022,74,1802800,1,9,46,12,388,35172388
16023,1154,1802800,1,9,46,13,542,35173542
16024,201,1802800,1,9,46,13,743,35173743
16025,1,1802800,1,9,46,13,744,35173744
16026,528,1802900,1,9,46,14,272,35174272
16027,2634,1802900,1,9,46,16,906,35176906
16028,1422,1802800,1,9,46,18,328,35178328
16029,1445,1802800,1,9,46,19,773,35179773
16030,179,1802800,1,9,46,19,952,35179952
16031,166,1802900,1,9,46,20,118,35180118
16032,138,1802800,1,9,46,20,256,35180256
16033,518,1802900,1,9,46,20,774,35180774
16034,1162,1802800,1,9,46,21,936,35181936
16035,73,1802800,1,9,46,22,9,35182009
16036,39,1802800,1,9,46,22,48,35182048
16037,282,1802800,1,9,46,22,330,35182330
16038,22,1802900,4,9,46,22,352,35182352
16039,0,1802900,11,9,46,22,352,35182352
16040,302,1803000,1,9,46,22,654,35182654
16041,0,1803000,5,9,46,22,654,35182654
16042,0,1803000,1,9,46,22,654,35182654
16043,1,1803000,1,9,46,22,655,35182655
16044,0,1803000,4,9,46,22,655,35182655
16045,0,1803000,1,9,46,22,655,35182655
16046,0,1803000,8,9,46,22,655,35182655
16047,0,1803000,7,9,46,22,655,35182655
16048,4,1803000,1,9,46,22,659,35182659
16049,30,1803100,2,9,46,22,689,35182689
16050,58,1803200,1,9,46,22,747,35182747
16051,874,1803200,2,9,46,23,621,35183621
16052,165,1803000,1,9,46,23,786,35183786
16053,244,1803000,2,9,46,24,30,35184030
16054,125,1803200,1,9,46,24,155,35184155
16055,843,1803000,5,9,46,24,998,35184998
16056,404,1803100,1,9,46,25,402,35185402
16057,517,1803200,1,9,46,25,919,35185919
16058,73,1803200,1,9,46,25,992,35185992
16059,250,1803100,1,9,46,26,242,35186242
16060,196,1803200,3,9,46,26,438,35186438
16061,61,1803200,4,9,46,26,499,35186499
16062,541,1803100,1,9,46,27,40,35187040
16063,350,1803200,1,9,46,27,390,35187390
16064,0,1803200,2,9,46,27,390,35187390
16065,172,1803300,7,9,46,27,562,35187562
16066,0,1803300,1,9,46,27,562,35187562
16067,0,1803300,1,9,46,27,562,35187562
16068,219,1803200,1,9,46,27,781,35187781
16069,114,1803200,1,9,46,27,895,35187895
16070,300,1803300,1,9,46,28,195,35188195
16071,0,1803300,1,9,46,28,195,35188195
16073,432,1803300,1,9,46,28,627,35188627
16074,65,1803300,1,9,46,28,692,35188692
16075,51,1803200,1,9,46,28,743,35188743
16076,172,1803200,3,9,46,28,915,35188915
16077,942,1803300,1,9,46,29,857,35189857
16078,87,1803400,1,9,46,29,944,35189944
16079,206,1803400,1,9,46,30,150,35190150
16080,186,1803400,1,9,46,30,336,35190336
16081,407,1803300,1,9,46,30,743,35190743
16082,347,1803300,1,9,46,31,90,35191090
16083,33,1803300,1,9,46,31,123,35191123
16084,252,1803300,1,9,46,31,375,35191375
16085,660,1803300,1,9,46,32,35,35192035
16086,77,1803400,4,9,46,32,112,35192112
16087,0,1803400,4,9,46,32,112,35192112
16088,1,1803400,1,9,46,32,113,35192113
16089,1,1803500,2,9,46,32,114,35192114
16090,2,1803500,3,9,46,32,116,35192116
16091,29,1803500,1,9,46,32,145,35192145
16092,42,1803500,1,9,46,32,187,35192187
16093,1,1803600,1,9,46,32,188,35192188
16094,0,1803600,1,9,46,32,188,35192188
16095,0,1803600,3,9,46,32,188,35192188
16096,212,1803500,1,9,46,32,400,35192400
16097,6,1803500,1,9,46,32,406,35192406
16098,20,1803500,1,9,46,32,426,35192426
16100,375,1803500,1,9,46,32,801,35192801
16101,345,1803300,1,9,46,33,146,35193146
16102,30,1803500,1,9,46,33,176,35193176
16103,54,1803300,1,9,46,33,230,35193230
16104,761,1803400,1,9,46,33,991,35193991
16105,215,1803400,2,9,46,34,206,35194206
16107,676,1803500,1,9,46,34,882,35194882
16108,684,1803500,1,9,46,35,566,35195566
16109,539,1803400,1,9,46,36,105,35196105
16110,0,1803400,1,9,46,36,105,35196105
16111,0,1803400,1,9,46,36,105,35196105
16112,305,1803400,1,9,46,36,410,35196410
16113,191,1803300,1,9,46,36,601,35196601
16114,94,1803300,2,9,46,36,695,35196695
16115,844,1803200,1,9,46,37,539,35197539
16116,230,1803200,1,9,46,37,769,35197769
16117,71,1803300,1,9,46,37,840,35197840
16118,107,1803200,1,9,46,37,947,35197947
16119,456,1803200,1,9,46,38,403,35198403
16120,1301,1803400,1,9,46,39,704,35199704
16121,175,1803300,1,9,46,39,879,35199879
16122,1735,1803300,1,9,46,41,614,35201614
16123,873,1803300,5,9,46,42,487,35202487
16124,591,1803300,2,9,46,43,78,35203078
16125,239,1803300,1,9,46,43,317,35203317
16126,1484,1803300,2,9,46,44,801,35204801
16127,760,1803300,2,9,46,45,561,35205561
16128,303,1803300,1,9,46,45,864,35205864
16129,1005,1803300,1,9,46,46,869,35206869
16130,1392,1803300,1,9,46,48,261,35208261
16131,36,1803200,6,9,46,48,297,35208297
16132,1133,1803200,1,9,46,49,430,35209430
16133,414,1803300,1,9,46,49,844,35209844
16134,2358,1803200,1,9,46,52,202,35212202
16135,250,1803200,9,9,46,52,452,35212452
16136,675,1803200,1,9,46,53,127,35213127
16138,1364,1803100,12,9,46,54,491,35214491
16139,2,1803000,1,9,46,54,493,35214493
16140,128,1803000,1,9,46,54,621,35214621
16141,25,1803000,2,9,46,54,646,35214646
16142,32,1803000,1,9,46,54,678,35214678
16143,15,1803000,1,9,46,54,693,35214693
16144,0,1803000,1,9,46,54,693,35214693
16145,70,1803000,1,9,46,54,763,35214763
16146,8,1803100,1,9,46,54,771,35214771
16147,347,1803000,1,9,46,55,118,35215118
16148,34,1803000,1,9,46,55,152,35215152
16149,1079,1802900,1,9,46,56,231,35216231
16150,160,1802900,1,9,46,56,391,35216391
16151,335,1803000,1,9,46,56,726,35216726
16152,0,1803000,1,9,46,56,726,35216726
16153,82,1802900,1,9,46,56,808,35216808
16154,440,1803000,1,9,46,57,248,35217248
16155,35,1803200,2,9,46,57,283,35217283
16156,335,1803000,1,9,46,57,618,35217618
16157,737,1803200,4,9,46,58,355,35218355
16158,1139,1803200,2,9,46,59,494,35219494
16159,643,1803000,1,9,47,0,137,35220137
16160,103,1803100,1,9,47,0,240,35220240
16161,397,1802900,5,9,47,0,637,35220637
16162,234,1803100,2,9,47,0,871,35220871
16163,93,1803100,2,9,47,0,964,35220964
16164,1331,1803100,1,9,47,2,295,35222295
16165,168,1803100,1,9,47,2,463,35222463
16166,141,1803100,4,9,47,2,604,35222604
16167,2006,1803100,1,9,47,4,610,35224610
16168,1,1803000,5,9,47,4,611,35224611
16169,1,1803000,1,9,47,4,612,35224612
16170,0,1803000,13,9,47,4,612,35224612
16171,1,1802900,1,9,47,4,613,35224613
16172,1,1802900,3,9,47,4,614,35224614
16173,60,1803000,2,9,47,4,674,35224674
16174,200,1802900,1,9,47,4,874,35224874
16175,295,1803100,1,9,47,5,169,35225169
16176,211,1802900,1,9,47,5,380,35225380
16177,326,1803000,1,9,47,5,706,35225706
16178,1536,1803000,1,9,47,7,242,35227242
16179,228,1802900,1,9,47,7,470,35227470
16180,934,1803100,1,9,47,8,404,35228404
16181,32,1803100,1,9,47,8,436,35228436
16182,893,1803100,4,9,47,9,329,35229329
16183,154,1802900,1,9,47,9,483,35229483
16184,1708,1803000,1,9,47,11,191,35231191
16185,1530,1802900,4,9,47,12,721,35232721
16186,204,1802900,1,9,47,12,925,35232925
16187,1253,1802800,1,9,47,14,178,35234178
16188,0,1802800,2,9,47,14,178,35234178
16189,1,1802800,1,9,47,14,179,35234179
16190,0,1802800,4,9,47,14,179,35234179
16191,4,1802700,5,9,47,14,183,35234183
16192,0,1802700,7,9,47,14,183,35234183
16193,2,1802600,6,9,47,14,185,35234185
16194,26,1802600,1,9,47,14,211,35234211
16195,144,1802700,1,9,47,14,355,35234355
16196,5,1802700,2,9,47,14,360,35234360
16197,121,1802600,1,9,47,14,481,35234481
16198,214,1802600,7,9,47,14,695,35234695
16199,0,1802600,7,9,47,14,695,35234695
16201,3,1802500,1,9,47,14,698,35234698
16202,1,1802500,1,9,47,14,699,35234699
16203,34,1802500,1,9,47,14,733,35234733
16205,19,1802500,1,9,47,14,752,35234752
16207,689,1802700,1,9,47,15,441,35235441
16208,474,1802600,1,9,47,15,915,35235915
16209,1234,1802600,1,9,47,17,149,35237149
16210,2502,1802600,1,9,47,19,651,35239651
16211,57,1802600,1,9,47,19,708,35239708
16212,377,1802700,4,9,47,20,85,35240085
16213,37,1802500,2,9,47,20,122,35240122
16214,1210,1802500,1,9,47,21,332,35241332
16215,376,1802500,1,9,47,21,708,35241708
16216,351,1802500,1,9,47,22,59,35242059
16217,991,1802700,4,9,47,23,50,35243050
16219,1158,1802600,1,9,47,24,208,35244208
16220,2505,1802700,2,9,47,26,713,35246713
16221,49,1802800,1,9,47,26,762,35246762
16222,1106,1802900,1,9,47,27,868,35247868
16223,248,1802700,2,9,47,28,116,35248116
16224,394,1802700,1,9,47,28,510,35248510
16225,1249,1802800,1,9,47,29,759,35249759
16226,384,1802900,2,9,47,30,143,35250143
16227,864,1803000,1,9,47,31,7,35251007
16228,1703,1802900,1,9,47,32,710,35252710
16229,510,1802900,1,9,47,33,220,35253220
16230,171,1802900,1,9,47,33,391,35253391
16231,195,1802800,1,9,47,33,586,35253586
16232,548,1802700,5,9,47,34,134,35254134
16233,1717,1802700,1,9,47,35,851,35255851
16234,487,1802800,1,9,47,36,338,35256338
16235,1,1802900,2,9,47,36,339,35256339
16236,0,1802900,5,9,47,36,339,35256339
16237,1,1802900,1,9,47,36,340,35256340
16238,34,1803000,1,9,47,36,374,35256374
16239,0,1803000,1,9,47,36,374,35256374
16240,2286,1803000,1,9,47,38,660,35258660
16241,1846,1802900,1,9,47,40,506,35260506
16242,619,1803000,8,9,47,41,125,35261125
16243,1,1803000,1,9,47,41,126,35261126
16244,0,1803000,5,9,47,41,126,35261126
16245,0,1803000,1,9,47,41,126,35261126
16246,0,1803000,1,9,47,41,126,35261126
16247,0,1803000,3,9,47,41,126,35261126
16248,282,1803000,1,9,47,41,408,35261408
16249,91,1803000,1,9,47,41,499,35261499
16250,949,1803000,1,9,47,42,448,35262448
16251,250,1803000,1,9,47,42,698,35262698
16252,218,1803000,1,9,47,42,916,35262916
16253,905,1803000,1,9,47,43,821,35263821
16254,579,1803000,1,9,47,44,400,35264400
16255,535,1803000,2,9,47,44,935,35264935
16256,0,1803100,4,9,47,44,935,35264935
16257,3355,1803200,4,9,47,48,290,35268290
16258,805,1803100,1,9,47,49,95,35269095
16259,156,1803100,1,9,47,49,251,35269251
16260,2994,1803200,2,9,47,52,245,35272245
16261,15,1803000,2,9,47,52,260,35272260
16262,2385,1803200,5,9,47,54,645,35274645
16263,3674,1803000,4,9,47,58,319,35278319
16264,73,1803000,2,9,47,58,392,35278392
16265,211,1802900,4,9,47,58,603,35278603
16266,1969,1802900,1,9,48,0,572,35280572
16267,35,1803000,1,9,48,0,607,35280607
16268,278,1803100,1,9,48,0,885,35280885
16269,142,1803100,3,9,48,1,27,35281027
16270,194,1803200,1,9,48,1,221,35281221
16271,43,1803000,1,9,48,1,264,35281264
16272,397,1803200,1,9,48,1,661,35281661
16273,1,1803200,2,9,48,1,662,35281662
16274,0,1803200,1,9,48,1,662,35281662
16275,0,1803200,1,9,48,1,662,35281662
16276,0,1803200,1,9,48,1,662,35281662
16277,0,1803200,1,9,48,1,662,35281662
16278,1,1803200,10,9,48,1,663,35281663
16279,82,1803200,2,9,48,1,745,35281745
16280,175,1803200,1,9,48,1,920,35281920
16281,321,1803300,1,9,48,2,241,35282241
16282,0,1803300,2,9,48,2,241,35282241
16283,1,1803300,4,9,48,2,242,35282242
16284,0,1803300,1,9,48,2,242,35282242
16285,0,1803300,3,9,48,2,242,35282242
16286,0,1803300,1,9,48,2,242,35282242
16287,61,1803300,1,9,48,2,303,35282303
16288,71,1803400,5,9,48,2,374,35282374
16289,1,1803400,3,9,48,2,375,35282375
16290,557,1803300,8,9,48,2,932,35282932
16291,3,1803200,1,9,48,2,935,35282935
16292,7,1803200,1,9,48,2,942,35282942
16293,1,1803200,1,9,48,2,943,35282943
16294,977,1803300,3,9,48,3,920,35283920
16295,170,1803300,1,9,48,4,90,35284090
16296,2627,1803200,2,9,48,6,717,35286717
16297,1,1803200,2,9,48,6,718,35286718
16298,2940,1803100,1,9,48,9,658,35289658
16299,68,1803200,1,9,48,9,726,35289726
16300,0,1803200,1,9,48,9,726,35289726
16301,1402,1803300,3,9,48,11,128,35291128
16302,1,1803400,4,9,48,11,129,35291129
16303,821,1803400,2,9,48,11,950,35291950
16304,194,1803400,1,9,48,12,144,35292144
16305,3,1803300,1,9,48,12,147,35292147
16306,165,1803400,3,9,48,12,312,35292312
16307,1334,1803300,1,9,48,13,646,35293646
16308,31,1803300,1,9,48,13,677,35293677
16309,267,1803300,1,9,48,13,944,35293944
16310,21,1803400,2,9,48,13,965,35293965
16311,1100,1803400,1,9,48,15,65,35295065
16312,1708,1803500,9,9,48,16,773,35296773
16313,1,1803500,11,9,48,16,774,35296774
16314,123,1803600,2,9,48,16,897,35296897
16315,138,1803600,2,9,48,17,35,35297035
16316,0,1803600,2,9,48,17,35,35297035
16317,0,1803600,2,9,48,17,35,35297035
16318,1,1803600,5,9,48,17,36,35297036
16319,65,1803700,1,9,48,17,101,35297101
16320,128,1803700,1,9,48,17,229,35297229
16321,5,1803700,1,9,48,17,234,35297234
16322,8,1803500,2,9,48,17,242,35297242
16323,24,1803700,1,9,48,17,266,35297266
16324,2,1803700,2,9,48,17,268,35297268
16325,30,1803700,1,9,48,17,298,35297298
16326,14,1803700,4,9,48,17,312,35297312
16327,26,1803700,2,9,48,17,338,35297338
16328,7,1803700,2,9,48,17,345,35297345
16329,0,1803700,2,9,48,17,345,35297345
16330,0,1803700,2,9,48,17,345,35297345
16331,1,1803700,1,9,48,17,346,35297346
16332,22,1803600,1,9,48,17,368,35297368
16333,139,1803700,1,9,48,17,507,35297507
16334,70,1803800,1,9,48,17,577,35297577
16335,93,1803800,1,9,48,17,670,35297670
16336,15,1803800,2,9,48,17,685,35297685
16337,1,1803800,1,9,48,17,686,35297686
16338,17,1803800,1,9,48,17,703,35297703
16339,11,1803800,1,9,48,17,714,35297714
16340,40,1803700,1,9,48,17,754,35297754
16341,9,1803700,1,9,48,17,763,35297763
16342,9,1803800,36,9,48,17,772,35297772
16343,29,1803800,1,9,48,17,801,35297801
16344,44,1803800,2,9,48,17,845,35297845
16346,67,1803900,1,9,48,17,912,35297912
16347,150,1803900,1,9,48,18,62,35298062
16348,9,1803900,1,9,48,18,71,35298071
16349,13,1803900,2,9,48,18,84,35298084
16350,21,1803900,3,9,48,18,105,35298105
16351,15,1803900,1,9,48,18,120,35298120
16352,15,1803900,1,9,48,18,135,35298135
16353,9,1803900,2,9,48,18,144,35298144
16354,4,1803900,2,9,48,18,148,35298148
16355,5,1803900,1,9,48,18,153,35298153
16356,289,1803900,1,9,48,18,442,35298442
16357,22,1803800,1,9,48,18,464,35298464
16358,91,1803900,1,9,48,18,555,35298555
16359,23,1803900,2,9,48,18,578,35298578
16360,22,1803900,1,9,48,18,600,35298600
16361,7,1803900,1,9,48,18,607,35298607
16362,1,1803700,1,9,48,18,608,35298608
16363,92,1803800,1,9,48,18,700,35298700
16364,30,1803800,1,9,48,18,730,35298730
16365,139,1803700,1,9,48,18,869,35298869
16366,323,1803800,1,9,48,19,192,35299192
16367,1265,1803700,1,9,48,20,457,35300457
16368,46,1803500,1,9,48,20,503,35300503
16369,12,1803700,1,9,48,20,515,35300515
16370,146,1803700,1,9,48,20,661,35300661
16371,14,1803500,1,9,48,20,675,35300675
16372,474,1803600,1,9,48,21,149,35301149
16373,115,1803600,1,9,48,21,264,35301264
16374,203,1803600,1,9,48,21,467,35301467
16375,0,1803700,5,9,48,21,467,35301467
16376,0,1803700,1,9,48,21,467,35301467
16377,180,1803800,1,9,48,21,647,35301647
16378,21,1803800,1,9,48,21,668,35301668
16379,410,1803600,1,9,48,22,78,35302078
16380,44,1803700,1,9,48,22,122,35302122
16381,3,1803700,1,9,48,22,125,35302125
16382,192,1803700,2,9,48,22,317,35302317
16383,379,1803700,1,9,48,22,696,35302696
16384,10,1803700,1,9,48,22,706,35302706
16385,54,1803600,1,9,48,22,760,35302760
16386,155,1803600,1,9,48,22,915,35302915
16387,82,1803600,1,9,48,22,997,35302997
16388,88,1803600,2,9,48,23,85,35303085
16389,491,1803500,1,9,48,23,576,35303576
16390,360,1803400,1,9,48,23,936,35303936
16391,5,1803400,1,9,48,23,941,35303941
16392,343,1803600,1,9,48,24,284,35304284
16393,161,1803600,3,9,48,24,445,35304445
16394,271,1803600,2,9,48,24,716,35304716
16395,1174,1803500,1,9,48,25,890,35305890
16396,1061,1803500,1,9,48,26,951,35306951
16397,274,1803500,1,9,48,27,225,35307225
16398,92,1803500,1,9,48,27,317,35307317
16399,0,1803500,1,9,48,27,317,35307317
16400,1,1803400,2,9,48,27,318,35307318
16401,1,1803400,1,9,48,27,319,35307319
16402,22,1803500,1,9,48,27,341,35307341
16403,1346,1803500,1,9,48,28,687,35308687
16404,110,1803500,1,9,48,28,797,35308797
16405,484,1803500,1,9,48,29,281,35309281
16406,235,1803500,1,9,48,29,516,35309516
16407,56,1803600,1,9,48,29,572,35309572
16408,168,1803400,2,9,48,29,740,35309740
16409,359,1803500,1,9,48,30,99,35310099
16410,508,1803500,2,9,48,30,607,35310607
16411,162,1803500,1,9,48,30,769,35310769
16412,615,1803500,1,9,48,31,384,35311384
16413,1,1803600,3,9,48,31,385,35311385
16414,636,1803400,1,9,48,32,21,35312021
16415,0,1803400,13,9,48,32,21,35312021
16416,381,1803400,2,9,48,32,402,35312402
16417,486,1803500,4,9,48,32,888,35312888
16418,777,1803500,1,9,48,33,665,35313665
16419,134,1803500,1,9,48,33,799,35313799
16420,410,1803500,2,9,48,34,209,35314209
16421,345,1803500,1,9,48,34,554,35314554
16422,99,1803500,2,9,48,34,653,35314653
16423,1,1803500,1,9,48,34,654,35314654
16424,0,1803500,1,9,48,34,654,35314654
16425,390,1803400,2,9,48,35,44,35315044
16426,50,1803300,1,9,48,35,94,35315094
16427,102,1803300,1,9,48,35,196,35315196
16429,232,1803400,2,9,48,35,428,35315428
16430,60,1803400,1,9,48,35,488,35315488
16431,231,1803300,1,9,48,35,719,35315719
16432,40,1803500,10,9,48,35,759,35315759
16433,82,1803300,1,9,48,35,841,35315841
16434,849,1803300,3,9,48,36,690,35316690
16435,1870,1803400,1,9,48,38,560,35318560
16436,40,1803400,1,9,48,38,600,35318600
16437,1,1803400,1,9,48,38,601,35318601
16438,67,1803300,1,9,48,38,668,35318668
16439,1642,1803300,1,9,48,40,310,35320310
16440,586,1803200,1,9,48,40,896,35320896
16441,54,1803300,1,9,48,40,950,35320950
16442,147,1803200,1,9,48,41,97,35321097
16443,552,1803200,7,9,48,41,649,35321649
16444,581,1803100,1,9,48,42,230,35322230
16445,2315,1803200,1,9,48,44,545,35324545
16446,6,1803200,3,9,48,44,551,35324551
16448,2698,1803200,1,9,48,47,249,35327249
16450,1067,1803200,1,9,48,48,316,35328316
16451,155,1803100,1,9,48,48,471,35328471
16452,190,1803300,1,9,48,48,661,35328661
16453,71,1803300,1,9,48,48,732,35328732
16454,94,1803300,1,9,48,48,826,35328826
16455,86,1803400,1,9,48,48,912,35328912
16456,313,1803400,1,9,48,49,225,35329225
16457,66,1803400,1,9,48,49,291,35329291
16458,3056,1803200,1,9,48,52,347,35332347
16459,794,1803300,1,9,48,53,141,35333141
16460,1347,1803100,4,9,48,54,488,35334488
16461,177,1803200,3,9,48,54,665,35334665
16462,1,1803200,1,9,48,54,666,35334666
16463,0,1803200,1,9,48,54,666,35334666
16464,1,1803300,1,9,48,54,667,35334667
16465,0,1803300,1,9,48,54,667,35334667
16466,893,1803200,2,9,48,55,560,35335560
16467,954,1803300,3,9,48,56,514,35336514
16469,1603,1803200,7,9,48,58,117,35338117
16471,1938,1803200,1,9,49,0,55,35340055
16472,313,1803200,1,9,49,0,368,35340368
16473,110,1803200,1,9,49,0,478,35340478
16474,21,1803200,1,9,49,0,499,35340499
16475,33,1803300,1,9,49,0,532,35340532
16476,27,1803300,1,9,49,0,559,35340559
16477,738,1803200,1,9,49,1,297,35341297
16478,263,1803300,1,9,49,1,560,35341560
16479,0,1803300,1,9,49,1,560,35341560
16480,112,1803200,1,9,49,1,672,35341672
16481,80,1803200,1,9,49,1,752,35341752
16482,1155,1803300,1,9,49,2,907,35342907
16483,794,1803300,1,9,49,3,701,35343701
16484,273,1803200,1,9,49,3,974,35343974
16485,1960,1803200,8,9,49,5,934,35345934
16486,1073,1803200,2,9,49,7,7,35347007
16487,1714,1803200,1,9,49,8,721,35348721
16488,481,1803100,1,9,49,9,202,35349202
16489,375,1803100,100,9,49,9,577,35349577
16490,1,1803100,1,9,49,9,578,35349578
16491,0,1803100,4,9,49,9,578,35349578
16492,0,1803100,8,9,49,9,578,35349578
16493,0,1803100,14,9,49,9,578,35349578
16494,0,1803100,1,9,49,9,578,35349578
16495,0,1803100,1,9,49,9,578,35349578
16496,0,1803100,1,9,49,9,578,35349578
16497,0,1803100,2,9,49,9,578,35349578
16498,1,1803100,6,9,49,9,579,35349579
16499,0,1803100,2,9,49,9,579,35349579
16500,0,1803100,19,9,49,9,579,35349579
16501,0,1803100,1,9,49,9,579,35349579
16502,0,1803100,23,9,49,9,579,35349579
16503,0,1803100,1,9,49,9,579,35349579
16504,0,1803100,2,9,49,9,579,35349579
16505,1,1803100,1,9,49,9,580,35349580
16506,0,1803100,5,9,49,9,580,35349580
16508,1,1803100,2,9,49,9,581,35349581
16509,1,1803100,2,9,49,9,582,35349582
16510,0,1803100,1,9,49,9,582,35349582
16511,0,1803100,1,9,49,9,582,35349582
16512,0,1803100,1,9,49,9,582,35349582
16513,0,1803100,4,9,49,9,582,35349582
16514,0,1803100,2,9,49,9,582,35349582
16515,0,1803100,1,9,49,9,582,35349582
16516,0,1803100,8,9,49,9,582,35349582
16517,0,1803100,7,9,49,9,582,35349582
16518,0,1803100,1,9,49,9,582,35349582
16519,0,1803100,1,9,49,9,582,35349582
16520,0,1803100,1,9,49,9,582,35349582
16521,1,1803100,1,9,49,9,583,35349583
16522,0,1803100,2,9,49,9,583,35349583
16523,0,1803100,1,9,49,9,583,35349583
16524,0,1803100,1,9,49,9,583,35349583
16525,0,1803100,1,9,49,9,583,35349583
16526,0,1803100,6,9,49,9,583,35349583
16527,0,1803100,8,9,49,9,583,35349583
16528,0,1803100,1,9,49,9,583,35349583
16529,0,1803100,1,9,49,9,583,35349583
16530,0,1803100,1,9,49,9,583,35349583
16531,20,1803100,3,9,49,9,603,35349603
16532,33,1803000,1,9,49,9,636,35349636
16533,1413,1803100,1,9,49,11,49,35351049
16534,12,1803000,8,9,49,11,61,35351061
16535,79,1802900,1,9,49,11,140,35351140
16536,521,1803100,3,9,49,11,661,35351661
16537,371,1802900,1,9,49,12,32,35352032
16538,102,1803100,2,9,49,12,134,35352134
16539,51,1803200,2,9,49,12,185,35352185
16540,48,1803100,1,9,49,12,233,35352233
16541,16,1803200,1,9,49,12,249,35352249
16542,114,1803100,6,9,49,12,363,35352363
16544,60,1803000,1,9,49,12,423,35352423
16545,638,1803000,2,9,49,13,61,35353061
16546,683,1803000,1,9,49,13,744,35353744
16547,1073,1803000,1,9,49,14,817,35354817
16548,125,1802900,10,9,49,14,942,35354942
16549,793,1803000,2,9,49,15,735,35355735
16550,254,1802900,1,9,49,15,989,35355989
16551,268,1802800,1,9,49,16,257,35356257
16552,1399,1802800,1,9,49,17,656,35357656
16553,63,1802800,18,9,49,17,719,35357719
16554,447,1802700,5,9,49,18,166,35358166
16555,76,1802700,1,9,49,18,242,35358242
16556,531,1802800,1,9,49,18,773,35358773
16557,29,1802900,1,9,49,18,802,35358802
16558,393,1802700,1,9,49,19,195,35359195
16559,469,1802700,1,9,49,19,664,35359664
16560,93,1802700,1,9,49,19,757,35359757
16561,1,1802700,3,9,49,19,758,35359758
16562,0,1802700,1,9,49,19,758,35359758
16563,0,1802700,1,9,49,19,758,35359758
16564,0,1802700,1,9,49,19,758,35359758
16565,0,1802700,1,9,49,19,758,35359758
16566,0,1802700,1,9,49,19,758,35359758
16567,248,1802600,22,9,49,20,6,35360006
16568,286,1802700,1,9,49,20,292,35360292
16569,4,1802500,1,9,49,20,296,35360296
16570,516,1802500,1,9,49,20,812,35360812
16571,453,1802600,1,9,49,21,265,35361265
16573,554,1802800,8,9,49,21,819,35361819
16574,0,1802800,8,9,49,21,819,35361819
16576,3,1803000,16,9,49,21,822,35361822
16577,2,1803000,1,9,49,21,824,35361824
16578,136,1802900,1,9,49,21,960,35361960
16579,388,1803000,2,9,49,22,348,35362348
16580,1,1803000,1,9,49,22,349,35362349
16581,134,1803000,5,9,49,22,483,35362483
16582,0,1803000,5,9,49,22,483,35362483
16584,253,1802800,1,9,49,22,736,35362736
16585,76,1802800,1,9,49,22,812,35362812
16586,28,1802800,1,9,49,22,840,35362840
16587,23,1802800,1,9,49,22,863,35362863
16588,688,1802700,1,9,49,23,551,35363551
16589,1217,1802700,2,9,49,24,768,35364768
16590,667,1802600,2,9,49,25,435,35365435
16592,1,1802500,1,9,49,25,436,35365436
16593,1,1802400,1,9,49,25,437,35365437
16594,0,1802400,1,9,49,25,437,35365437
16595,0,1802400,1,9,49,25,437,35365437
16596,4,1802400,5,9,49,25,441,35365441
16597,90,1802400,1,9,49,25,531,35365531
16598,18,1802300,1,9,49,25,549,35365549
16599,18,1802400,1,9,49,25,567,35365567
16600,1,1802300,1,9,49,25,568,35365568
16601,120,1802300,1,9,49,25,688,35365688
16602,17,1802300,5,9,49,25,705,35365705
16603,64,1802300,16,9,49,25,769,35365769
16604,1,1802300,3,9,49,25,770,35365770
16605,11,1802200,5,9,49,25,781,35365781
16606,0,1802200,10,9,49,25,781,35365781
16607,0,1802200,1,9,49,25,781,35365781
16608,1,1802200,1,9,49,25,782,35365782
16609,0,1802200,1,9,49,25,782,35365782
16610,31,1802300,1,9,49,25,813,35365813
16611,217,1802300,1,9,49,26,30,35366030
16612,25,1802300,2,9,49,26,55,35366055
16613,1501,1802400,2,9,49,27,556,35367556
16614,40,1802400,2,9,49,27,596,35367596
16615,55,1802500,60,9,49,27,651,35367651
16616,1,1802500,19,9,49,27,652,35367652
16617,0,1802500,1,9,49,27,652,35367652
16618,1,1802600,1,9,49,27,653,35367653
16619,0,1802600,1,9,49,27,653,35367653
16620,0,1802600,1,9,49,27,653,35367653
16621,45,1802600,1,9,49,27,698,35367698
16622,64,1802500,1,9,49,27,762,35367762
16623,30,1802500,1,9,49,27,792,35367792
16624,79,1802600,1,9,49,27,871,35367871
16625,213,1802600,1,9,49,28,84,35368084
16626,97,1802500,1,9,49,28,181,35368181
16627,371,1802500,1,9,49,28,552,35368552
16628,130,1802400,1,9,49,28,682,35368682
16629,152,1802500,3,9,49,28,834,35368834
16630,0,1802500,1,9,49,28,834,35368834
16631,994,1802400,1,9,49,29,828,35369828
16632,136,1802500,1,9,49,29,964,35369964
16633,116,1802500,2,9,49,30,80,35370080
16634,1066,1802500,1,9,49,31,146,35371146
16635,754,1802600,1,9,49,31,900,35371900
16636,314,1802600,1,9,49,32,214,35372214
16637,1482,1802500,1,9,49,33,696,35373696
16638,209,1802400,1,9,49,33,905,35373905
16639,624,1802500,1,9,49,34,529,35374529
16640,1169,1802500,1,9,49,35,698,35375698
16641,1,1802600,4,9,49,35,699,35375699
16642,0,1802600,4,9,49,35,699,35375699
16643,0,1802600,4,9,49,35,699,35375699
16644,0,1802600,4,9,49,35,699,35375699
16646,43,1803000,1,9,49,35,742,35375742
16647,0,1803000,1,9,49,35,742,35375742
16648,0,1803000,2,9,49,35,742,35375742
16649,0,1803000,1,9,49,35,742,35375742
16650,156,1802900,1,9,49,35,898,35375898
16651,680,1803000,6,9,49,36,578,35376578
16652,2,1803100,1,9,49,36,580,35376580
16653,0,1803100,5,9,49,36,580,35376580
16654,0,1803100,2,9,49,36,580,35376580
16655,299,1803200,7,9,49,36,879,35376879
16656,338,1803200,1,9,49,37,217,35377217
16657,99,1803200,1,9,49,37,316,35377316
16658,27,1803100,1,9,49,37,343,35377343
16659,532,1803100,1,9,49,37,875,35377875
16660,488,1803100,1,9,49,38,363,35378363
16661,104,1803100,2,9,49,38,467,35378467
16663,312,1803000,1,9,49,38,779,35378779
16664,393,1803100,1,9,49,39,172,35379172
16665,334,1803000,1,9,49,39,506,35379506
16666,369,1803100,1,9,49,39,875,35379875
16667,413,1803000,1,9,49,40,288,35380288
16668,19,1803000,1,9,49,40,307,35380307
16669,89,1803000,1,9,49,40,396,35380396
16670,1011,1803100,1,9,49,41,407,35381407
16671,446,1803100,1,9,49,41,853,35381853
16672,325,1803200,1,9,49,42,178,35382178
16673,208,1803100,1,9,49,42,386,35382386
16674,566,1803000,1,9,49,42,952,35382952
16675,2203,1803100,2,9,49,45,155,35385155
16676,130,1803100,1,9,49,45,285,35385285
16677,21,1803200,3,9,49,45,306,35385306
16678,314,1803100,1,9,49,45,620,35385620
16679,1248,1803000,2,9,49,46,868,35386868
16680,214,1803000,2,9,49,47,82,35387082
16681,3517,1803100,1,9,49,50,599,35390599
16682,742,1803000,1,9,49,51,341,35391341
16683,1354,1803100,6,9,49,52,695,35392695
16684,533,1803100,1,9,49,53,228,35393228
16685,2254,1803000,1,9,49,55,482,35395482
16686,723,1803200,6,9,49,56,205,35396205
16687,1,1803200,1,9,49,56,206,35396206
16688,40,1803200,1,9,49,56,246,35396246
16689,153,1803300,1,9,49,56,399,35396399
16690,866,1803200,1,9,49,57,265,35397265
16691,196,1803200,1,9,49,57,461,35397461
16692,548,1803200,1,9,49,58,9,35398009
16693,3104,1803300,1,9,50,1,113,35401113
16694,1,1803300,6,9,50,1,114,35401114
16695,0,1803300,8,9,50,1,114,35401114
16696,0,1803300,1,9,50,1,114,35401114
16697,0,1803300,3,9,50,1,114,35401114
16698,1,1803300,1,9,50,1,115,35401115
16699,0,1803300,4,9,50,1,115,35401115
16700,0,1803300,1,9,50,1,115,35401115
16701,0,1803300,1,9,50,1,115,35401115
16702,164,1803400,2,9,50,1,279,35401279
16703,243,1803300,2,9,50,1,522,35401522
16704,18,1803400,6,9,50,1,540,35401540
16705,17,1803400,2,9,50,1,557,35401557
16706,283,1803300,1,9,50,1,840,35401840
16707,673,1803200,1,9,50,2,513,35402513
16708,842,1803200,1,9,50,3,355,35403355
16709,1129,1803200,1,9,50,4,484,35404484
16710,494,1803200,2,9,50,4,978,35404978
16711,2596,1803200,7,9,50,7,574,35407574
16712,0,1803200,7,9,50,7,574,35407574
16714,2,1803000,1,9,50,7,576,35407576
16715,1,1803000,1,9,50,7,577,35407577
16716,0,1803000,10,9,50,7,577,35407577
16717,2,1803000,1,9,50,7,579,35407579
16718,0,1803000,1,9,50,7,579,35407579
16719,0,1803000,1,9,50,7,579,35407579
16720,0,1803000,1,9,50,7,579,35407579
16721,0,1803000,1,9,50,7,579,35407579
16722,0,1803000,1,9,50,7,579,35407579
16723,10,1803000,3,9,50,7,589,35407589
16724,83,1803000,1,9,50,7,672,35407672
16725,102,1803100,1,9,50,7,774,35407774
16726,25,1803100,1,9,50,7,799,35407799
16727,1287,1803100,1,9,50,9,86,35409086
16728,214,1803100,1,9,50,9,300,35409300
16729,553,1802900,5,9,50,9,853,35409853
16731,2,1802900,1,9,50,9,855,35409855
16732,55,1802900,1,9,50,9,910,35409910
16733,560,1802900,1,9,50,10,470,35410470
16734,25,1802900,1,9,50,10,495,35410495
16735,458,1802800,10,9,50,10,953,35410953
16736,238,1802900,1,9,50,11,191,35411191
16737,1310,1802800,1,9,50,12,501,35412501
16738,694,1802800,1,9,50,13,195,35413195
16739,0,1802800,2,9,50,13,195,35413195
16740,0,1802800,1,9,50,13,195,35413195
16741,596,1802700,1,9,50,13,791,35413791
16742,1603,1802800,1,9,50,15,394,35415394
16743,140,1802800,1,9,50,15,534,35415534
16744,1229,1802800,1,9,50,16,763,35416763
16745,716,1802700,1,9,50,17,479,35417479
16746,1101,1802900,1,9,50,18,580,35418580
16747,338,1803000,1,9,50,18,918,35418918
16748,920,1802900,1,9,50,19,838,35419838
16749,4154,1802900,1,9,50,23,992,35423992
16750,616,1803000,2,9,50,24,608,35424608
16752,653,1802900,1,9,50,25,261,35425261
16753,179,1802900,1,9,50,25,440,35425440
16754,0,1802900,3,9,50,25,440,35425440
16755,41,1802800,13,9,50,25,481,35425481
16756,973,1802800,1,9,50,26,454,35426454
16757,2558,1802900,1,9,50,29,12,35429012
16758,890,1803000,1,9,50,29,902,35429902
16759,1281,1802900,5,9,50,31,183,35431183
16760,996,1802900,1,9,50,32,179,35432179
16761,522,1802900,1,9,50,32,701,35432701
16762,23,1802900,1,9,50,32,724,35432724
16763,4330,1802800,2,9,50,37,54,35437054
16764,2952,1802800,1,9,50,40,6,35440006
16765,541,1802800,1,9,50,40,547,35440547
16766,1157,1802700,1,9,50,41,704,35441704
16767,120,1802700,1,9,50,41,824,35441824
16768,318,1802700,1,9,50,42,142,35442142
16769,133,1802700,1,9,50,42,275,35442275
16770,682,1802800,2,9,50,42,957,35442957
16771,1764,1802700,6,9,50,44,721,35444721
16772,1,1802700,2,9,50,44,722,35444722
16773,795,1802600,1,9,50,45,517,35445517
16774,410,1802800,1,9,50,45,927,35445927
16775,1429,1802700,1,9,50,47,356,35447356
16776,2223,1802800,2,9,50,49,579,35449579
16777,0,1802800,1,9,50,49,579,35449579
16778,0,1802800,1,9,50,49,579,35449579
16779,1,1802800,1,9,50,49,580,35449580
16780,0,1802800,1,9,50,49,580,35449580
16781,483,1802900,1,9,50,50,63,35450063
16782,960,1802900,1,9,50,51,23,35451023
16783,364,1803000,2,9,50,51,387,35451387
16784,0,1803000,1,9,50,51,387,35451387
16785,1,1803000,7,9,50,51,388,35451388
16786,136,1803100,3,9,50,51,524,35451524
16787,914,1803000,3,9,50,52,438,35452438
16788,1005,1803000,4,9,50,53,443,35453443
16789,449,1803100,1,9,50,53,892,35453892
16790,50,1803100,1,9,50,53,942,35453942
16791,9,1803000,1,9,50,53,951,35453951
16792,1155,1803300,7,9,50,55,106,35455106
16793,94,1803400,9,9,50,55,200,35455200
16794,156,1803500,2,9,50,55,356,35455356
16795,3,1803500,3,9,50,55,359,35455359
16796,52,1803400,1,9,50,55,411,35455411
16797,271,1803300,1,9,50,55,682,35455682
16798,0,1803300,1,9,50,55,682,35455682
16799,38,1803400,1,9,50,55,720,35455720
16800,60,1803300,1,9,50,55,780,35455780
16801,320,1803400,1,9,50,56,100,35456100
16802,228,1803300,2,9,50,56,328,35456328
16803,1353,1803300,2,9,50,57,681,35457681
16804,237,1803400,1,9,50,57,918,35457918
16805,317,1803400,2,9,50,58,235,35458235
16806,76,1803400,1,9,50,58,311,35458311
16807,8,1803400,4,9,50,58,319,35458319
16808,158,1803400,6,9,50,58,477,35458477
16809,0,1803400,6,9,50,58,477,35458477
16810,0,1803400,6,9,50,58,477,35458477
16811,0,1803400,6,9,50,58,477,35458477
16813,17,1803200,1,9,50,58,494,35458494
16814,29,1803100,3,9,50,58,523,35458523
16815,40,1803200,1,9,50,58,563,35458563
16816,579,1803100,2,9,50,59,142,35459142
16817,1379,1803200,5,9,51,0,521,35460521
16818,884,1803300,1,9,51,1,405,35461405
16819,146,1803200,5,9,51,1,551,35461551
16820,0,1803200,5,9,51,1,551,35461551
16822,2,1803000,4,9,51,1,553,35461553
16823,0,1803000,2,9,51,1,553,35461553
16824,1,1803000,2,9,51,1,554,35461554
16825,0,1803000,3,9,51,1,554,35461554
16826,0,1803000,1,9,51,1,554,35461554
16827,0,1803000,8,9,51,1,554,35461554
16828,0,1803000,1,9,51,1,554,35461554
16829,0,1803000,5,9,51,1,554,35461554
16830,2,1803100,2,9,51,1,556,35461556
16831,3,1803100,1,9,51,1,559,35461559
16832,2,1803100,1,9,51,1,561,35461561
16833,34,1803100,2,9,51,1,595,35461595
16834,153,1803200,1,9,51,1,748,35461748
16835,522,1803000,1,9,51,2,270,35462270
16836,78,1803200,1,9,51,2,348,35462348
16837,725,1803100,1,9,51,3,73,35463073
16838,381,1803200,2,9,51,3,454,35463454
16839,1033,1803300,2,9,51,4,487,35464487
16840,1295,1803100,2,9,51,5,782,35465782
16842,2,1803000,47,9,51,5,784,35465784
16843,1,1803000,1,9,51,5,785,35465785
16844,466,1803000,1,9,51,6,251,35466251
16845,608,1802900,1,9,51,6,859,35466859
16846,331,1803000,1,9,51,7,190,35467190
16847,35,1803000,1,9,51,7,225,35467225
16848,1,1803100,1,9,51,7,226,35467226
16849,1239,1803000,1,9,51,8,465,35468465
16850,1683,1803000,1,9,51,10,148,35470148
16851,3,1802900,1,9,51,10,151,35470151
16852,434,1803000,1,9,51,10,585,35470585
16853,315,1803000,2,9,51,10,900,35470900
16854,3531,1803100,4,9,51,14,431,35474431
16855,333,1803000,1,9,51,14,764,35474764
16856,1,1803000,1,9,51,14,765,35474765
16857,607,1803100,1,9,51,15,372,35475372
16858,1250,1803000,5,9,51,16,622,35476622
16860,5,1802900,1,9,51,16,627,35476627
16861,3334,1802900,1,9,51,19,961,35479961
16862,15,1802900,2,9,51,19,976,35479976
16863,0,1802900,1,9,51,19,976,35479976
16864,130,1802900,2,9,51,20,106,35480106
16865,0,1802900,1,9,51,20,106,35480106
16866,6,1802900,41,9,51,20,112,35480112
16867,0,1803000,1,9,51,20,112,35480112
16868,1,1803000,1,9,51,20,113,35480113
16869,275,1803000,1,9,51,20,388,35480388
16870,2912,1802900,1,9,51,23,300,35483300
16871,39,1802900,1,9,51,23,339,35483339
16872,185,1802900,1,9,51,23,524,35483524
16873,423,1802900,1,9,51,23,947,35483947
16874,201,1802900,1,9,51,24,148,35484148
16875,975,1803000,1,9,51,25,123,35485123
16876,73,1803000,1,9,51,25,196,35485196
16877,170,1802900,1,9,51,25,366,35485366
16878,145,1802900,1,9,51,25,511,35485511
16879,2524,1803000,1,9,51,28,35,35488035
16880,1429,1802900,1,9,51,29,464,35489464
16881,12,1803000,1,9,51,29,476,35489476
16882,1,1803000,1,9,51,29,477,35489477
16883,17,1803000,1,9,51,29,494,35489494
16884,308,1803000,1,9,51,29,802,35489802
16885,731,1802900,1,9,51,30,533,35490533
16886,289,1802900,6,9,51,30,822,35490822
16887,562,1802900,1,9,51,31,384,35491384
16888,2086,1802900,1,9,51,33,470,35493470
16889,4405,1802900,7,9,51,37,875,35497875
16891,1344,1803000,7,9,51,39,219,35499219
16893,21,1803000,1,9,51,39,240,35499240
16895,212,1802900,1,9,51,39,452,35499452
16896,108,1802900,1,9,51,39,560,35499560
16897,4714,1803000,3,9,51,44,274,35504274
16898,2126,1803000,1,9,51,46,400,35506400
16899,802,1803000,1,9,51,47,202,35507202
16901,698,1803100,7,9,51,47,900,35507900
16903,1129,1803000,1,9,51,49,29,35509029
16904,1050,1803100,1,9,51,50,79,35510079
16905,425,1803200,2,9,51,50,504,35510504
16906,211,1803200,2,9,51,50,715,35510715
16907,1,1803200,6,9,51,50,716,35510716
16908,176,1803300,2,9,51,50,892,35510892
16909,961,1803200,1,9,51,51,853,35511853
16910,375,1803100,1,9,51,52,228,35512228
16911,170,1803100,1,9,51,52,398,35512398
16912,442,1803100,1,9,51,52,840,35512840
16913,36,1803200,1,9,51,52,876,35512876
16914,782,1803100,1,9,51,53,658,35513658
16915,115,1803100,1,9,51,53,773,35513773
16916,1194,1803300,1,9,51,54,967,35514967
16917,84,1803300,1,9,51,55,51,35515051
16918,459,1803300,5,9,51,55,510,35515510
16919,329,1803200,1,9,51,55,839,35515839
16920,449,1803200,1,9,51,56,288,35516288
16921,205,1803400,1,9,51,56,493,35516493
16922,778,1803400,3,9,51,57,271,35517271
16923,586,1803500,6,9,51,57,857,35517857
16924,1138,1803400,1,9,51,58,995,35518995
16925,615,1803500,1,9,51,59,610,35519610
16926,234,1803500,1,9,51,59,844,35519844
16927,309,1803500,10,9,52,0,153,35520153
16928,39,1803500,1,9,52,0,192,35520192
16929,58,1803500,1,9,52,0,250,35520250
16930,851,1803300,1,9,52,1,101,35521101
16931,474,1803300,3,9,52,1,575,35521575
16932,1,1803200,1,9,52,1,576,35521576
16933,0,1803200,1,9,52,1,576,35521576
16934,2,1803100,3,9,52,1,578,35521578
16935,1,1803100,1,9,52,1,579,35521579
16936,0,1803100,1,9,52,1,579,35521579
16937,0,1803100,1,9,52,1,579,35521579
16938,43,1803100,1,9,52,1,622,35521622
16939,24,1803100,1,9,52,1,646,35521646
16940,60,1803100,1,9,52,1,706,35521706
16941,432,1803300,1,9,52,2,138,35522138
16942,1034,1803300,1,9,52,3,172,35523172
16943,133,1803100,1,9,52,3,305,35523305
16944,2830,1803300,1,9,52,6,135,35526135
16945,435,1803200,1,9,52,6,570,35526570
16946,52,1803400,1,9,52,6,622,35526622
16947,353,1803300,1,9,52,6,975,35526975
16948,2097,1803100,4,9,52,9,72,35529072
16950,8,1802900,1,9,52,9,80,35529080
16951,4,1803000,1,9,52,9,84,35529084
16952,410,1803000,1,9,52,9,494,35529494
16953,223,1803000,1,9,52,9,717,35529717
16954,169,1803000,1,9,52,9,886,35529886
16955,391,1802900,2,9,52,10,277,35530277
16956,1,1802900,2,9,52,10,278,35530278
16957,474,1802800,2,9,52,10,752,35530752
16958,0,1802800,5,9,52,10,752,35530752
16959,0,1802800,10,9,52,10,752,35530752
16960,0,1802800,2,9,52,10,752,35530752
16961,11,1802800,1,9,52,10,763,35530763
16962,123,1802800,1,9,52,10,886,35530886
16963,224,1802900,5,9,52,11,110,35531110
16964,1465,1803000,1,9,52,12,575,35532575
16965,1926,1803000,1,9,52,14,501,35534501
16966,1226,1803000,4,9,52,15,727,35535727
16967,0,1803000,7,9,52,15,727,35535727
16968,0,1803000,1,9,52,15,727,35535727
16969,0,1803000,1,9,52,15,727,35535727
16970,0,1803000,1,9,52,15,727,35535727
16971,0,1803000,1,9,52,15,727,35535727
16972,0,1803000,1,9,52,15,727,35535727
16973,1,1803000,1,9,52,15,728,35535728
16974,0,1803000,7,9,52,15,728,35535728
16975,0,1803000,7,9,52,15,728,35535728
16976,1,1803000,1,9,52,15,729,35535729
16977,2016,1802900,2,9,52,17,745,35537745
16978,576,1803000,1,9,52,18,321,35538321
16979,30,1803100,1,9,52,18,351,35538351
16980,366,1803100,1,9,52,18,717,35538717
16981,59,1803200,10,9,52,18,776,35538776
16982,1268,1803000,4,9,52,20,44,35540044
16983,1038,1802900,1,9,52,21,82,35541082
16984,2856,1803000,1,9,52,23,938,35543938
16985,1298,1802900,2,9,52,25,236,35545236
16986,1788,1803000,1,9,52,27,24,35547024
16987,789,1802900,3,9,52,27,813,35547813
16988,595,1803000,1,9,52,28,408,35548408
16989,512,1803000,1,9,52,28,920,35548920
16990,643,1803000,1,9,52,29,563,35549563
16991,503,1802900,1,9,52,30,66,35550066
16992,211,1802900,1,9,52,30,277,35550277
16993,0,1802900,2,9,52,30,277,35550277
16994,3,1802800,8,9,52,30,280,35550280
16995,11,1802900,1,9,52,30,291,35550291
16996,567,1802900,1,9,52,30,858,35550858
16997,3983,1802900,1,9,52,34,841,35554841
16998,3840,1802900,1,9,52,38,681,35558681
16999,1930,1803000,1,9,52,40,611,35560611
17000,115,1803000,1,9,52,40,726,35560726
17001,0,1803000,1,9,52,40,726,35560726
17002,1,1803000,1,9,52,40,727,35560727
17003,2267,1803000,1,9,52,42,994,35562994
17004,50,1803000,1,9,52,43,44,35563044
17005,1248,1803100,1,9,52,44,292,35564292
17006,1011,1803100,3,9,52,45,303,35565303
17007,927,1803200,1,9,52,46,230,35566230
17008,234,1803200,1,9,52,46,464,35566464
17009,1067,1803200,1,9,52,47,531,35567531
17010,695,1803300,8,9,52,48,226,35568226
17012,515,1803100,1,9,52,48,741,35568741
17013,1365,1803200,2,9,52,50,106,35570106
17014,42,1803100,1,9,52,50,148,35570148
17015,0,1803100,1,9,52,50,148,35570148
17016,0,1803100,1,9,52,50,148,35570148
17017,60,1803000,1,9,52,50,208,35570208
17018,98,1802900,3,9,52,50,306,35570306
17020,20,1803100,1,9,52,50,326,35570326
17021,147,1803100,1,9,52,50,473,35570473
17022,1719,1802900,1,9,52,52,192,35572192
17023,45,1802800,5,9,52,52,237,35572237
17024,0,1802800,2,9,52,52,237,35572237
17025,5657,1802900,1,9,52,57,894,35577894
17026,1,1802900,1,9,52,57,895,35577895
17027,0,1802900,1,9,52,57,895,35577895
17028,514,1802800,4,9,52,58,409,35578409
17029,1823,1802900,1,9,53,0,232,35580232
17030,831,1803000,1,9,53,1,63,35581063
17031,490,1803000,1,9,53,1,553,35581553
17032,184,1802900,1,9,53,1,737,35581737
17033,86,1802900,2,9,53,1,823,35581823
17034,178,1803000,1,9,53,2,1,35582001
17035,52,1803000,1,9,53,2,53,35582053
17036,197,1803000,2,9,53,2,250,35582250
17037,11,1803000,1,9,53,2,261,35582261
17038,207,1802900,2,9,53,2,468,35582468
17039,714,1803000,1,9,53,3,182,35583182
17040,2,1803000,2,9,53,3,184,35583184
17041,2043,1802900,3,9,53,5,227,35585227
17042,0,1802900,1,9,53,5,227,35585227
17043,1,1802900,2,9,53,5,228,35585228
17044,30,1802800,1,9,53,5,258,35585258
17045,0,1802800,6,9,53,5,258,35585258
17046,81,1802800,2,9,53,5,339,35585339
17047,1301,1802900,1,9,53,6,640,35586640
17048,304,1802800,1,9,53,6,944,35586944
17049,193,1802700,1,9,53,7,137,35587137
17050,683,1802700,1,9,53,7,820,35587820
17051,589,1802800,1,9,53,8,409,35588409
17052,1588,1803000,1,9,53,9,997,35589997
17053,1731,1802900,1,9,53,11,728,35591728
17054,96,1802900,1,9,53,11,824,35591824
17055,564,1802900,1,9,53,12,388,35592388
17056,1,1802900,4,9,53,12,389,35592389
17057,2,1803000,2,9,53,12,391,35592391
17058,0,1802900,2,9,53,12,391,35592391
17059,1,1803000,1,9,53,12,392,35592392
17060,1975,1803000,1,9,53,14,367,35594367
17061,0,1803000,4,9,53,14,367,35594367
17062,2413,1802900,1,9,53,16,780,35596780
17063,222,1802800,9,9,53,17,2,35597002
17064,1597,1802800,1,9,53,18,599,35598599
17065,187,1802800,11,9,53,18,786,35598786
17066,1,1802800,1,9,53,18,787,35598787
17067,0,1802800,1,9,53,18,787,35598787
17068,1,1802800,1,9,53,18,788,35598788
17069,171,1802800,1,9,53,18,959,35598959
17070,239,1802800,1,9,53,19,198,35599198
17071,1,1802800,1,9,53,19,199,35599199
17072,1393,1802800,1,9,53,20,592,35600592
17073,1113,1803000,4,9,53,21,705,35601705
17074,1690,1803000,3,9,53,23,395,35603395
17076,1384,1802900,1,9,53,24,779,35604779
17077,200,1802800,1,9,53,24,979,35604979
17078,2385,1802800,9,9,53,27,364,35607364
17079,1223,1802700,1,9,53,28,587,35608587
17080,73,1802700,3,9,53,28,660,35608660
17081,297,1802700,2,9,53,28,957,35608957
17082,0,1802700,9,9,53,28,957,35608957
17083,0,1802700,4,9,53,28,957,35608957
17084,0,1802700,3,9,53,28,957,35608957
17085,296,1802600,1,9,53,29,253,35609253
17086,198,1802600,1,9,53,29,451,35609451
17087,135,1802800,1,9,53,29,586,35609586
17088,406,1802700,1,9,53,29,992,35609992
17089,300,1802700,1,9,53,30,292,35610292
17090,354,1802700,2,9,53,30,646,35610646
17091,300,1802600,1,9,53,30,946,35610946
17092,4514,1802700,2,9,53,35,460,35615460
17093,534,1802800,1,9,53,35,994,35615994
17094,0,1802700,5,9,53,35,994,35615994
17095,189,1802600,1,9,53,36,183,35616183
17096,1476,1802600,1,9,53,37,659,35617659
17097,802,1802700,1,9,53,38,461,35618461
17098,904,1802700,1,9,53,39,365,35619365
17099,1070,1802700,2,9,53,40,435,35620435
17100,0,1802700,2,9,53,40,435,35620435
17102,276,1802700,1,9,53,40,711,35620711
17103,168,1802700,1,9,53,40,879,35620879
17104,1392,1802700,2,9,53,42,271,35622271
17105,1919,1802900,1,9,53,44,190,35624190
17106,310,1802700,1,9,53,44,500,35624500
17107,113,1802900,1,9,53,44,613,35624613
17108,1405,1802700,1,9,53,46,18,35626018
17109,177,1802900,1,9,53,46,195,35626195
17110,994,1802900,1,9,53,47,189,35627189
17111,999,1802900,1,9,53,48,188,35628188
17112,1212,1802800,1,9,53,49,400,35629400
17113,2539,1802900,2,9,53,51,939,35631939
17115,258,1803000,1,9,53,52,197,35632197
17116,658,1803000,1,9,53,52,855,35632855
17117,0,1803000,2,9,53,52,855,35632855
17118,0,1803000,6,9,53,52,855,35632855
17119,0,1803000,1,9,53,52,855,35632855
17120,0,1803000,1,9,53,52,855,35632855
17121,416,1802900,2,9,53,53,271,35633271
17122,585,1802900,1,9,53,53,856,35633856
17123,1066,1802900,1,9,53,54,922,35634922
17124,14,1803100,1,9,53,54,936,35634936
17125,1453,1802900,1,9,53,56,389,35636389
17126,773,1802800,1,9,53,57,162,35637162
17127,645,1802700,1,9,53,57,807,35637807
17128,1501,1802900,1,9,53,59,308,35639308
17129,11,1803000,1,9,53,59,319,35639319
17130,1617,1802800,1,9,54,0,936,35640936
17131,245,1803000,2,9,54,1,181,35641181
17132,125,1803000,2,9,54,1,306,35641306
17133,28,1803000,2,9,54,1,334,35641334
17134,361,1803000,1,9,54,1,695,35641695
17135,1282,1802900,1,9,54,2,977,35642977
17136,28,1803100,1,9,54,3,5,35643005
17137,684,1803000,1,9,54,3,689,35643689
17138,928,1802900,1,9,54,4,617,35644617
17139,469,1803000,1,9,54,5,86,35645086
17140,0,1803000,1,9,54,5,86,35645086
17142,1054,1803000,1,9,54,6,140,35646140
17143,749,1803000,1,9,54,6,889,35646889
17144,20,1803000,1,9,54,6,909,35646909
17145,3897,1802900,1,9,54,10,806,35650806
17146,413,1803100,1,9,54,11,219,35651219
17147,0,1803000,3,9,54,11,219,35651219
17148,12,1803200,2,9,54,11,231,35651231
17149,1163,1803200,6,9,54,12,394,35652394
17150,818,1803300,2,9,54,13,212,35653212
17151,187,1803300,1,9,54,13,399,35653399
17152,56,1803200,1,9,54,13,455,35653455
17153,2577,1803200,1,9,54,16,32,35656032
17154,246,1803100,1,9,54,16,278,35656278
17155,943,1803100,1,9,54,17,221,35657221
17156,5,1803300,1,9,54,17,226,35657226
17157,450,1803200,2,9,54,17,676,35657676
17158,4,1803300,1,9,54,17,680,35657680
17159,1301,1803100,1,9,54,18,981,35658981
17160,369,1803200,1,9,54,19,350,35659350
17161,3301,1803300,3,9,54,22,651,35662651
17162,437,1803400,16,9,54,23,88,35663088
17163,532,1803300,1,9,54,23,620,35663620
17164,540,1803300,1,9,54,24,160,35664160
17165,146,1803300,1,9,54,24,306,35664306
17166,746,1803200,1,9,54,25,52,35665052
17167,1,1803300,1,9,54,25,53,35665053
17168,677,1803300,1,9,54,25,730,35665730
17169,1513,1803400,4,9,54,27,243,35667243
17170,1,1803400,1,9,54,27,244,35667244
17171,1756,1803300,1,9,54,29,0,35669000
17172,100,1803400,1,9,54,29,100,35669100
17173,1252,1803400,1,9,54,30,352,35670352
17174,3245,1803400,1,9,54,33,597,35673597
17175,224,1803500,94,9,54,33,821,35673821
17176,0,1803500,4,9,54,33,821,35673821
17177,0,1803500,9,9,54,33,821,35673821
17178,1,1803500,1,9,54,33,822,35673822
17179,0,1803500,8,9,54,33,822,35673822
17180,1,1803600,3,9,54,33,823,35673823
17181,0,1803600,1,9,54,33,823,35673823
17182,63,1803600,1,9,54,33,886,35673886
17183,69,1803600,1,9,54,33,955,35673955
17184,27,1803600,1,9,54,33,982,35673982
17185,18,1803600,14,9,54,34,0,35674000
17186,13,1803700,1,9,54,34,13,35674013
17187,91,1803700,2,9,54,34,104,35674104
17188,45,1803700,1,9,54,34,149,35674149
17189,28,1803600,1,9,54,34,177,35674177
17190,0,1803700,10,9,54,34,177,35674177
17191,49,1803700,1,9,54,34,226,35674226
17192,70,1803700,1,9,54,34,296,35674296
17193,3,1803500,1,9,54,34,299,35674299
17194,81,1803700,2,9,54,34,380,35674380
17195,42,1803600,1,9,54,34,422,35674422
17196,538,1803600,1,9,54,34,960,35674960
17197,11,1803700,1,9,54,34,971,35674971
17198,652,1803600,1,9,54,35,623,35675623
17199,1,1803600,1,9,54,35,624,35675624
17200,1446,1803700,1,9,54,37,70,35677070
17201,73,1803700,3,9,54,37,143,35677143
17202,197,1803700,2,9,54,37,340,35677340
17203,151,1803700,1,9,54,37,491,35677491
17204,143,1803800,1,9,54,37,634,35677634
17205,110,1803800,1,9,54,37,744,35677744
17206,38,1803700,2,9,54,37,782,35677782
17207,3,1803800,2,9,54,37,785,35677785
17208,0,1803800,2,9,54,37,785,35677785
17209,2,1803800,2,9,54,37,787,35677787
17210,226,1803800,1,9,54,38,13,35678013
17211,281,1803800,1,9,54,38,294,35678294
17212,436,1803800,1,9,54,38,730,35678730
17213,161,1803800,1,9,54,38,891,35678891
17214,43,1803800,2,9,54,38,934,35678934
17215,36,1803800,1,9,54,38,970,35678970
17216,378,1803800,1,9,54,39,348,35679348
17217,15,1803700,1,9,54,39,363,35679363
17218,139,1803800,1,9,54,39,502,35679502
17219,9,1803800,1,9,54,39,511,35679511
17220,360,1803700,2,9,54,39,871,35679871
17221,340,1803600,1,9,54,40,211,35680211
17222,205,1803600,1,9,54,40,416,35680416
17223,152,1803600,1,9,54,40,568,35680568
17224,882,1803600,1,9,54,41,450,35681450
17225,1470,1803500,4,9,54,42,920,35682920
17226,20,1803500,1,9,54,42,940,35682940
17227,368,1803400,1,9,54,43,308,35683308
17228,393,1803600,5,9,54,43,701,35683701
17229,2679,1803500,1,9,54,46,380,35686380
17230,569,1803400,1,9,54,46,949,35686949
17231,180,1803300,4,9,54,47,129,35687129
17232,1,1803300,1,9,54,47,130,35687130
17233,95,1803400,1,9,54,47,225,35687225
17234,346,1803400,1,9,54,47,571,35687571
17235,768,1803300,1,9,54,48,339,35688339
17236,2563,1803400,1,9,54,50,902,35690902
17237,378,1803400,1,9,54,51,280,35691280
17238,569,1803300,2,9,54,51,849,35691849
17239,562,1803300,1,9,54,52,411,35692411
17240,541,1803400,2,9,54,52,952,35692952
17241,813,1803200,1,9,54,53,765,35693765
17242,121,1803200,1,9,54,53,886,35693886
17243,93,1803400,1,9,54,53,979,35693979
17244,1215,1803500,1,9,54,55,194,35695194
17245,2800,1803500,1,9,54,57,994,35697994
17246,387,1803500,5,9,54,58,381,35698381
17247,311,1803500,1,9,54,58,692,35698692
17248,395,1803500,1,9,54,59,87,35699087
17249,241,1803600,1,9,54,59,328,35699328
17250,177,1803600,1,9,54,59,505,35699505
17251,545,1803600,3,9,55,0,50,35700050
17252,0,1803700,3,9,55,0,50,35700050
17253,0,1803700,3,9,55,0,50,35700050
17254,1,1803600,2,9,55,0,51,35700051
17256,233,1803700,1,9,55,0,284,35700284
17257,107,1803700,6,9,55,0,391,35700391
17258,1,1803700,1,9,55,0,392,35700392
17259,5,1803700,1,9,55,0,397,35700397
17260,1,1803700,1,9,55,0,398,35700398
17261,26,1803700,1,9,55,0,424,35700424
17262,669,1803700,1,9,55,1,93,35701093
17263,289,1803700,1,9,55,1,382,35701382
17264,56,1803700,1,9,55,1,438,35701438
17265,32,1803700,1,9,55,1,470,35701470
17266,45,1803800,1,9,55,1,515,35701515
17267,56,1803800,1,9,55,1,571,35701571
17268,485,1803800,1,9,55,2,56,35702056
17269,0,1803800,1,9,55,2,56,35702056
17270,6,1803800,1,9,55,2,62,35702062
17271,76,1803700,3,9,55,2,138,35702138
17272,81,1803800,2,9,55,2,219,35702219
17273,18,1803600,1,9,55,2,237,35702237
17274,1200,1803700,1,9,55,3,437,35703437
17275,283,1803600,1,9,55,3,720,35703720
17276,19,1803800,1,9,55,3,739,35703739
17277,603,1803600,1,9,55,4,342,35704342
17278,2110,1803600,2,9,55,6,452,35706452
17279,704,1803700,1,9,55,7,156,35707156
17280,522,1803600,1,9,55,7,678,35707678
17281,413,1803600,2,9,55,8,91,35708091
17282,0,1803600,2,9,55,8,91,35708091
17283,1433,1803700,2,9,55,9,524,35709524
17284,795,1803700,1,9,55,10,319,35710319
17285,1077,1803700,4,9,55,11,396,35711396
17286,412,1803800,1,9,55,11,808,35711808
17287,166,1803800,1,9,55,11,974,35711974
17288,1285,1803800,1,9,55,13,259,35713259
17289,1383,1803800,7,9,55,14,642,35714642
17290,0,1803800,18,9,55,14,642,35714642
17291,681,1803800,2,9,55,15,323,35715323
17292,291,1803800,1,9,55,15,614,35715614
17293,1034,1803800,2,9,55,16,648,35716648
17294,77,1803800,1,9,55,16,725,35716725
17295,547,1803900,6,9,55,17,272,35717272
17296,17,1803900,2,9,55,17,289,35717289
17297,80,1803900,2,9,55,17,369,35717369
17298,1,1803900,2,9,55,17,370,35717370
17299,0,1803900,2,9,55,17,370,35717370
17300,1,1803900,2,9,55,17,371,35717371
17301,0,1803900,2,9,55,17,371,35717371
17302,0,1803900,4,9,55,17,371,35717371
17303,1,1803900,1,9,55,17,372,35717372
17304,0,1803900,1,9,55,17,372,35717372
17305,0,1803900,4,9,55,17,372,35717372
17306,0,1804000,2,9,55,17,372,35717372
17307,2,1804000,1,9,55,17,374,35717374
17308,1,1804000,1,9,55,17,375,35717375
17309,35,1804000,2,9,55,17,410,35717410
17310,7,1804000,4,9,55,17,417,35717417
17311,13,1804000,1,9,55,17,430,35717430
17312,5,1804000,2,9,55,17,435,35717435
17313,16,1804000,1,9,55,17,451,35717451
17314,0,1804000,1,9,55,17,451,35717451
17315,0,1804000,1,9,55,17,451,35717451
17316,1,1804000,7,9,55,17,452,35717452
17317,0,1804000,4,9,55,17,452,35717452
17318,1,1804000,1,9,55,17,453,35717453
17319,0,1804000,1,9,55,17,453,35717453
17320,0,1804000,1,9,55,17,453,35717453
17321,60,1804000,1,9,55,17,513,35717513
17322,1,1804000,2,9,55,17,514,35717514
17323,12,1804000,1,9,55,17,526,35717526
17324,0,1804000,1,9,55,17,526,35717526
17325,4,1804000,1,9,55,17,530,35717530
17326,8,1804000,4,9,55,17,538,35717538
17327,6,1804000,1,9,55,17,544,35717544
17328,1,1804000,1,9,55,17,545,35717545
17329,1,1804000,1,9,55,17,546,35717546
17330,1,1804000,1,9,55,17,547,35717547
17331,18,1804000,1,9,55,17,565,35717565
17332,5,1804000,1,9,55,17,570,35717570
17333,26,1804100,1,9,55,17,596,35717596
17334,13,1804100,1,9,55,17,609,35717609
17335,1,1804100,1,9,55,17,610,35717610
17336,8,1804100,1,9,55,17,618,35717618
17337,0,1804100,1,9,55,17,618,35717618
17338,11,1804100,1,9,55,17,629,35717629
17339,5,1804100,1,9,55,17,634,35717634
17340,6,1804100,1,9,55,17,640,35717640
17341,7,1803900,1,9,55,17,647,35717647
17342,3,1804100,1,9,55,17,650,35717650
17343,9,1804100,2,9,55,17,659,35717659
17344,10,1804100,1,9,55,17,669,35717669
17345,41,1804100,1,9,55,17,710,35717710
17346,22,1804100,2,9,55,17,732,35717732
17347,2,1804100,1,9,55,17,734,35717734
17348,45,1804000,1,9,55,17,779,35717779
17350,3,1804000,1,9,55,17,782,35717782
17351,35,1803900,2,9,55,17,817,35717817
17352,12,1804000,1,9,55,17,829,35717829
17353,2,1804000,1,9,55,17,831,35717831
17354,22,1804000,1,9,55,17,853,35717853
17355,47,1804000,1,9,55,17,900,35717900
17356,110,1804000,1,9,55,18,10,35718010
17357,31,1803900,1,9,55,18,41,35718041
17358,21,1804000,1,9,55,18,62,35718062
17359,64,1804000,1,9,55,18,126,35718126
17360,106,1804000,1,9,55,18,232,35718232
17361,11,1804000,1,9,55,18,243,35718243
17362,75,1804000,2,9,55,18,318,35718318
17363,1,1804000,1,9,55,18,319,35718319
17364,132,1803900,1,9,55,18,451,35718451
17365,96,1804000,1,9,55,18,547,35718547
17366,35,1804000,1,9,55,18,582,35718582
17368,16,1804000,1,9,55,18,598,35718598
17370,134,1804000,1,9,55,18,732,35718732
17371,885,1803900,5,9,55,19,617,35719617
17372,20,1804000,1,9,55,19,637,35719637
17373,206,1804000,1,9,55,19,843,35719843
17375,32,1804000,1,9,55,19,875,35719875
17376,4,1804000,1,9,55,19,879,35719879
17378,62,1804000,1,9,55,19,941,35719941
17379,346,1804000,1,9,55,20,287,35720287
17380,174,1803900,1,9,55,20,461,35720461
17381,7,1804000,1,9,55,20,468,35720468
17382,415,1804000,2,9,55,20,883,35720883
17383,173,1804000,2,9,55,21,56,35721056
17385,83,1803900,1,9,55,21,139,35721139
17386,210,1804000,1,9,55,21,349,35721349
17387,36,1804000,1,9,55,21,385,35721385
17388,26,1804100,1,9,55,21,411,35721411
17389,15,1804100,1,9,55,21,426,35721426
17390,3,1804100,1,9,55,21,429,35721429
17391,10,1804100,1,9,55,21,439,35721439
17392,17,1804100,1,9,55,21,456,35721456
17393,2,1804100,1,9,55,21,458,35721458
17394,506,1803900,1,9,55,21,964,35721964
17395,70,1803900,1,9,55,22,34,35722034
17396,0,1803900,2,9,55,22,34,35722034
17397,125,1803800,2,9,55,22,159,35722159
17398,86,1803900,1,9,55,22,245,35722245
17399,545,1804000,5,9,55,22,790,35722790
17400,526,1803800,1,9,55,23,316,35723316
17401,884,1804000,1,9,55,24,200,35724200
17402,375,1804000,1,9,55,24,575,35724575
17403,603,1804000,1,9,55,25,178,35725178
17404,666,1804000,4,9,55,25,844,35725844
17405,562,1804000,2,9,55,26,406,35726406
17406,402,1804000,1,9,55,26,808,35726808
17407,690,1803900,1,9,55,27,498,35727498
17408,0,1803800,1,9,55,27,498,35727498
17409,1046,1803900,1,9,55,28,544,35728544
17410,1070,1803900,1,9,55,29,614,35729614
17411,79,1803800,1,9,55,29,693,35729693
17412,454,1803900,2,9,55,30,147,35730147
17413,247,1804000,1,9,55,30,394,35730394
17414,180,1804000,12,9,55,30,574,35730574
17415,2040,1803900,1,9,55,32,614,35732614
17416,872,1803800,1,9,55,33,486,35733486
17417,109,1803700,4,9,55,33,595,35733595
17418,507,1803900,1,9,55,34,102,35734102
17419,354,1803900,1,9,55,34,456,35734456
17420,61,1803900,3,9,55,34,517,35734517
17421,579,1804000,2,9,55,35,96,35735096
17422,1548,1804000,3,9,55,36,644,35736644
17424,558,1804100,1,9,55,37,202,35737202
17425,128,1804100,1,9,55,37,330,35737330
17426,32,1804100,1,9,55,37,362,35737362
17427,60,1804100,1,9,55,37,422,35737422
17428,864,1804200,1,9,55,38,286,35738286
17429,83,1804200,6,9,55,38,369,35738369
17430,8,1804200,3,9,55,38,377,35738377
17431,48,1804200,8,9,55,38,425,35738425
17432,74,1804200,1,9,55,38,499,35738499
17433,8,1804200,1,9,55,38,507,35738507
17434,31,1804200,1,9,55,38,538,35738538
17435,0,1804100,1,9,55,38,538,35738538
17436,33,1804200,1,9,55,38,571,35738571
17437,8,1804200,1,9,55,38,579,35738579
17438,146,1804200,4,9,55,38,725,35738725
17439,53,1804200,1,9,55,38,778,35738778
17440,136,1804200,4,9,55,38,914,35738914
17441,967,1804100,2,9,55,39,881,35739881
17442,1,1804100,1,9,55,39,882,35739882
17443,160,1804200,1,9,55,40,42,35740042
17444,168,1804100,1,9,55,40,210,35740210
17445,203,1804200,6,9,55,40,413,35740413
17446,26,1804200,6,9,55,40,439,35740439
17447,71,1804200,1,9,55,40,510,35740510
17448,118,1804200,1,9,55,40,628,35740628
17449,342,1804100,7,9,55,40,970,35740970
17451,1,1804000,1,9,55,40,971,35740971
17452,0,1804000,1,9,55,40,971,35740971
17453,0,1804000,2,9,55,40,971,35740971
17454,1,1804000,4,9,55,40,972,35740972
17455,0,1804000,1,9,55,40,972,35740972
17456,0,1804000,17,9,55,40,972,35740972
17457,0,1804000,10,9,55,40,972,35740972
17458,55,1804100,1,9,55,41,27,35741027
17459,192,1804100,1,9,55,41,219,35741219
17460,480,1804000,1,9,55,41,699,35741699
17461,259,1804100,1,9,55,41,958,35741958
17462,385,1804100,1,9,55,42,343,35742343
17463,197,1804200,1,9,55,42,540,35742540
17464,65,1804000,1,9,55,42,605,35742605
17465,499,1804100,1,9,55,43,104,35743104
17466,554,1804200,2,9,55,43,658,35743658
17467,285,1804200,5,9,55,43,943,35743943
17468,512,1804200,3,9,55,44,455,35744455
17469,114,1804100,2,9,55,44,569,35744569
17470,62,1804200,1,9,55,44,631,35744631
17471,154,1804100,1,9,55,44,785,35744785
17472,35,1804100,1,9,55,44,820,35744820
17473,33,1804200,2,9,55,44,853,35744853
17474,14,1804100,1,9,55,44,867,35744867
17475,2117,1804200,1,9,55,46,984,35746984
17476,65,1804100,2,9,55,47,49,35747049
17477,0,1804100,2,9,55,47,49,35747049
17479,3,1803900,7,9,55,47,52,35747052
17480,0,1803900,1,9,55,47,52,35747052
17481,232,1803900,1,9,55,47,284,35747284
17482,21,1803900,1,9,55,47,305,35747305
17483,537,1803900,1,9,55,47,842,35747842
17484,540,1803900,12,9,55,48,382,35748382
17485,493,1804000,1,9,55,48,875,35748875
17486,1208,1804000,2,9,55,50,83,35750083
17487,370,1803900,1,9,55,50,453,35750453
17488,721,1804000,1,9,55,51,174,35751174
17489,1099,1803900,1,9,55,52,273,35752273
17490,1814,1804000,1,9,55,54,87,35754087
17491,1161,1803900,1,9,55,55,248,35755248
17492,672,1803900,1,9,55,55,920,35755920
17493,270,1804000,1,9,55,56,190,35756190
17494,1064,1803900,1,9,55,57,254,35757254
17495,289,1803900,1,9,55,57,543,35757543
17496,42,1804000,3,9,55,57,585,35757585
17497,1150,1803900,3,9,55,58,735,35758735
17498,215,1803900,3,9,55,58,950,35758950
17499,1,1803900,3,9,55,58,951,35758951
17500,605,1804000,2,9,55,59,556,35759556
17501,1165,1804000,1,9,56,0,721,35760721
17502,513,1803900,1,9,56,1,234,35761234
17503,116,1804100,1,9,56,1,350,35761350
17504,0,1804100,1,9,56,1,350,35761350
17505,1587,1803900,1,9,56,2,937,35762937
17507,304,1803900,1,9,56,3,241,35763241
17508,1213,1803800,16,9,56,4,454,35764454
17509,15,1803700,1,9,56,4,469,35764469
17510,0,1803700,3,9,56,4,469,35764469
17511,0,1803700,1,9,56,4,469,35764469
17512,0,1803700,1,9,56,4,469,35764469
17513,0,1803700,1,9,56,4,469,35764469
17514,0,1803700,1,9,56,4,469,35764469
17515,0,1803700,1,9,56,4,469,35764469
17516,0,1803700,1,9,56,4,469,35764469
17517,1,1803700,9,9,56,4,470,35764470
17518,804,1803800,3,9,56,5,274,35765274
17519,2,1803800,1,9,56,5,276,35765276
17520,588,1803800,2,9,56,5,864,35765864
17521,159,1803600,1,9,56,6,23,35766023
17522,248,1803600,1,9,56,6,271,35766271
17523,815,1803700,1,9,56,7,86,35767086
17524,702,1803800,1,9,56,7,788,35767788
17525,2151,1803700,2,9,56,9,939,35769939
17526,514,1803700,1,9,56,10,453,35770453
17527,109,1803700,1,9,56,10,562,35770562
17528,1280,1803700,1,9,56,11,842,35771842
17529,640,1803600,3,9,56,12,482,35772482
17530,32,1803600,5,9,56,12,514,35772514
17531,0,1803600,2,9,56,12,514,35772514
17532,25,1803500,5,9,56,12,539,35772539
17533,1,1803500,1,9,56,12,540,35772540
17534,0,1803500,1,9,56,12,540,35772540
17535,159,1803600,1,9,56,12,699,35772699
17536,147,1803600,1,9,56,12,846,35772846
17537,455,1803500,2,9,56,13,301,35773301
17538,70,1803600,1,9,56,13,371,35773371
17539,518,1803500,1,9,56,13,889,35773889
17540,1077,1803600,1,9,56,14,966,35774966
17541,251,1803500,1,9,56,15,217,35775217
17542,406,1803500,2,9,56,15,623,35775623
17543,502,1803500,2,9,56,16,125,35776125
17544,70,1803500,1,9,56,16,195,35776195
17545,349,1803400,1,9,56,16,544,35776544
17546,1085,1803400,1,9,56,17,629,35777629
17547,1545,1803400,10,9,56,19,174,35779174
17548,112,1803400,2,9,56,19,286,35779286
17549,921,1803500,1,9,56,20,207,35780207
17550,169,1803400,1,9,56,20,376,35780376
17551,55,1803300,12,9,56,20,431,35780431
17552,86,1803400,2,9,56,20,517,35780517
17553,98,1803300,4,9,56,20,615,35780615
17554,67,1803300,1,9,56,20,682,35780682
17555,315,1803200,2,9,56,20,997,35780997
17556,156,1803200,5,9,56,21,153,35781153
17557,56,1803200,1,9,56,21,209,35781209
17558,30,1803200,1,9,56,21,239,35781239
17559,284,1803400,1,9,56,21,523,35781523
17560,503,1803300,3,9,56,22,26,35782026
17561,0,1803300,1,9,56,22,26,35782026
17562,23,1803400,1,9,56,22,49,35782049
17563,1177,1803300,4,9,56,23,226,35783226
17565,296,1803400,1,9,56,23,522,35783522
17566,144,1803400,3,9,56,23,666,35783666
17567,0,1803400,3,9,56,23,666,35783666
17569,3,1803500,1,9,56,23,669,35783669
17570,3,1803500,1,9,56,23,672,35783672
17571,366,1803400,1,9,56,24,38,35784038
17572,148,1803400,1,9,56,24,186,35784186
17573,42,1803500,1,9,56,24,228,35784228
17574,2229,1803500,1,9,56,26,457,35786457
17575,778,1803500,1,9,56,27,235,35787235
17576,2256,1803500,1,9,56,29,491,35789491
17577,1601,1803400,7,9,56,31,92,35791092
17578,1854,1803300,4,9,56,32,946,35792946
17579,224,1803300,1,9,56,33,170,35793170
17581,860,1803200,1,9,56,34,30,35794030
17582,1,1803200,6,9,56,34,31,35794031
17583,45,1803200,4,9,56,34,76,35794076
17584,75,1803200,2,9,56,34,151,35794151
17585,322,1803200,1,9,56,34,473,35794473
17586,60,1803200,1,9,56,34,533,35794533
17587,661,1803200,1,9,56,35,194,35795194
17588,1732,1803300,2,9,56,36,926,35796926
17589,547,1803200,5,9,56,37,473,35797473
17590,422,1803100,1,9,56,37,895,35797895
17591,266,1803300,1,9,56,38,161,35798161
17592,358,1803100,1,9,56,38,519,35798519
17593,682,1803200,1,9,56,39,201,35799201
17594,173,1803300,1,9,56,39,374,35799374
17595,190,1803100,1,9,56,39,564,35799564
17596,63,1803200,4,9,56,39,627,35799627
17598,2,1803200,2,9,56,39,629,35799629
17599,822,1803200,1,9,56,40,451,35800451
17600,654,1803200,1,9,56,41,105,35801105
17601,299,1803200,1,9,56,41,404,35801404
17602,271,1803200,2,9,56,41,675,35801675
17603,761,1803100,3,9,56,42,436,35802436
17604,2354,1803200,1,9,56,44,790,35804790
17605,657,1803200,1,9,56,45,447,35805447
17606,149,1803100,1,9,56,45,596,35805596
17607,21,1803200,1,9,56,45,617,35805617
17608,0,1803200,1,9,56,45,617,35805617
17609,0,1803200,1,9,56,45,617,35805617
17611,8,1803300,2,9,56,45,625,35805625
17612,102,1803400,1,9,56,45,727,35805727
17613,463,1803200,1,9,56,46,190,35806190
17614,1,1803200,1,9,56,46,191,35806191
17615,266,1803300,1,9,56,46,457,35806457
17616,202,1803300,1,9,56,46,659,35806659
17617,411,1803200,3,9,56,47,70,35807070
17618,621,1803300,1,9,56,47,691,35807691
17619,0,1803300,1,9,56,47,691,35807691
17621,1298,1803400,3,9,56,48,989,35808989
17623,1536,1803300,2,9,56,50,525,35810525
17624,730,1803200,2,9,56,51,255,35811255
17625,941,1803300,3,9,56,52,196,35812196
17626,0,1803300,3,9,56,52,196,35812196
17628,1356,1803400,1,9,56,53,552,35813552
17629,725,1803400,1,9,56,54,277,35814277
17630,2,1803400,14,9,56,54,279,35814279
17631,869,1803200,1,9,56,55,148,35815148
17632,0,1803200,8,9,56,55,148,35815148
17633,681,1803200,1,9,56,55,829,35815829
17634,129,1803100,1,9,56,55,958,35815958
17635,51,1803200,1,9,56,56,9,35816009
17636,129,1803300,1,9,56,56,138,35816138
17637,4492,1803200,1,9,57,0,630,35820630
17638,173,1803200,1,9,57,0,803,35820803
17639,119,1803200,2,9,57,0,922,35820922
17640,1087,1803300,2,9,57,2,9,35822009
17641,0,1803300,2,9,57,2,9,35822009
17642,0,1803300,2,9,57,2,9,35822009
17644,3,1803400,4,9,57,2,12,35822012
17646,12,1803500,2,9,57,2,24,35822024
17647,93,1803500,1,9,57,2,117,35822117
17648,271,1803500,2,9,57,2,388,35822388
17649,0,1803500,1,9,57,2,388,35822388
17650,1,1803500,4,9,57,2,389,35822389
17651,83,1803400,2,9,57,2,472,35822472
17652,105,1803400,10,9,57,2,577,35822577
17653,57,1803400,1,9,57,2,634,35822634
17654,1034,1803300,1,9,57,3,668,35823668
17655,1794,1803300,1,9,57,5,462,35825462
17656,1929,1803300,1,9,57,7,391,35827391
17657,163,1803400,2,9,57,7,554,35827554
17658,2765,1803300,5,9,57,10,319,35830319
17659,250,1803200,17,9,57,10,569,35830569
17660,4,1803100,8,9,57,10,573,35830573
17661,1126,1803200,1,9,57,11,699,35831699
17662,661,1803200,2,9,57,12,360,35832360
17663,1507,1803300,1,9,57,13,867,35833867
17664,1577,1803200,3,9,57,15,444,35835444
17665,596,1803100,2,9,57,16,40,35836040
17666,297,1803200,1,9,57,16,337,35836337
17667,1458,1803100,1,9,57,17,795,35837795
17668,1245,1803100,5,9,57,19,40,35839040
17669,730,1803000,2,9,57,19,770,35839770
17670,355,1803000,1,9,57,20,125,35840125
17671,741,1803000,2,9,57,20,866,35840866
17672,629,1803100,1,9,57,21,495,35841495
17673,2413,1803100,5,9,57,23,908,35843908
17674,550,1803200,1,9,57,24,458,35844458
17675,737,1803100,1,9,57,25,195,35845195
17676,773,1803200,4,9,57,25,968,35845968
17677,170,1803200,1,9,57,26,138,35846138
17678,656,1803300,1,9,57,26,794,35846794
17679,1,1803300,2,9,57,26,795,35846795
17680,0,1803300,4,9,57,26,795,35846795
17681,0,1803300,2,9,57,26,795,35846795
17682,0,1803300,1,9,57,26,795,35846795
17683,0,1803300,1,9,57,26,795,35846795
17684,0,1803300,3,9,57,26,795,35846795
17685,2775,1803400,1,9,57,29,570,35849570
17686,1559,1803300,1,9,57,31,129,35851129
17687,2613,1803400,1,9,57,33,742,35853742
17688,2670,1803400,4,9,57,36,412,35856412
17689,92,1803400,2,9,57,36,504,35856504
17690,501,1803300,1,9,57,37,5,35857005
17691,5711,1803300,1,9,57,42,716,35862716
17692,1664,1803300,1,9,57,44,380,35864380
17693,2382,1803300,1,9,57,46,762,35866762
17694,2522,1803300,1,9,57,49,284,35869284
17695,363,1803300,1,9,57,49,647,35869647
17696,599,1803300,1,9,57,50,246,35870246
17697,1,1803300,1,9,57,50,247,35870247
17698,666,1803400,3,9,57,50,913,35870913
17699,353,1803300,1,9,57,51,266,35871266
17700,1543,1803400,3,9,57,52,809,35872809
17701,343,1803300,1,9,57,53,152,35873152
17702,977,1803300,2,9,57,54,129,35874129
17703,576,1803400,1,9,57,54,705,35874705
17704,472,1803500,5,9,57,55,177,35875177
17705,0,1803500,1,9,57,55,177,35875177
17706,164,1803500,1,9,57,55,341,35875341
17707,44,1803500,1,9,57,55,385,35875385
17708,848,1803600,5,9,57,56,233,35876233
17709,0,1803600,4,9,57,56,233,35876233
17710,34,1803500,1,9,57,56,267,35876267
17711,531,1803500,1,9,57,56,798,35876798
17712,280,1803500,1,9,57,57,78,35877078
17713,1026,1803600,1,9,57,58,104,35878104
17714,2235,1803500,1,9,58,0,339,35880339
17715,79,1803500,1,9,58,0,418,35880418
17716,2533,1803500,1,9,58,2,951,35882951
17717,329,1803500,2,9,58,3,280,35883280
17718,0,1803500,1,9,58,3,280,35883280
17719,248,1803500,1,9,58,3,528,35883528
17720,11,1803500,2,9,58,3,539,35883539
17721,2242,1803600,1,9,58,5,781,35885781
17722,3337,1803400,1,9,58,9,118,35889118
17723,0,1803400,1,9,58,9,118,35889118
17724,1,1803400,1,9,58,9,119,35889119
17725,256,1803300,1,9,58,9,375,35889375
17726,0,1803300,2,9,58,9,375,35889375
17727,0,1803300,1,9,58,9,375,35889375
17728,0,1803300,1,9,58,9,375,35889375
17729,0,1803300,1,9,58,9,375,35889375
17730,1,1803300,1,9,58,9,376,35889376
17731,690,1803400,1,9,58,10,66,35890066
17732,2128,1803200,1,9,58,12,194,35892194
17733,150,1803400,1,9,58,12,344,35892344
17734,236,1803200,2,9,58,12,580,35892580
17736,166,1803300,1,9,58,12,746,35892746
17737,2058,1803400,3,9,58,14,804,35894804
17738,405,1803300,1,9,58,15,209,35895209
17739,1285,1803400,1,9,58,16,494,35896494
17740,5267,1803300,1,9,58,21,761,35901761
17741,935,1803200,1,9,58,22,696,35902696
17742,1430,1803200,1,9,58,24,126,35904126
17743,1291,1803200,1,9,58,25,417,35905417
17744,1846,1803200,1,9,58,27,263,35907263
17745,3551,1803200,1,9,58,30,814,35910814
17746,3539,1803200,5,9,58,34,353,35914353
17747,75,1803200,1,9,58,34,428,35914428
17748,1380,1803200,1,9,58,35,808,35915808
17749,120,1803200,1,9,58,35,928,35915928
17750,470,1803200,1,9,58,36,398,35916398
17751,154,1803200,1,9,58,36,552,35916552
17752,561,1803200,1,9,58,37,113,35917113
17753,189,1803200,1,9,58,37,302,35917302
17754,71,1803200,2,9,58,37,373,35917373
17755,1,1803300,1,9,58,37,374,35917374
17756,0,1803300,1,9,58,37,374,35917374
17757,0,1803300,1,9,58,37,374,35917374
17758,0,1803300,1,9,58,37,374,35917374
17759,0,1803300,1,9,58,37,374,35917374
17760,0,1803300,1,9,58,37,374,35917374
17761,0,1803300,8,9,58,37,374,35917374
17762,505,1803200,1,9,58,37,879,35917879
17763,2191,1803200,1,9,58,40,70,35920070
17764,304,1803100,1,9,58,40,374,35920374
17765,4939,1803200,1,9,58,45,313,35925313
17766,802,1803100,10,9,58,46,115,35926115
17767,7,1803100,1,9,58,46,122,35926122
17768,2250,1803200,3,9,58,48,372,35928372
17769,791,1803200,1,9,58,49,163,35929163
17770,556,1803200,1,9,58,49,719,35929719
17771,237,1803200,1,9,58,49,956,35929956
17772,2871,1803100,1,9,58,52,827,35932827
17773,328,1803100,1,9,58,53,155,35933155
17774,4096,1803000,2,9,58,57,251,35937251
17775,266,1803100,1,9,58,57,517,35937517
17776,1955,1803200,1,9,58,59,472,35939472
17777,965,1803100,1,9,59,0,437,35940437
17778,247,1803100,2,9,59,0,684,35940684
17780,98,1803200,4,9,59,0,782,35940782
17781,5493,1803100,1,9,59,6,275,35946275
17782,970,1803200,7,9,59,7,245,35947245
17783,1,1803200,1,9,59,7,246,35947246
17784,1,1803300,1,9,59,7,247,35947247
17785,0,1803300,1,9,59,7,247,35947247
17786,0,1803300,1,9,59,7,247,35947247
17787,1,1803300,4,9,59,7,248,35947248
17788,1217,1803300,1,9,59,8,465,35948465
17789,1522,1803400,8,9,59,9,987,35949987
17790,456,1803400,1,9,59,10,443,35950443
17791,1084,1803400,3,9,59,11,527,35951527
17792,888,1803500,1,9,59,12,415,35952415
17793,1995,1803400,2,9,59,14,410,35954410
17794,3759,1803500,1,9,59,18,169,35958169
17795,1485,1803400,3,9,59,19,654,35959654
17797,3,1803300,3,9,59,19,657,35959657
17798,100,1803300,1,9,59,19,757,35959757
17799,118,1803400,1,9,59,19,875,35959875
17800,1181,1803300,1,9,59,21,56,35961056
17801,1306,1803400,2,9,59,22,362,35962362
17803,1768,1803500,7,9,59,24,130,35964130
17804,2,1803600,6,9,59,24,132,35964132
17805,671,1803700,7,9,59,24,803,35964803
17806,493,1803600,1,9,59,25,296,35965296
17807,758,1803700,3,9,59,26,54,35966054
17808,1,1803700,4,9,59,26,55,35966055
17809,857,1803700,1,9,59,26,912,35966912
17810,639,1803600,1,9,59,27,551,35967551
17811,1586,1803700,1,9,59,29,137,35969137
17812,693,1803700,1,9,59,29,830,35969830
17813,1561,1803700,1,9,59,31,391,35971391
17814,486,1803700,1,9,59,31,877,35971877
17815,1852,1803600,1,9,59,33,729,35973729
17816,2457,1803700,4,9,59,36,186,35976186
17817,167,1803600,1,9,59,36,353,35976353
17818,339,1803700,1,9,59,36,692,35976692
17819,53,1803600,3,9,59,36,745,35976745
17820,76,1803600,1,9,59,36,821,35976821
17821,974,1803700,4,9,59,37,795,35977795
17822,377,1803800,7,9,59,38,172,35978172
17823,277,1803600,1,9,59,38,449,35978449
17824,211,1803800,2,9,59,38,660,35978660
17825,315,1803800,1,9,59,38,975,35978975
17826,1923,1803800,1,9,59,40,898,35980898
17827,293,1803700,1,9,59,41,191,35981191
17828,2815,1803700,4,9,59,44,6,35984006
17829,131,1803700,1,9,59,44,137,35984137
17830,129,1803800,1,9,59,44,266,35984266
17831,887,1803700,1,9,59,45,153,35985153
17832,1225,1803800,26,9,59,46,378,35986378
17833,2,1803900,17,9,59,46,380,35986380
17834,2,1804000,2,9,59,46,382,35986382
17835,270,1804000,1,9,59,46,652,35986652
17836,216,1803900,1,9,59,46,868,35986868
17837,451,1804000,5,9,59,47,319,35987319
17838,367,1803800,1,9,59,47,686,35987686
17839,345,1803900,7,9,59,48,31,35988031
17840,0,1803900,7,9,59,48,31,35988031
17842,608,1804100,1,9,59,48,639,35988639
17843,311,1804100,2,9,59,48,950,35988950
17844,411,1804100,8,9,59,49,361,35989361
17845,0,1804100,8,9,59,49,361,35989361
17847,4,1804300,1,9,59,49,365,35989365
17848,1,1804300,1,9,59,49,366,35989366
17849,0,1804300,1,9,59,49,366,35989366
17850,2,1804300,2,9,59,49,368,35989368
17851,5,1804300,2,9,59,49,373,35989373
17852,0,1804300,1,9,59,49,373,35989373
17853,11,1804300,5,9,59,49,384,35989384
17854,104,1804300,1,9,59,49,488,35989488
17855,1,1804300,2,9,59,49,489,35989489
17857,8,1804300,1,9,59,49,497,35989497
17858,13,1804300,1,9,59,49,510,35989510
17859,0,1804400,3,9,59,49,510,35989510
17860,31,1804300,2,9,59,49,541,35989541
17861,8,1804400,1,9,59,49,549,35989549
17862,4,1804400,1,9,59,49,553,35989553
17863,7,1804200,2,9,59,49,560,35989560
17864,24,1804400,1,9,59,49,584,35989584
17865,82,1804400,2,9,59,49,666,35989666
17866,3,1804400,2,9,59,49,669,35989669
17867,2,1804400,4,9,59,49,671,35989671
17868,8,1804400,3,9,59,49,679,35989679
17869,3,1804400,1,9,59,49,682,35989682
17870,10,1804400,1,9,59,49,692,35989692
17871,16,1804400,2,9,59,49,708,35989708
17872,16,1804400,1,9,59,49,724,35989724
17873,34,1804400,4,9,59,49,758,35989758
17874,22,1804400,2,9,59,49,780,35989780
17875,86,1804300,1,9,59,49,866,35989866
17876,21,1804400,1,9,59,49,887,35989887
17877,165,1804400,1,9,59,50,52,35990052
17878,79,1804400,1,9,59,50,131,35990131
17879,135,1804400,2,9,59,50,266,35990266
17880,21,1804400,2,9,59,50,287,35990287
17881,633,1804400,1,9,59,50,920,35990920
17882,195,1804400,1,9,59,51,115,35991115
17883,111,1804400,1,9,59,51,226,35991226
17884,527,1804300,1,9,59,51,753,35991753
17885,235,1804300,2,9,59,51,988,35991988
17886,18,1804400,1,9,59,52,6,35992006
17887,48,1804400,9,9,59,52,54,35992054
17888,11,1804400,1,9,59,52,65,35992065
17889,338,1804300,1,9,59,52,403,35992403
17890,25,1804200,4,9,59,52,428,35992428
17891,140,1804200,1,9,59,52,568,35992568
17892,20,1804300,1,9,59,52,588,35992588
17893,290,1804400,1,9,59,52,878,35992878
17894,123,1804400,2,9,59,53,1,35993001
17895,166,1804400,1,9,59,53,167,35993167
17896,774,1804400,2,9,59,53,941,35993941
17897,0,1804400,2,9,59,53,941,35993941
17898,0,1804400,1,9,59,53,941,35993941
17899,0,1804400,2,9,59,53,941,35993941
17900,0,1804400,14,9,59,53,941,35993941
17901,1,1804400,3,9,59,53,942,35993942
17902,1,1804400,1,9,59,53,943,35993943
17903,0,1804400,4,9,59,53,943,35993943
17904,93,1804400,3,9,59,54,36,35994036
17905,636,1804300,2,9,59,54,672,35994672
17906,1398,1804300,1,9,59,56,70,35996070
17907,531,1804300,1,9,59,56,601,35996601
17908,126,1804300,1,9,59,56,727,35996727
17909,381,1804400,1,9,59,57,108,35997108
17910,408,1804400,2,9,59,57,516,35997516
17911,136,1804400,10,9,59,57,652,35997652
17912,1252,1804400,1,9,59,58,904,35998904
17913,386,1804400,10,9,59,59,290,35999290
17914,1,1804400,1,9,59,59,291,35999291
17915,578,1804400,1,9,59,59,869,35999869
17916,82,1804500,1,9,59,59,951,35999951
17917,40,1804300,1,9,59,59,991,35999991
17918,12,1804500,3,10,0,0,3,36000003
17919,2,1804500,1,10,0,0,5,36000005
17920,45,1804500,1,10,0,0,50,36000050
17921,4,1804500,2,10,0,0,54,36000054
17922,6,1804500,1,10,0,0,60,36000060
17923,53,1804500,2,10,0,0,113,36000113
17924,0,1804500,1,10,0,0,113,36000113
17925,0,1804500,1,10,0,0,113,36000113
17926,0,1804500,2,10,0,0,113,36000113
17927,0,1804500,5,10,0,0,113,36000113
17928,0,1804500,1,10,0,0,113,36000113
17929,1,1804500,1,10,0,0,114,36000114
17930,0,1804500,1,10,0,0,114,36000114
17931,0,1804500,1,10,0,0,114,36000114
17932,0,1804500,1,10,0,0,114,36000114
17933,28,1804500,1,10,0,0,142,36000142
17934,24,1804500,4,10,0,0,166,36000166
17935,41,1804500,1,10,0,0,207,36000207
17936,10,1804300,1,10,0,0,217,36000217
17937,28,1804500,1,10,0,0,245,36000245
17938,6,1804500,2,10,0,0,251,36000251
17939,77,1804500,1,10,0,0,328,36000328
17940,0,1804400,1,10,0,0,328,36000328
17941,58,1804500,2,10,0,0,386,36000386
17942,24,1804500,1,10,0,0,410,36000410
17943,4,1804500,1,10,0,0,414,36000414
17944,13,1804500,1,10,0,0,427,36000427
17945,36,1804500,1,10,0,0,463,36000463
17946,6,1804500,1,10,0,0,469,36000469
17947,20,1804500,4,10,0,0,489,36000489
17948,3,1804500,2,10,0,0,492,36000492
17949,109,1804500,1,10,0,0,601,36000601
17950,1,1804500,1,10,0,0,602,36000602
17951,79,1804500,2,10,0,0,681,36000681
17952,135,1804500,5,10,0,0,816,36000816
17953,24,1804500,1,10,0,0,840,36000840
17954,1,1804400,2,10,0,0,841,36000841
17955,27,1804300,2,10,0,0,868,36000868
17956,48,1804300,4,10,0,0,916,36000916
17957,1,1804300,23,10,0,0,917,36000917
17958,28,1804200,1,10,0,0,945,36000945
17959,57,1804200,3,10,0,1,2,36001002
17960,93,1804300,1,10,0,1,95,36001095
17961,5,1804300,1,10,0,1,100,36001100
17962,1,1804300,1,10,0,1,101,36001101
17963,0,1804300,1,10,0,1,101,36001101
17964,0,1804300,1,10,0,1,101,36001101
17965,0,1804300,1,10,0,1,101,36001101
17966,0,1804400,1,10,0,1,101,36001101
17967,80,1804300,1,10,0,1,181,36001181
17968,1,1804300,1,10,0,1,182,36001182
17969,0,1804300,1,10,0,1,182,36001182
17970,1,1804300,1,10,0,1,183,36001183
17971,31,1804300,1,10,0,1,214,36001214
17972,96,1804300,1,10,0,1,310,36001310
17973,4,1804300,1,10,0,1,314,36001314
17974,79,1804300,1,10,0,1,393,36001393
17975,96,1804400,1,10,0,1,489,36001489
17976,19,1804400,1,10,0,1,508,36001508
17977,46,1804400,1,10,0,1,554,36001554
17978,87,1804400,1,10,0,1,641,36001641
17979,34,1804400,1,10,0,1,675,36001675
17980,106,1804300,3,10,0,1,781,36001781
17982,82,1804200,1,10,0,1,863,36001863
17983,11,1804400,1,10,0,1,874,36001874
17984,12,1804400,1,10,0,1,886,36001886
17985,13,1804400,1,10,0,1,899,36001899
17986,10,1804400,2,10,0,1,909,36001909
17987,32,1804400,1,10,0,1,941,36001941
17988,22,1804400,1,10,0,1,963,36001963
17989,18,1804400,1,10,0,1,981,36001981
17990,16,1804400,4,10,0,1,997,36001997
17991,4,1804400,4,10,0,2,1,36002001
17992,1,1804400,1,10,0,2,2,36002002
17993,8,1804500,2,10,0,2,10,36002010
17994,52,1804300,1,10,0,2,62,36002062
17995,76,1804400,1,10,0,2,138,36002138
17996,121,1804400,1,10,0,2,259,36002259
17997,112,1804300,1,10,0,2,371,36002371
17998,89,1804300,1,10,0,2,460,36002460
17999,188,1804400,1,10,0,2,648,36002648
18000,87,1804200,1,10,0,2,735,36002735
18001,52,1804400,1,10,0,2,787,36002787
18002,125,1804300,1,10,0,2,912,36002912
18003,187,1804300,1,10,0,3,99,36003099
18004,105,1804200,1,10,0,3,204,36003204
18005,447,1804300,1,10,0,3,651,36003651
18006,92,1804300,4,10,0,3,743,36003743
18007,166,1804200,1,10,0,3,909,36003909
18008,0,1804200,1,10,0,3,909,36003909
18009,1,1804200,5,10,0,3,910,36003910
18010,453,1804100,2,10,0,4,363,36004363
18011,363,1804200,2,10,0,4,726,36004726
18012,166,1804200,9,10,0,4,892,36004892
18014,237,1804200,2,10,0,5,129,36005129
18015,370,1804200,10,10,0,5,499,36005499
18016,143,1804200,1,10,0,5,642,36005642
18017,178,1804000,1,10,0,5,820,36005820
18018,51,1804200,1,10,0,5,871,36005871
18019,15,1804200,1,10,0,5,886,36005886
18020,326,1804200,4,10,0,6,212,36006212
18021,511,1804000,1,10,0,6,723,36006723
18022,105,1804000,4,10,0,6,828,36006828
18023,988,1804100,1,10,0,7,816,36007816
18025,34,1804200,1,10,0,7,850,36007850
18026,0,1804200,1,10,0,7,850,36007850
18027,0,1804200,1,10,0,7,850,36007850
18028,1,1804200,1,10,0,7,851,36007851
18029,0,1804200,1,10,0,7,851,36007851
18030,738,1804100,1,10,0,8,589,36008589
18031,1205,1804100,1,10,0,9,794,36009794
18032,917,1804000,1,10,0,10,711,36010711
18033,89,1804000,4,10,0,10,800,36010800
18034,736,1804100,1,10,0,11,536,36011536
18035,14,1804200,1,10,0,11,550,36011550
18036,548,1804100,1,10,0,12,98,36012098
18037,288,1804000,1,10,0,12,386,36012386
18038,0,1804000,1,10,0,12,386,36012386
18039,270,1804100,1,10,0,12,656,36012656
18040,479,1804000,1,10,0,13,135,36013135
18041,960,1804000,2,10,0,14,95,36014095
18042,138,1804000,2,10,0,14,233,36014233
18043,69,1804000,1,10,0,14,302,36014302
18044,1389,1803900,1,10,0,15,691,36015691
18045,1,1803900,3,10,0,15,692,36015692
18046,0,1803900,1,10,0,15,692,36015692
18047,0,1803900,1,10,0,15,692,36015692
18048,163,1803800,1,10,0,15,855,36015855
18049,104,1803800,1,10,0,15,959,36015959
18050,117,1803800,1,10,0,16,76,36016076
18051,41,1803700,2,10,0,16,117,36016117
18052,0,1803700,1,10,0,16,117,36016117
18053,0,1803700,2,10,0,16,117,36016117
18054,1297,1803800,1,10,0,17,414,36017414
18055,62,1803800,1,10,0,17,476,36017476
18056,0,1803800,1,10,0,17,476,36017476
18057,1,1803800,1,10,0,17,477,36017477
18058,1552,1803700,1,10,0,19,29,36019029
18059,3484,1803700,1,10,0,22,513,36022513
18060,2432,1803700,1,10,0,24,945,36024945
18061,916,1803700,1,10,0,25,861,36025861
18062,60,1803600,1,10,0,25,921,36025921
18063,100,1803700,1,10,0,26,21,36026021
18064,224,1803600,1,10,0,26,245,36026245
18065,81,1803600,1,10,0,26,326,36026326
18066,40,1803700,1,10,0,26,366,36026366
18067,375,1803600,1,10,0,26,741,36026741
18068,770,1803700,2,10,0,27,511,36027511
18069,89,1803700,1,10,0,27,600,36027600
18070,0,1803700,1,10,0,27,600,36027600
18071,0,1803700,1,10,0,27,600,36027600
18072,0,1803700,1,10,0,27,600,36027600
18073,0,1803700,1,10,0,27,600,36027600
18074,1,1803700,2,10,0,27,601,36027601
18075,514,1803600,1,10,0,28,115,36028115
18076,1992,1803600,1,10,0,30,107,36030107
18077,167,1803700,1,10,0,30,274,36030274
18078,260,1803700,10,10,0,30,534,36030534
18079,0,1803700,1,10,0,30,534,36030534
18080,0,1803700,6,10,0,30,534,36030534
18081,1651,1803700,1,10,0,32,185,36032185
18082,5106,1803700,1,10,0,37,291,36037291
18083,1301,1803700,1,10,0,38,592,36038592
18084,567,1803700,1,10,0,39,159,36039159
18085,462,1803700,1,10,0,39,621,36039621
18086,186,1803700,9,10,0,39,807,36039807
18087,112,1803600,1,10,0,39,919,36039919
18088,0,1803600,1,10,0,39,919,36039919
18089,0,1803600,2,10,0,39,919,36039919
18090,0,1803600,6,10,0,39,919,36039919
18091,0,1803600,1,10,0,39,919,36039919
18092,0,1803600,1,10,0,39,919,36039919
18093,0,1803600,2,10,0,39,919,36039919
18094,1,1803600,2,10,0,39,920,36039920
18095,1363,1803600,1,10,0,41,283,36041283
18096,1715,1803600,1,10,0,42,998,36042998
18097,1128,1803600,1,10,0,44,126,36044126
18098,708,1803500,1,10,0,44,834,36044834
18099,18,1803500,2,10,0,44,852,36044852
18100,171,1803500,1,10,0,45,23,36045023
18101,1474,1803500,6,10,0,46,497,36046497
18102,337,1803600,1,10,0,46,834,36046834
18103,372,1803500,1,10,0,47,206,36047206
18104,73,1803600,1,10,0,47,279,36047279
18105,2337,1803600,1,10,0,49,616,36049616
18106,703,1803500,8,10,0,50,319,36050319
18107,0,1803500,4,10,0,50,319,36050319
18108,108,1803700,1,10,0,50,427,36050427
18109,1573,1803600,1,10,0,52,0,36052000
18110,4789,1803600,1,10,0,56,789,36056789
18111,192,1803700,1,10,0,56,981,36056981
18112,1736,1803600,1,10,0,58,717,36058717
18113,1332,1803600,1,10,1,0,49,36060049
18114,180,1803700,1,10,1,0,229,36060229
18115,336,1803700,6,10,1,0,565,36060565
18116,2,1803700,1,10,1,0,567,36060567
18117,3,1803700,1,10,1,0,570,36060570
18119,142,1803800,3,10,1,0,712,36060712
18121,101,1803900,6,10,1,0,813,36060813
18122,53,1803900,1,10,1,0,866,36060866
18124,2,1804000,11,10,1,0,868,36060868
18126,128,1804100,2,10,1,0,996,36060996
18127,67,1804100,4,10,1,1,63,36061063
18129,5,1804000,1,10,1,1,68,36061068
18130,33,1804100,1,10,1,1,101,36061101
18131,17,1803900,1,10,1,1,118,36061118
18132,91,1804100,1,10,1,1,209,36061209
18133,34,1803900,2,10,1,1,243,36061243
18134,10,1804100,1,10,1,1,253,36061253
18135,129,1804100,3,10,1,1,382,36061382
18136,0,1804100,3,10,1,1,382,36061382
18138,2,1804100,3,10,1,1,384,36061384
18139,57,1804100,2,10,1,1,441,36061441
18140,5,1804200,1,10,1,1,446,36061446
18141,407,1804000,1,10,1,1,853,36061853
18142,77,1804000,6,10,1,1,930,36061930
18143,177,1804100,1,10,1,2,107,36062107
18144,818,1803900,1,10,1,2,925,36062925
18145,1481,1803900,1,10,1,4,406,36064406
18146,169,1803900,1,10,1,4,575,36064575
18147,454,1803900,1,10,1,5,29,36065029
18148,3928,1803900,1,10,1,8,957,36068957
18149,646,1803900,4,10,1,9,603,36069603
18150,122,1804000,1,10,1,9,725,36069725
18151,0,1804000,1,10,1,9,725,36069725
18152,0,1804000,1,10,1,9,725,36069725
18153,1,1804000,1,10,1,9,726,36069726
18154,1831,1803800,1,10,1,11,557,36071557
18155,150,1803800,1,10,1,11,707,36071707
18156,22,1803900,5,10,1,11,729,36071729
18157,1,1803900,5,10,1,11,730,36071730
18158,3230,1803900,2,10,1,14,960,36074960
18159,1294,1803800,1,10,1,16,254,36076254
18160,173,1803800,1,10,1,16,427,36076427
18161,622,1804000,1,10,1,17,49,36077049
18162,51,1804000,1,10,1,17,100,36077100
18163,0,1804000,1,10,1,17,100,36077100
18164,0,1804000,1,10,1,17,100,36077100
18165,1,1804100,1,10,1,17,101,36077101
18166,0,1804100,1,10,1,17,101,36077101
18167,0,1804100,1,10,1,17,101,36077101
18168,1,1804100,1,10,1,17,102,36077102
18169,3337,1804000,1,10,1,20,439,36080439
18170,1406,1803900,3,10,1,21,845,36081845
18171,1256,1803800,2,10,1,23,101,36083101
18172,2984,1804000,4,10,1,26,85,36086085
18173,0,1804000,2,10,1,26,85,36086085
18174,2,1804100,4,10,1,26,87,36086087
18175,1,1804200,4,10,1,26,88,36086088
18176,4,1804100,1,10,1,26,92,36086092
18177,2161,1804100,1,10,1,28,253,36088253
18178,0,1804100,2,10,1,28,253,36088253
18179,63,1804100,1,10,1,28,316,36088316
18180,34,1804200,1,10,1,28,350,36088350
18181,0,1804200,1,10,1,28,350,36088350
18182,0,1804200,1,10,1,28,350,36088350
18183,1,1804200,1,10,1,28,351,36088351
18184,1499,1804100,1,10,1,29,850,36089850
18185,5332,1804100,1,10,1,35,182,36095182
18186,370,1804200,10,10,1,35,552,36095552
18187,462,1804100,1,10,1,36,14,36096014
18188,227,1804100,1,10,1,36,241,36096241
18189,540,1804100,1,10,1,36,781,36096781
18190,175,1804100,1,10,1,36,956,36096956
18191,73,1804100,1,10,1,37,29,36097029
18192,427,1804100,4,10,1,37,456,36097456
18193,2490,1804000,1,10,1,39,946,36099946
18194,1,1804100,4,10,1,39,947,36099947
18196,1243,1804100,3,10,1,41,190,36101190
18197,0,1804100,1,10,1,41,190,36101190
18198,1,1804200,5,10,1,41,191,36101191
18199,785,1804200,1,10,1,41,976,36101976
18200,1,1804200,2,10,1,41,977,36101977
18201,880,1804300,1,10,1,42,857,36102857
18202,628,1804100,5,10,1,43,485,36103485
18203,783,1804100,1,10,1,44,268,36104268
18204,1036,1804000,1,10,1,45,304,36105304
18205,682,1804100,1,10,1,45,986,36105986
18206,4222,1804100,1,10,1,50,208,36110208
18207,1479,1804100,1,10,1,51,687,36111687
18208,839,1804000,2,10,1,52,526,36112526
18209,121,1804000,4,10,1,52,647,36112647
18210,1096,1804000,1,10,1,53,743,36113743
18211,2,1804000,3,10,1,53,745,36113745
18212,887,1803900,1,10,1,54,632,36114632
18213,182,1804000,1,10,1,54,814,36114814
18214,223,1804000,1,10,1,55,37,36115037
18215,894,1804000,6,10,1,55,931,36115931
18217,7404,1803900,1,10,2,3,335,36123335
18218,379,1804000,2,10,2,3,714,36123714
18219,2057,1804000,6,10,2,5,771,36125771
18220,1243,1803900,1,10,2,7,14,36127014
18221,319,1804000,1,10,2,7,333,36127333
18222,43,1804000,1,10,2,7,376,36127376
18223,160,1803800,1,10,2,7,536,36127536
18224,9050,1803900,1,10,2,16,586,36136586
18225,1037,1804000,5,10,2,17,623,36137623
18226,0,1804000,5,10,2,17,623,36137623
18228,4629,1804100,1,10,2,22,252,36142252
18229,1260,1804100,1,10,2,23,512,36143512
18230,1,1804100,1,10,2,23,513,36143513
18231,3685,1804200,31,10,2,27,198,36147198
18232,2,1804300,6,10,2,27,200,36147200
18233,1,1804200,1,10,2,27,201,36147201
18234,1435,1804300,1,10,2,28,636,36148636
18235,396,1804300,1,10,2,29,32,36149032
18236,515,1804300,1,10,2,29,547,36149547
18237,454,1804300,2,10,2,30,1,36150001
18238,1119,1804200,1,10,2,31,120,36151120
18239,431,1804300,1,10,2,31,551,36151551
18240,579,1804200,6,10,2,32,130,36152130
18241,1008,1804200,4,10,2,33,138,36153138
18242,306,1804100,1,10,2,33,444,36153444
18243,559,1804200,2,10,2,34,3,36154003
18244,132,1804200,1,10,2,34,135,36154135
18245,2149,1804200,1,10,2,36,284,36156284
18246,853,1804100,1,10,2,37,137,36157137
18247,165,1804100,1,10,2,37,302,36157302
18248,434,1804100,1,10,2,37,736,36157736
18249,190,1804100,1,10,2,37,926,36157926
18250,1,1804100,1,10,2,37,927,36157927
18251,534,1804000,1,10,2,38,461,36158461
18252,217,1804000,1,10,2,38,678,36158678
18253,817,1804200,10,10,2,39,495,36159495
18254,1848,1804200,1,10,2,41,343,36161343
18255,1215,1804100,1,10,2,42,558,36162558
18256,3681,1804200,7,10,2,46,239,36166239
18257,0,1804200,7,10,2,46,239,36166239
18258,0,1804200,7,10,2,46,239,36166239
18260,4,1804400,1,10,2,46,243,36166243
18262,0,1804400,1,10,2,46,243,36166243
18263,2,1804500,2,10,2,46,245,36166245
18264,1,1804400,1,10,2,46,246,36166246
18265,0,1804400,1,10,2,46,246,36166246
18266,0,1804400,1,10,2,46,246,36166246
18268,1,1804400,1,10,2,46,247,36166247
18270,4,1804400,1,10,2,46,251,36166251
18271,9,1804300,1,10,2,46,260,36166260
18272,10,1804300,1,10,2,46,270,36166270
18273,84,1804400,1,10,2,46,354,36166354
18274,96,1804400,2,10,2,46,450,36166450
18275,28,1804400,1,10,2,46,478,36166478
18276,0,1804400,2,10,2,46,478,36166478
18277,0,1804400,1,10,2,46,478,36166478
18278,0,1804400,1,10,2,46,478,36166478
18279,0,1804400,1,10,2,46,478,36166478
18280,31,1804400,4,10,2,46,509,36166509
18281,237,1804300,1,10,2,46,746,36166746
18282,53,1804400,1,10,2,46,799,36166799
18283,20,1804400,1,10,2,46,819,36166819
18284,133,1804400,5,10,2,46,952,36166952
18285,1082,1804400,5,10,2,48,34,36168034
18286,117,1804400,1,10,2,48,151,36168151
18287,121,1804400,1,10,2,48,272,36168272
18288,274,1804400,1,10,2,48,546,36168546
18289,22,1804400,1,10,2,48,568,36168568
18290,40,1804300,3,10,2,48,608,36168608
18291,44,1804400,1,10,2,48,652,36168652
18292,145,1804400,1,10,2,48,797,36168797
18293,143,1804400,1,10,2,48,940,36168940
18294,155,1804400,1,10,2,49,95,36169095
18295,161,1804400,1,10,2,49,256,36169256
18296,202,1804300,4,10,2,49,458,36169458
18297,1,1804300,2,10,2,49,459,36169459
18298,1788,1804400,1,10,2,51,247,36171247
18299,2625,1804300,1,10,2,53,872,36173872
18300,1117,1804300,1,10,2,54,989,36174989
18301,1648,1804400,1,10,2,56,637,36176637
18302,1069,1804400,1,10,2,57,706,36177706
18303,752,1804300,1,10,2,58,458,36178458
18304,117,1804300,1,10,2,58,575,36178575
18305,284,1804400,1,10,2,58,859,36178859
18306,28,1804300,1,10,2,58,887,36178887
18307,59,1804400,1,10,2,58,946,36178946
18308,442,1804400,5,10,2,59,388,36179388
18309,573,1804400,1,10,2,59,961,36179961
18310,19,1804300,1,10,2,59,980,36179980
18311,1597,1804400,6,10,3,1,577,36181577
18313,41,1804400,2,10,3,1,618,36181618
18314,80,1804400,2,10,3,1,698,36181698
18315,51,1804400,1,10,3,1,749,36181749
18316,0,1804500,2,10,3,1,749,36181749
18317,81,1804400,1,10,3,1,830,36181830
18318,111,1804400,1,10,3,1,941,36181941
18319,0,1804400,1,10,3,1,941,36181941
18320,3,1804400,1,10,3,1,944,36181944
18321,132,1804400,1,10,3,2,76,36182076
18322,638,1804300,5,10,3,2,714,36182714
18323,244,1804300,2,10,3,2,958,36182958
18324,461,1804300,1,10,3,3,419,36183419
18325,83,1804300,1,10,3,3,502,36183502
18326,589,1804300,2,10,3,4,91,36184091
18328,95,1804400,1,10,3,4,186,36184186
18329,70,1804400,1,10,3,4,256,36184256
18330,492,1804300,1,10,3,4,748,36184748
18331,28,1804400,5,10,3,4,776,36184776
18332,659,1804200,1,10,3,5,435,36185435
18333,80,1804400,1,10,3,5,515,36185515
18334,3,1804200,1,10,3,5,518,36185518
18335,1186,1804300,1,10,3,6,704,36186704
18336,58,1804300,1,10,3,6,762,36186762
18337,167,1804200,5,10,3,6,929,36186929
18338,41,1804300,1,10,3,6,970,36186970
18339,1086,1804200,1,10,3,8,56,36188056
18340,413,1804200,1,10,3,8,469,36188469
18341,1165,1804300,1,10,3,9,634,36189634
18342,159,1804200,1,10,3,9,793,36189793
18343,481,1804200,1,10,3,10,274,36190274
18344,4105,1804200,1,10,3,14,379,36194379
18345,138,1804100,1,10,3,14,517,36194517
18346,40,1804200,1,10,3,14,557,36194557
18347,81,1804100,2,10,3,14,638,36194638
18348,449,1804100,1,10,3,15,87,36195087
18349,1,1804100,1,10,3,15,88,36195088
18350,43,1804200,1,10,3,15,131,36195131
18351,354,1804200,1,10,3,15,485,36195485
18352,793,1804100,1,10,3,16,278,36196278
18353,1918,1804100,6,10,3,18,196,36198196
18354,2000,1804000,1,10,3,20,196,36200196
18355,1809,1804200,4,10,3,22,5,36202005
18356,1367,1804100,1,10,3,23,372,36203372
18357,219,1804200,1,10,3,23,591,36203591
18358,139,1804200,1,10,3,23,730,36203730
18359,4495,1804100,1,10,3,28,225,36208225
18360,1283,1804200,1,10,3,29,508,36209508
18361,1064,1804200,22,10,3,30,572,36210572
18362,3969,1804200,1,10,3,34,541,36214541
18363,1712,1804200,6,10,3,36,253,36216253
18365,1,1804300,1,10,3,36,254,36216254
18366,1,1804300,1,10,3,36,255,36216255
18367,0,1804300,1,10,3,36,255,36216255
18368,0,1804300,1,10,3,36,255,36216255
18369,30,1804200,1,10,3,36,285,36216285
18370,7,1804200,1,10,3,36,292,36216292
18371,0,1804200,4,10,3,36,292,36216292
18372,46,1804300,4,10,3,36,338,36216338
18373,19,1804300,1,10,3,36,357,36216357
18374,223,1804400,3,10,3,36,580,36216580
18375,0,1804400,2,10,3,36,580,36216580
18376,0,1804400,5,10,3,36,580,36216580
18377,0,1804400,1,10,3,36,580,36216580
18378,0,1804400,1,10,3,36,580,36216580
18379,444,1804500,14,10,3,37,24,36217024
18380,630,1804500,1,10,3,37,654,36217654
18381,238,1804500,1,10,3,37,892,36217892
18382,1069,1804500,1,10,3,38,961,36218961
18383,1016,1804500,1,10,3,39,977,36219977
18384,440,1804400,1,10,3,40,417,36220417
18385,1390,1804500,1,10,3,41,807,36221807
18386,441,1804400,1,10,3,42,248,36222248
18387,325,1804500,2,10,3,42,573,36222573
18388,166,1804400,1,10,3,42,739,36222739
18389,293,1804400,3,10,3,43,32,36223032
18390,394,1804400,1,10,3,43,426,36223426
18391,1399,1804500,5,10,3,44,825,36224825
18392,3190,1804500,3,10,3,48,15,36228015
18393,36,1804500,1,10,3,48,51,36228051
18394,694,1804500,2,10,3,48,745,36228745
18395,1,1804500,1,10,3,48,746,36228746
18396,0,1804500,2,10,3,48,746,36228746
18397,330,1804400,1,10,3,49,76,36229076
18398,1045,1804500,1,10,3,50,121,36230121
18399,724,1804400,4,10,3,50,845,36230845
18400,61,1804300,1,10,3,50,906,36230906
18401,542,1804500,1,10,3,51,448,36231448
18402,444,1804500,1,10,3,51,892,36231892
18403,9,1804500,1,10,3,51,901,36231901
18404,896,1804300,1,10,3,52,797,36232797
18405,779,1804400,1,10,3,53,576,36233576
18406,187,1804400,2,10,3,53,763,36233763
18407,53,1804400,1,10,3,53,816,36233816
18408,2465,1804400,1,10,3,56,281,36236281
18409,3847,1804400,6,10,4,0,128,36240128
18410,0,1804400,2,10,4,0,128,36240128
18411,508,1804400,1,10,4,0,636,36240636
18413,1111,1804500,2,10,4,1,747,36241747
18414,496,1804400,1,10,4,2,243,36242243
18415,85,1804500,2,10,4,2,328,36242328
18416,592,1804400,1,10,4,2,920,36242920
18417,6,1804300,1,10,4,2,926,36242926
18418,2996,1804300,1,10,4,5,922,36245922
18419,2,1804300,2,10,4,5,924,36245924
18420,1516,1804400,1,10,4,7,440,36247440
18421,144,1804300,1,10,4,7,584,36247584
18422,3862,1804200,4,10,4,11,446,36251446
18423,1,1804200,1,10,4,11,447,36251447
18424,1085,1804100,1,10,4,12,532,36252532
18425,1,1804100,5,10,4,12,533,36252533
18426,1458,1804100,1,10,4,13,991,36253991
18427,1222,1804100,1,10,4,15,213,36255213
18428,335,1804100,1,10,4,15,548,36255548
18429,243,1804100,1,10,4,15,791,36255791
18430,1436,1804100,1,10,4,17,227,36257227
18431,3611,1804100,1,10,4,20,838,36260838
18432,2102,1804100,1,10,4,22,940,36262940
18433,686,1804100,1,10,4,23,626,36263626
18434,262,1804100,1,10,4,23,888,36263888
18435,431,1804100,1,10,4,24,319,36264319
18436,1510,1804100,1,10,4,25,829,36265829
18437,442,1804100,1,10,4,26,271,36266271
18438,902,1804200,1,10,4,27,173,36267173
18439,1,1804200,1,10,4,27,174,36267174
18440,0,1804200,1,10,4,27,174,36267174
18441,0,1804200,2,10,4,27,174,36267174
18442,0,1804200,1,10,4,27,174,36267174
18443,0,1804200,1,10,4,27,174,36267174
18444,0,1804200,1,10,4,27,174,36267174
18445,420,1804200,1,10,4,27,594,36267594
18446,1703,1804100,2,10,4,29,297,36269297
18447,771,1804300,1,10,4,30,68,36270068
18448,739,1804100,1,10,4,30,807,36270807
18449,2407,1804200,1,10,4,33,214,36273214
18450,1006,1804100,1,10,4,34,220,36274220
18451,3558,1804100,1,10,4,37,778,36277778
18452,55,1804100,1,10,4,37,833,36277833
18453,2806,1804100,1,10,4,40,639,36280639
18454,1035,1804100,1,10,4,41,674,36281674
18455,1059,1804100,2,10,4,42,733,36282733
18456,169,1804100,1,10,4,42,902,36282902
18457,338,1804100,1,10,4,43,240,36283240
18459,773,1804100,1,10,4,44,13,36284013
18460,7334,1804100,3,10,4,51,347,36291347
18462,4716,1804200,1,10,4,56,63,36296063
18463,1,1804200,2,10,4,56,64,36296064
18464,316,1804200,1,10,4,56,380,36296380
18465,130,1804200,2,10,4,56,510,36296510
18466,843,1804200,1,10,4,57,353,36297353
18467,167,1804200,1,10,4,57,520,36297520
18468,1584,1804200,1,10,4,59,104,36299104
18469,319,1804200,1,10,4,59,423,36299423
18470,1687,1804300,17,10,5,1,110,36301110
18471,253,1804400,3,10,5,1,363,36301363
18472,1,1804400,2,10,5,1,364,36301364
18473,102,1804500,1,10,5,1,466,36301466
18474,16,1804500,1,10,5,1,482,36301482
18475,46,1804300,1,10,5,1,528,36301528
18476,5,1804500,1,10,5,1,533,36301533
18477,23,1804500,1,10,5,1,556,36301556
18478,29,1804500,2,10,5,1,585,36301585
18479,4,1804500,2,10,5,1,589,36301589
18480,21,1804500,1,10,5,1,610,36301610
18481,23,1804500,1,10,5,1,633,36301633
18482,218,1804500,1,10,5,1,851,36301851
18483,175,1804500,1,10,5,2,26,36302026
18484,26,1804400,2,10,5,2,52,36302052
18485,2,1804500,1,10,5,2,54,36302054
18486,100,1804500,1,10,5,2,154,36302154
18487,33,1804300,2,10,5,2,187,36302187
18488,128,1804500,1,10,5,2,315,36302315
18489,147,1804500,1,10,5,2,462,36302462
18490,25,1804400,1,10,5,2,487,36302487
18491,67,1804400,2,10,5,2,554,36302554
18492,40,1804500,2,10,5,2,594,36302594
18493,51,1804300,1,10,5,2,645,36302645
18494,100,1804500,5,10,5,2,745,36302745
18496,1,1804400,1,10,5,2,746,36302746
18497,127,1804500,1,10,5,2,873,36302873
18498,222,1804500,2,10,5,3,95,36303095
18499,120,1804500,2,10,5,3,215,36303215
18500,75,1804500,1,10,5,3,290,36303290
18501,80,1804500,2,10,5,3,370,36303370
18502,124,1804600,1,10,5,3,494,36303494
18503,1,1804400,3,10,5,3,495,36303495
18504,63,1804600,2,10,5,3,558,36303558
18505,86,1804600,5,10,5,3,644,36303644
18506,20,1804600,2,10,5,3,664,36303664
18507,53,1804600,1,10,5,3,717,36303717
18508,548,1804600,1,10,5,4,265,36304265
18509,21,1804600,2,10,5,4,286,36304286
18510,44,1804600,1,10,5,4,330,36304330
18511,17,1804600,2,10,5,4,347,36304347
18512,5,1804600,1,10,5,4,352,36304352
18513,122,1804600,2,10,5,4,474,36304474
18514,129,1804600,2,10,5,4,603,36304603
18515,1602,1804500,1,10,5,6,205,36306205
18516,0,1804600,3,10,5,6,205,36306205
18517,0,1804600,1,10,5,6,205,36306205
18518,139,1804600,1,10,5,6,344,36306344
18519,30,1804600,1,10,5,6,374,36306374
18520,585,1804600,1,10,5,6,959,36306959
18521,41,1804500,2,10,5,7,0,36307000
18522,22,1804600,1,10,5,7,22,36307022
18523,44,1804600,1,10,5,7,66,36307066
18524,4540,1804500,2,10,5,11,606,36311606
18525,173,1804500,1,10,5,11,779,36311779
18526,1,1804500,2,10,5,11,780,36311780
18527,739,1804500,1,10,5,12,519,36312519
18528,1536,1804500,1,10,5,14,55,36314055
18529,190,1804500,3,10,5,14,245,36314245
18530,86,1804500,2,10,5,14,331,36314331
18531,1190,1804500,1,10,5,15,521,36315521
18532,2993,1804500,2,10,5,18,514,36318514
18533,2252,1804500,1,10,5,20,766,36320766
18534,448,1804500,1,10,5,21,214,36321214
18535,3222,1804400,6,10,5,24,436,36324436
18536,372,1804300,2,10,5,24,808,36324808
18537,591,1804400,3,10,5,25,399,36325399
18539,2474,1804400,1,10,5,27,873,36327873
18540,1191,1804500,1,10,5,29,64,36329064
18541,421,1804400,1,10,5,29,485,36329485
18542,1915,1804500,1,10,5,31,400,36331400
18543,0,1804500,11,10,5,31,400,36331400
18544,328,1804400,1,10,5,31,728,36331728
18545,373,1804500,1,10,5,32,101,36332101
18546,518,1804600,2,10,5,32,619,36332619
18547,32,1804500,1,10,5,32,651,36332651
18548,289,1804500,6,10,5,32,940,36332940
18550,19,1804500,1,10,5,32,959,36332959
18551,391,1804500,1,10,5,33,350,36333350
18552,1472,1804500,1,10,5,34,822,36334822
18553,124,1804500,2,10,5,34,946,36334946
18554,661,1804500,1,10,5,35,607,36335607
18555,160,1804500,1,10,5,35,767,36335767
18556,1639,1804600,3,10,5,37,406,36337406
18557,128,1804600,4,10,5,37,534,36337534
18558,44,1804600,1,10,5,37,578,36337578
18559,152,1804500,1,10,5,37,730,36337730
18560,22,1804500,1,10,5,37,752,36337752
18561,93,1804500,1,10,5,37,845,36337845
18562,1583,1804600,1,10,5,39,428,36339428
18563,1150,1804600,1,10,5,40,578,36340578
18564,749,1804600,1,10,5,41,327,36341327
18565,858,1804600,1,10,5,42,185,36342185
18566,86,1804700,2,10,5,42,271,36342271
18567,48,1804700,1,10,5,42,319,36342319
18568,40,1804700,2,10,5,42,359,36342359
18569,22,1804700,1,10,5,42,381,36342381
18570,13,1804700,2,10,5,42,394,36342394
18571,269,1804700,2,10,5,42,663,36342663
18572,11,1804700,1,10,5,42,674,36342674
18573,28,1804700,1,10,5,42,702,36342702
18574,4,1804700,1,10,5,42,706,36342706
18575,56,1804700,5,10,5,42,762,36342762
18576,0,1804700,1,10,5,42,762,36342762
18577,535,1804700,18,10,5,43,297,36343297
18578,41,1804800,1,10,5,43,338,36343338
18579,54,1804700,1,10,5,43,392,36343392
18580,190,1804800,1,10,5,43,582,36343582
18581,279,1804800,1,10,5,43,861,36343861
18582,156,1804700,1,10,5,44,17,36344017
18583,395,1804700,1,10,5,44,412,36344412
18584,39,1804700,1,10,5,44,451,36344451
18585,782,1804700,2,10,5,45,233,36345233
18586,1,1804700,1,10,5,45,234,36345234
18587,26,1804700,1,10,5,45,260,36345260
18588,99,1804800,3,10,5,45,359,36345359
18589,323,1804700,2,10,5,45,682,36345682
18590,773,1804800,2,10,5,46,455,36346455
18591,648,1804700,1,10,5,47,103,36347103
18592,74,1804700,1,10,5,47,177,36347177
18593,896,1804800,1,10,5,48,73,36348073
18594,409,1804700,1,10,5,48,482,36348482
18595,15,1804600,7,10,5,48,497,36348497
18596,3,1804700,1,10,5,48,500,36348500
18597,110,1804700,1,10,5,48,610,36348610
18598,161,1804700,1,10,5,48,771,36348771
18599,3116,1804600,1,10,5,51,887,36351887
18600,216,1804600,1,10,5,52,103,36352103
18601,17,1804600,2,10,5,52,120,36352120
18602,242,1804700,1,10,5,52,362,36352362
18603,473,1804500,1,10,5,52,835,36352835
18604,1053,1804600,1,10,5,53,888,36353888
18605,429,1804700,4,10,5,54,317,36354317
18606,262,1804500,2,10,5,54,579,36354579
18607,147,1804500,1,10,5,54,726,36354726
18608,594,1804700,1,10,5,55,320,36355320
18609,718,1804600,1,10,5,56,38,36356038
18610,10,1804700,1,10,5,56,48,36356048
18611,0,1804700,5,10,5,56,48,36356048
18612,0,1804700,2,10,5,56,48,36356048
18613,0,1804700,4,10,5,56,48,36356048
18614,0,1804700,1,10,5,56,48,36356048
18615,950,1804800,1,10,5,56,998,36356998
18616,413,1804800,1,10,5,57,411,36357411
18617,1917,1804700,1,10,5,59,328,36359328
18618,39,1804700,1,10,5,59,367,36359367
18619,353,1804800,6,10,5,59,720,36359720
18620,777,1804800,1,10,6,0,497,36360497
18621,105,1804800,2,10,6,0,602,36360602
18622,0,1804800,1,10,6,0,602,36360602
18623,0,1804800,1,10,6,0,602,36360602
18624,0,1804800,1,10,6,0,602,36360602
18625,1,1804800,1,10,6,0,603,36360603
18626,0,1804800,1,10,6,0,603,36360603
18627,141,1804800,1,10,6,0,744,36360744
18628,10,1804800,2,10,6,0,754,36360754
18629,310,1804700,5,10,6,1,64,36361064
18630,152,1804700,1,10,6,1,216,36361216
18631,217,1804800,1,10,6,1,433,36361433
18632,15,1804800,1,10,6,1,448,36361448
18633,5,1804800,1,10,6,1,453,36361453
18634,23,1804800,1,10,6,1,476,36361476
18635,139,1804600,1,10,6,1,615,36361615
18636,194,1804800,2,10,6,1,809,36361809
18637,88,1804700,4,10,6,1,897,36361897
18638,130,1804700,1,10,6,2,27,36362027
18639,180,1804700,1,10,6,2,207,36362207
18640,501,1804800,1,10,6,2,708,36362708
18641,0,1804800,1,10,6,2,708,36362708
18642,0,1804800,1,10,6,2,708,36362708
18643,1,1804800,1,10,6,2,709,36362709
18644,610,1804800,1,10,6,3,319,36363319
18645,0,1804800,9,10,6,3,319,36363319
18646,0,1804800,2,10,6,3,319,36363319
18647,0,1804800,11,10,6,3,319,36363319
18648,1,1804800,1,10,6,3,320,36363320
18649,0,1804800,16,10,6,3,320,36363320
18650,347,1804900,1,10,6,3,667,36363667
18651,79,1804800,15,10,6,3,746,36363746
18652,35,1804900,1,10,6,3,781,36363781
18653,78,1804800,1,10,6,3,859,36363859
18654,57,1804900,5,10,6,3,916,36363916
18655,4,1804900,1,10,6,3,920,36363920
18656,113,1804900,1,10,6,4,33,36364033
18657,75,1804800,1,10,6,4,108,36364108
18658,37,1804900,1,10,6,4,145,36364145
18659,76,1804900,1,10,6,4,221,36364221
18660,350,1804900,1,10,6,4,571,36364571
18661,307,1804900,1,10,6,4,878,36364878
18662,150,1804900,32,10,6,5,28,36365028
18664,1,1805000,90,10,6,5,29,36365029
18665,0,1805000,83,10,6,5,29,36365029
18667,4,1805100,8,10,6,5,33,36365033
18668,0,1805100,2,10,6,5,33,36365033
18669,1,1805100,4,10,6,5,34,36365034
18670,0,1805200,1,10,6,5,34,36365034
18671,1,1805200,2,10,6,5,35,36365035
18672,1,1805200,1,10,6,5,36,36365036
18673,1,1805200,1,10,6,5,37,36365037
18674,0,1805200,36,10,6,5,37,36365037
18675,0,1805200,1,10,6,5,37,36365037
18676,0,1805100,2,10,6,5,37,36365037
18677,1,1805300,1,10,6,5,38,36365038
18678,2,1805300,7,10,6,5,40,36365040
18679,0,1805300,1,10,6,5,40,36365040
18680,0,1805300,1,10,6,5,40,36365040
18681,0,1805300,21,10,6,5,40,36365040
18682,1,1805300,6,10,6,5,41,36365041
18683,0,1805300,1,10,6,5,41,36365041
18684,0,1805200,1,10,6,5,41,36365041
18685,0,1805300,1,10,6,5,41,36365041
18686,0,1805300,4,10,6,5,41,36365041
18687,1,1805400,1,10,6,5,42,36365042
18688,0,1805400,7,10,6,5,42,36365042
18689,1,1805400,1,10,6,5,43,36365043
18690,0,1805400,2,10,6,5,43,36365043
18691,0,1805400,2,10,6,5,43,36365043
18692,0,1805400,1,10,6,5,43,36365043
18693,0,1805300,10,10,6,5,43,36365043
18694,0,1805400,7,10,6,5,43,36365043
18695,1,1805400,8,10,6,5,44,36365044
18696,0,1805400,1,10,6,5,44,36365044
18697,0,1805400,1,10,6,5,44,36365044
18698,0,1805300,1,10,6,5,44,36365044
18699,1,1805300,6,10,6,5,45,36365045
18701,0,1805400,4,10,6,5,45,36365045
18702,0,1805400,8,10,6,5,45,36365045
18703,0,1805400,1,10,6,5,45,36365045
18704,3,1805300,2,10,6,5,48,36365048
18705,12,1805200,1,10,6,5,60,36365060
18706,11,1805400,6,10,6,5,71,36365071
18707,8,1805300,1,10,6,5,79,36365079
18708,7,1805300,1,10,6,5,86,36365086
18709,53,1805400,1,10,6,5,139,36365139
18710,4,1805400,1,10,6,5,143,36365143
18711,22,1805400,2,10,6,5,165,36365165
18712,24,1805400,1,10,6,5,189,36365189
18713,1,1805400,1,10,6,5,190,36365190
18714,10,1805200,1,10,6,5,200,36365200
18715,8,1805400,1,10,6,5,208,36365208
18716,1,1805400,1,10,6,5,209,36365209
18717,10,1805400,4,10,6,5,219,36365219
18719,1,1805500,2,10,6,5,220,36365220
18720,0,1805500,1,10,6,5,220,36365220
18721,5,1805300,1,10,6,5,225,36365225
18722,29,1805300,1,10,6,5,254,36365254
18723,2,1805400,1,10,6,5,256,36365256
18724,23,1805200,1,10,6,5,279,36365279
18725,9,1805400,1,10,6,5,288,36365288
18726,22,1805300,1,10,6,5,310,36365310
18727,0,1805300,1,10,6,5,310,36365310
18728,30,1805400,5,10,6,5,340,36365340
18729,0,1805400,5,10,6,5,340,36365340
18730,0,1805400,5,10,6,5,340,36365340
18732,6,1805700,8,10,6,5,346,36365346
18733,2,1805700,1,10,6,5,348,36365348
18734,1,1805700,1,10,6,5,349,36365349
18735,0,1805700,1,10,6,5,349,36365349
18736,15,1805800,1,10,6,5,364,36365364
18737,27,1805700,1,10,6,5,391,36365391
18738,2,1805600,1,10,6,5,393,36365393
18739,28,1805700,2,10,6,5,421,36365421
18740,4,1805500,1,10,6,5,425,36365425
18741,19,1805500,1,10,6,5,444,36365444
18742,0,1805500,1,10,6,5,444,36365444
18743,12,1805600,1,10,6,5,456,36365456
18744,13,1805600,2,10,6,5,469,36365469
18746,0,1805500,1,10,6,5,469,36365469
18747,0,1805500,1,10,6,5,469,36365469
18748,16,1805700,1,10,6,5,485,36365485
18749,5,1805700,2,10,6,5,490,36365490
18750,2,1805700,1,10,6,5,492,36365492
18751,10,1805600,1,10,6,5,502,36365502
18752,0,1805700,10,10,6,5,502,36365502
18753,6,1805800,3,10,6,5,508,36365508
18754,10,1805800,1,10,6,5,518,36365518
18755,2,1805600,1,10,6,5,520,36365520
18756,1,1805800,2,10,6,5,521,36365521
18757,2,1805600,1,10,6,5,523,36365523
18758,0,1805800,1,10,6,5,523,36365523
18759,11,1805800,1,10,6,5,534,36365534
18760,8,1805800,2,10,6,5,542,36365542
18761,14,1805700,1,10,6,5,556,36365556
18762,1,1805700,1,10,6,5,557,36365557
18763,1,1805700,4,10,6,5,558,36365558
18765,0,1805600,1,10,6,5,558,36365558
18766,2,1805800,1,10,6,5,560,36365560
18767,10,1805800,2,10,6,5,570,36365570
18768,11,1805600,1,10,6,5,581,36365581
18769,23,1805700,1,10,6,5,604,36365604
18770,21,1805600,1,10,6,5,625,36365625
18771,31,1805800,1,10,6,5,656,36365656
18772,6,1805800,1,10,6,5,662,36365662
18773,7,1805800,1,10,6,5,669,36365669
18774,6,1805800,1,10,6,5,675,36365675
18775,12,1805600,1,10,6,5,687,36365687
18776,1,1805800,8,10,6,5,688,36365688
18777,0,1805600,1,10,6,5,688,36365688
18778,7,1805800,8,10,6,5,695,36365695
18780,9,1805900,1,10,6,5,704,36365704
18781,23,1805800,2,10,6,5,727,36365727
18782,26,1805900,2,10,6,5,753,36365753
18783,0,1805900,1,10,6,5,753,36365753
18784,3,1805900,3,10,6,5,756,36365756
18785,7,1805900,2,10,6,5,763,36365763
18786,14,1805800,1,10,6,5,777,36365777
18787,2,1805800,1,10,6,5,779,36365779
18788,18,1805900,1,10,6,5,797,36365797
18789,16,1805900,1,10,6,5,813,36365813
18790,38,1805700,1,10,6,5,851,36365851
18791,5,1805800,1,10,6,5,856,36365856
18792,11,1805900,1,10,6,5,867,36365867
18793,12,1805900,1,10,6,5,879,36365879
18794,18,1805800,1,10,6,5,897,36365897
18795,13,1805900,1,10,6,5,910,36365910
18796,6,1805900,1,10,6,5,916,36365916
18797,3,1805800,1,10,6,5,919,36365919
18798,1,1805800,2,10,6,5,920,36365920
18799,0,1805800,1,10,6,5,920,36365920
18800,41,1805900,1,10,6,5,961,36365961
18801,21,1805900,1,10,6,5,982,36365982
18802,0,1805900,2,10,6,5,982,36365982
18803,5,1805900,12,10,6,5,987,36365987
18804,0,1805900,2,10,6,5,987,36365987
18805,0,1806000,6,10,6,5,987,36365987
18806,5,1805900,1,10,6,5,992,36365992
18807,3,1805800,1,10,6,5,995,36365995
18808,6,1805900,4,10,6,6,1,36366001
18809,8,1805800,1,10,6,6,9,36366009
18810,77,1805800,1,10,6,6,86,36366086
18811,37,1805800,1,10,6,6,123,36366123
18812,16,1805900,5,10,6,6,139,36366139
18813,0,1805900,1,10,6,6,139,36366139
18814,23,1805900,1,10,6,6,162,36366162
18815,14,1805700,1,10,6,6,176,36366176
18816,1,1805800,1,10,6,6,177,36366177
18817,19,1805800,2,10,6,6,196,36366196
18818,4,1805800,1,10,6,6,200,36366200
18819,0,1805800,1,10,6,6,200,36366200
18820,0,1805800,1,10,6,6,200,36366200
18821,45,1805800,2,10,6,6,245,36366245
18822,19,1805600,1,10,6,6,264,36366264
18823,22,1805700,1,10,6,6,286,36366286
18824,7,1805700,1,10,6,6,293,36366293
18825,125,1805600,1,10,6,6,418,36366418
18826,29,1805800,1,10,6,6,447,36366447
18827,23,1805700,5,10,6,6,470,36366470
18828,36,1805600,1,10,6,6,506,36366506
18829,42,1805600,2,10,6,6,548,36366548
18830,68,1805800,1,10,6,6,616,36366616
18831,25,1805800,1,10,6,6,641,36366641
18832,25,1805800,1,10,6,6,666,36366666
18833,10,1805600,2,10,6,6,676,36366676
18834,38,1805800,1,10,6,6,714,36366714
18835,8,1805800,1,10,6,6,722,36366722
18836,21,1805800,1,10,6,6,743,36366743
18837,6,1805800,1,10,6,6,749,36366749
18838,19,1805800,1,10,6,6,768,36366768
18839,1,1805700,1,10,6,6,769,36366769
18840,6,1805800,1,10,6,6,775,36366775
18841,24,1805700,1,10,6,6,799,36366799
18842,89,1805700,1,10,6,6,888,36366888
18843,38,1805900,1,10,6,6,926,36366926
18844,5,1805700,2,10,6,6,931,36366931
18845,19,1805900,1,10,6,6,950,36366950
18846,22,1805900,1,10,6,6,972,36366972
18847,10,1805900,1,10,6,6,982,36366982
18848,7,1805900,1,10,6,6,989,36366989
18849,14,1805900,1,10,6,7,3,36367003
18850,22,1805900,1,10,6,7,25,36367025
18851,23,1805900,1,10,6,7,48,36367048
18852,35,1805900,1,10,6,7,83,36367083
18853,18,1805900,1,10,6,7,101,36367101
18854,15,1805700,1,10,6,7,116,36367116
18855,2,1805800,1,10,6,7,118,36367118
18856,59,1805800,1,10,6,7,177,36367177
18857,3,1805800,1,10,6,7,180,36367180
18858,23,1805800,1,10,6,7,203,36367203
18859,10,1805800,1,10,6,7,213,36367213
18860,101,1805700,1,10,6,7,314,36367314
18861,1,1805800,1,10,6,7,315,36367315
18862,19,1805800,1,10,6,7,334,36367334
18863,11,1805800,1,10,6,7,345,36367345
18864,20,1805800,1,10,6,7,365,36367365
18865,21,1805800,3,10,6,7,386,36367386
18866,12,1805800,2,10,6,7,398,36367398
18867,2,1805800,1,10,6,7,400,36367400
18868,16,1805800,1,10,6,7,416,36367416
18869,0,1805800,1,10,6,7,416,36367416
18871,9,1805900,2,10,6,7,425,36367425
18872,57,1805900,1,10,6,7,482,36367482
18873,0,1805900,3,10,6,7,482,36367482
18874,41,1805900,2,10,6,7,523,36367523
18876,0,1806000,2,10,6,7,523,36367523
18877,0,1806000,3,10,6,7,523,36367523
18878,78,1806000,2,10,6,7,601,36367601
18879,1,1806000,3,10,6,7,602,36367602
18880,18,1806000,2,10,6,7,620,36367620
18881,54,1806000,3,10,6,7,674,36367674
18882,10,1806000,1,10,6,7,684,36367684
18883,24,1805800,2,10,6,7,708,36367708
18884,32,1806000,1,10,6,7,740,36367740
18885,1,1806000,1,10,6,7,741,36367741
18886,13,1806000,1,10,6,7,754,36367754
18887,10,1806000,1,10,6,7,764,36367764
18888,0,1806000,1,10,6,7,764,36367764
18889,92,1806000,1,10,6,7,856,36367856
18890,21,1805800,6,10,6,7,877,36367877
18891,0,1805800,6,10,6,7,877,36367877
18892,0,1805800,6,10,6,7,877,36367877
18894,22,1805700,1,10,6,7,899,36367899
18895,36,1805800,1,10,6,7,935,36367935
18896,19,1805800,2,10,6,7,954,36367954
18897,55,1805700,1,10,6,8,9,36368009
18898,0,1805700,1,10,6,8,9,36368009
18900,18,1805700,2,10,6,8,27,36368027
18901,4,1805600,1,10,6,8,31,36368031
18902,14,1805600,1,10,6,8,45,36368045
18903,50,1805500,1,10,6,8,95,36368095
18904,84,1805700,1,10,6,8,179,36368179
18905,1,1805700,9,10,6,8,180,36368180
18906,0,1805700,1,10,6,8,180,36368180
18908,32,1805800,1,10,6,8,212,36368212
18909,10,1805800,1,10,6,8,222,36368222
18910,28,1805600,1,10,6,8,250,36368250
18911,105,1805700,1,10,6,8,355,36368355
18912,25,1805700,1,10,6,8,380,36368380
18913,9,1805700,3,10,6,8,389,36368389
18914,1,1805800,2,10,6,8,390,36368390
18915,13,1805800,1,10,6,8,403,36368403
18916,13,1805600,1,10,6,8,416,36368416
18917,3,1805600,1,10,6,8,419,36368419
18918,38,1805600,1,10,6,8,457,36368457
18919,117,1805800,1,10,6,8,574,36368574
18920,24,1805800,3,10,6,8,598,36368598
18921,19,1805800,2,10,6,8,617,36368617
18922,1,1805800,1,10,6,8,618,36368618
18923,52,1805900,1,10,6,8,670,36368670
18924,10,1805900,1,10,6,8,680,36368680
18925,0,1805900,1,10,6,8,680,36368680
18926,10,1805900,1,10,6,8,690,36368690
18927,66,1805900,3,10,6,8,756,36368756
18928,1,1805900,1,10,6,8,757,36368757
18929,0,1805900,3,10,6,8,757,36368757
18930,0,1805900,5,10,6,8,757,36368757
18932,57,1805800,1,10,6,8,814,36368814
18933,34,1805900,1,10,6,8,848,36368848
18934,36,1805800,1,10,6,8,884,36368884
18935,30,1806000,3,10,6,8,914,36368914
18936,1,1806000,1,10,6,8,915,36368915
18937,21,1806000,2,10,6,8,936,36368936
18938,65,1806000,1,10,6,9,1,36369001
18939,44,1806000,3,10,6,9,45,36369045
18940,10,1806000,3,10,6,9,55,36369055
18941,19,1806000,1,10,6,9,74,36369074
18942,32,1806000,1,10,6,9,106,36369106
18943,11,1806000,2,10,6,9,117,36369117
18944,76,1806000,1,10,6,9,193,36369193
18945,0,1806000,1,10,6,9,193,36369193
18946,39,1806000,3,10,6,9,232,36369232
18947,21,1806000,2,10,6,9,253,36369253
18948,21,1806000,1,10,6,9,274,36369274
18949,10,1806000,2,10,6,9,284,36369284
18950,0,1806000,2,10,6,9,284,36369284
18952,10,1806200,2,10,6,9,294,36369294
18953,2,1806200,1,10,6,9,296,36369296
18954,7,1806000,1,10,6,9,303,36369303
18955,12,1806000,1,10,6,9,315,36369315
18956,5,1806000,1,10,6,9,320,36369320
18957,63,1806200,1,10,6,9,383,36369383
18958,18,1806200,1,10,6,9,401,36369401
18959,24,1806200,2,10,6,9,425,36369425
18960,36,1806200,1,10,6,9,461,36369461
18961,2,1806200,1,10,6,9,463,36369463
18962,3,1806200,1,10,6,9,466,36369466
18963,24,1806200,1,10,6,9,490,36369490
18964,21,1806200,2,10,6,9,511,36369511
18965,17,1806200,1,10,6,9,528,36369528
18966,38,1806200,1,10,6,9,566,36369566
18967,2,1806200,1,10,6,9,568,36369568
18968,7,1806200,1,10,6,9,575,36369575
18969,59,1806100,1,10,6,9,634,36369634
18970,4,1806000,1,10,6,9,638,36369638
18971,0,1806200,1,10,6,9,638,36369638
18972,5,1806000,1,10,6,9,643,36369643
18973,6,1806200,1,10,6,9,649,36369649
18974,3,1806100,1,10,6,9,652,36369652
18976,8,1806200,1,10,6,9,660,36369660
18977,35,1806300,1,10,6,9,695,36369695
18978,46,1806300,3,10,6,9,741,36369741
18979,22,1806300,1,10,6,9,763,36369763
18980,2,1806300,1,10,6,9,765,36369765
18981,10,1806300,1,10,6,9,775,36369775
18982,16,1806300,1,10,6,9,791,36369791
18983,16,1806300,1,10,6,9,807,36369807
18984,12,1806300,1,10,6,9,819,36369819
18985,18,1806300,2,10,6,9,837,36369837
18986,15,1806200,3,10,6,9,852,36369852
18988,1,1806300,2,10,6,9,853,36369853
18989,1,1806300,2,10,6,9,854,36369854
18990,0,1806300,1,10,6,9,854,36369854
18991,0,1806300,1,10,6,9,854,36369854
18992,4,1806200,17,10,6,9,858,36369858
18993,3,1806300,1,10,6,9,861,36369861
18994,16,1806300,2,10,6,9,877,36369877
18995,17,1806200,1,10,6,9,894,36369894
18996,16,1806200,1,10,6,9,910,36369910
18997,40,1806300,2,10,6,9,950,36369950
18998,39,1806200,2,10,6,9,989,36369989
18999,63,1806100,2,10,6,10,52,36370052
19000,44,1806200,1,10,6,10,96,36370096
19001,30,1806000,1,10,6,10,126,36370126
19002,57,1806100,1,10,6,10,183,36370183
19003,125,1805900,2,10,6,10,308,36370308
19004,1,1805900,1,10,6,10,309,36370309
19005,7,1805800,1,10,6,10,316,36370316
19006,71,1806000,1,10,6,10,387,36370387
19007,34,1805800,1,10,6,10,421,36370421
19008,14,1806000,1,10,6,10,435,36370435
19009,13,1806000,1,10,6,10,448,36370448
19010,23,1805900,1,10,6,10,471,36370471
19011,15,1806000,1,10,6,10,486,36370486
19012,34,1806000,1,10,6,10,520,36370520
19013,4,1806000,1,10,6,10,524,36370524
19014,6,1806000,2,10,6,10,530,36370530
19015,44,1806000,1,10,6,10,574,36370574
19016,27,1806000,1,10,6,10,601,36370601
19017,144,1806000,1,10,6,10,745,36370745
19018,15,1806000,1,10,6,10,760,36370760
19019,55,1806000,1,10,6,10,815,36370815
19020,52,1806000,2,10,6,10,867,36370867
19021,114,1806000,1,10,6,10,981,36370981
19022,68,1806000,4,10,6,11,49,36371049
19023,11,1806000,2,10,6,11,60,36371060
19024,220,1805800,1,10,6,11,280,36371280
19025,72,1806000,1,10,6,11,352,36371352
19026,27,1805800,2,10,6,11,379,36371379
19027,158,1805900,1,10,6,11,537,36371537
19028,2,1805800,1,10,6,11,539,36371539
19029,48,1805900,2,10,6,11,587,36371587
19030,6,1806000,1,10,6,11,593,36371593
19031,17,1806000,1,10,6,11,610,36371610
19032,8,1806000,1,10,6,11,618,36371618
19033,0,1806000,1,10,6,11,618,36371618
19034,49,1806000,2,10,6,11,667,36371667
19035,35,1805900,1,10,6,11,702,36371702
19036,184,1805900,1,10,6,11,886,36371886
19037,20,1805900,1,10,6,11,906,36371906
19039,16,1805800,1,10,6,11,922,36371922
19040,46,1805800,1,10,6,11,968,36371968
19041,381,1806000,1,10,6,12,349,36372349
19042,331,1806100,2,10,6,12,680,36372680
19043,116,1806000,1,10,6,12,796,36372796
19044,0,1806100,5,10,6,12,796,36372796
19045,57,1806000,2,10,6,12,853,36372853
19046,66,1806100,1,10,6,12,919,36372919
19048,174,1806100,1,10,6,13,93,36373093
19049,0,1806200,5,10,6,13,93,36373093
19050,86,1806300,1,10,6,13,179,36373179
19051,33,1806300,1,10,6,13,212,36373212
19052,4,1806100,1,10,6,13,216,36373216
19053,247,1806000,1,10,6,13,463,36373463
19054,9,1806200,1,10,6,13,472,36373472
19055,6,1806000,1,10,6,13,478,36373478
19056,19,1806000,1,10,6,13,497,36373497
19057,35,1806000,1,10,6,13,532,36373532
19058,130,1806100,2,10,6,13,662,36373662
19059,22,1806100,1,10,6,13,684,36373684
19060,36,1806000,1,10,6,13,720,36373720
19062,98,1806100,2,10,6,13,818,36373818
19063,2,1806100,2,10,6,13,820,36373820
19064,3,1806100,2,10,6,13,823,36373823
19065,377,1806000,1,10,6,14,200,36374200
19067,135,1806100,1,10,6,14,335,36374335
19068,37,1806100,1,10,6,14,372,36374372
19069,73,1806100,1,10,6,14,445,36374445
19070,28,1805900,1,10,6,14,473,36374473
19071,86,1806100,1,10,6,14,559,36374559
19072,39,1806100,1,10,6,14,598,36374598
19073,155,1805900,2,10,6,14,753,36374753
19074,176,1805800,1,10,6,14,929,36374929
19075,257,1805700,1,10,6,15,186,36375186
19076,669,1805700,1,10,6,15,855,36375855
19077,233,1805600,3,10,6,16,88,36376088
19078,0,1805600,3,10,6,16,88,36376088
19080,3,1805500,1,10,6,16,91,36376091
19081,7,1805500,1,10,6,16,98,36376098
19082,107,1805500,1,10,6,16,205,36376205
19083,117,1805500,2,10,6,16,322,36376322
19084,347,1805500,1,10,6,16,669,36376669
19085,44,1805400,1,10,6,16,713,36376713
19086,261,1805400,11,10,6,16,974,36376974
19087,265,1805400,2,10,6,17,239,36377239
19088,111,1805400,1,10,6,17,350,36377350
19089,34,1805300,1,10,6,17,384,36377384
19090,159,1805300,2,10,6,17,543,36377543
19091,75,1805300,1,10,6,17,618,36377618
19092,417,1805400,1,10,6,18,35,36378035
19093,360,1805400,1,10,6,18,395,36378395
19094,496,1805300,1,10,6,18,891,36378891
19095,22,1805400,1,10,6,18,913,36378913
19096,27,1805400,1,10,6,18,940,36378940
19097,493,1805400,1,10,6,19,433,36379433
19098,181,1805400,1,10,6,19,614,36379614
19099,202,1805400,1,10,6,19,816,36379816
19100,712,1805400,1,10,6,20,528,36380528
19101,225,1805500,9,10,6,20,753,36380753
19102,51,1805400,1,10,6,20,804,36380804
19103,229,1805400,1,10,6,21,33,36381033
19104,46,1805300,1,10,6,21,79,36381079
19105,68,1805500,1,10,6,21,147,36381147
19106,822,1805500,1,10,6,21,969,36381969
19107,41,1805400,3,10,6,22,10,36382010
19108,59,1805400,1,10,6,22,69,36382069
19109,139,1805500,1,10,6,22,208,36382208
19110,9,1805500,3,10,6,22,217,36382217
19111,6,1805600,1,10,6,22,223,36382223
19112,40,1805400,1,10,6,22,263,36382263
19113,72,1805600,3,10,6,22,335,36382335
19114,8,1805400,1,10,6,22,343,36382343
19115,1006,1805400,3,10,6,23,349,36383349
19116,1066,1805500,3,10,6,24,415,36384415
19117,512,1805600,1,10,6,24,927,36384927
19118,29,1805600,1,10,6,24,956,36384956
19119,34,1805600,2,10,6,24,990,36384990
19120,0,1805600,1,10,6,24,990,36384990
19121,231,1805400,1,10,6,25,221,36385221
19122,7,1805500,1,10,6,25,228,36385228
19123,60,1805400,1,10,6,25,288,36385288
19124,619,1805400,6,10,6,25,907,36385907
19125,235,1805500,1,10,6,26,142,36386142
19126,1,1805600,2,10,6,26,143,36386143
19127,168,1805600,1,10,6,26,311,36386311
19128,255,1805600,3,10,6,26,566,36386566
19129,41,1805400,1,10,6,26,607,36386607
19130,503,1805500,1,10,6,27,110,36387110
19132,116,1805600,1,10,6,27,226,36387226
19133,106,1805600,3,10,6,27,332,36387332
19134,239,1805600,1,10,6,27,571,36387571
19135,162,1805500,1,10,6,27,733,36387733
19136,264,1805600,1,10,6,27,997,36387997
19137,76,1805400,1,10,6,28,73,36388073
19138,250,1805600,1,10,6,28,323,36388323
19139,85,1805500,1,10,6,28,408,36388408
19140,375,1805400,1,10,6,28,783,36388783
19141,932,1805400,1,10,6,29,715,36389715
19142,128,1805400,1,10,6,29,843,36389843
19143,147,1805500,1,10,6,29,990,36389990
19144,241,1805500,1,10,6,30,231,36390231
19145,0,1805600,4,10,6,30,231,36390231
19146,224,1805500,1,10,6,30,455,36390455
19147,384,1805500,1,10,6,30,839,36390839
19148,1,1805600,12,10,6,30,840,36390840
19149,291,1805700,5,10,6,31,131,36391131
19150,61,1805700,1,10,6,31,192,36391192
19151,23,1805500,1,10,6,31,215,36391215
19152,170,1805500,1,10,6,31,385,36391385
19153,570,1805500,1,10,6,31,955,36391955
19154,423,1805500,2,10,6,32,378,36392378
19155,342,1805500,1,10,6,32,720,36392720
19156,1012,1805600,2,10,6,33,732,36393732
19157,210,1805600,4,10,6,33,942,36393942
19158,191,1805700,3,10,6,34,133,36394133
19159,59,1805700,3,10,6,34,192,36394192
19160,1,1805600,1,10,6,34,193,36394193
19161,254,1805600,1,10,6,34,447,36394447
19162,28,1805600,11,10,6,34,475,36394475
19163,0,1805600,11,10,6,34,475,36394475
19165,7,1805400,1,10,6,34,482,36394482
19167,35,1805300,5,10,6,34,517,36394517
19168,27,1805400,1,10,6,34,544,36394544
19169,111,1805500,6,10,6,34,655,36394655
19171,1043,1805600,1,10,6,35,698,36395698
19172,971,1805600,1,10,6,36,669,36396669
19173,542,1805700,2,10,6,37,211,36397211
19174,25,1805700,3,10,6,37,236,36397236
19175,951,1805800,2,10,6,38,187,36398187
19176,46,1805800,3,10,6,38,233,36398233
19177,523,1805700,1,10,6,38,756,36398756
19178,220,1805700,1,10,6,38,976,36398976
19179,133,1805700,2,10,6,39,109,36399109
19181,639,1805800,3,10,6,39,748,36399748
19182,645,1805800,2,10,6,40,393,36400393
19183,206,1805800,2,10,6,40,599,36400599
19184,200,1805800,4,10,6,40,799,36400799
19185,84,1805800,1,10,6,40,883,36400883
19186,1533,1805800,2,10,6,42,416,36402416
19187,97,1805800,1,10,6,42,513,36402513
19188,76,1805800,2,10,6,42,589,36402589
19189,71,1805800,1,10,6,42,660,36402660
19190,4,1805800,1,10,6,42,664,36402664
19191,65,1805800,1,10,6,42,729,36402729
19192,0,1805800,1,10,6,42,729,36402729
19193,43,1805800,1,10,6,42,772,36402772
19194,74,1805800,1,10,6,42,846,36402846
19195,100,1805800,1,10,6,42,946,36402946
19196,82,1805800,1,10,6,43,28,36403028
19197,443,1805900,1,10,6,43,471,36403471
19198,95,1805800,1,10,6,43,566,36403566
19199,70,1805800,1,10,6,43,636,36403636
19200,262,1805800,1,10,6,43,898,36403898
19201,588,1805900,10,10,6,44,486,36404486
19202,196,1805800,1,10,6,44,682,36404682
19203,31,1805900,3,10,6,44,713,36404713
19204,202,1805800,14,10,6,44,915,36404915
19205,0,1805800,14,10,6,44,915,36404915
19206,0,1805800,14,10,6,44,915,36404915
19208,5,1805500,2,10,6,44,920,36404920
19209,2,1805500,3,10,6,44,922,36404922
19210,0,1805500,1,10,6,44,922,36404922
19211,4,1805500,3,10,6,44,926,36404926
19212,31,1805500,2,10,6,44,957,36404957
19213,0,1805500,1,10,6,44,957,36404957
19214,1,1805500,1,10,6,44,958,36404958
19215,0,1805400,2,10,6,44,958,36404958
19216,111,1805600,1,10,6,45,69,36405069
19217,1328,1805700,1,10,6,46,397,36406397
19218,353,1805700,5,10,6,46,750,36406750
19220,231,1805800,1,10,6,46,981,36406981
19221,474,1805600,1,10,6,47,455,36407455
19222,406,1805600,1,10,6,47,861,36407861
19223,1584,1805800,1,10,6,49,445,36409445
19224,17,1805600,1,10,6,49,462,36409462
19225,1226,1805700,1,10,6,50,688,36410688
19227,77,1805600,1,10,6,50,765,36410765
19228,86,1805800,12,10,6,50,851,36410851
19229,24,1805800,3,10,6,50,875,36410875
19230,109,1805700,2,10,6,50,984,36410984
19231,227,1805700,1,10,6,51,211,36411211
19232,905,1805800,1,10,6,52,116,36412116
19233,248,1805700,2,10,6,52,364,36412364
19234,0,1805700,2,10,6,52,364,36412364
19236,2,1805500,5,10,6,52,366,36412366
19237,1,1805500,2,10,6,52,367,36412367
19238,0,1805500,2,10,6,52,367,36412367
19239,0,1805500,4,10,6,52,367,36412367
19240,0,1805500,1,10,6,52,367,36412367
19241,0,1805500,6,10,6,52,367,36412367
19242,0,1805500,1,10,6,52,367,36412367
19243,0,1805500,1,10,6,52,367,36412367
19244,0,1805500,1,10,6,52,367,36412367
19245,0,1805500,2,10,6,52,367,36412367
19246,269,1805500,1,10,6,52,636,36412636
19247,0,1805500,2,10,6,52,636,36412636
19248,203,1805600,1,10,6,52,839,36412839
19249,100,1805700,1,10,6,52,939,36412939
19250,46,1805600,1,10,6,52,985,36412985
19251,4,1805600,1,10,6,52,989,36412989
19252,1560,1805600,2,10,6,54,549,36414549
19253,361,1805600,2,10,6,54,910,36414910
19254,1453,1805700,2,10,6,56,363,36416363
19255,72,1805600,1,10,6,56,435,36416435
19256,1212,1805600,1,10,6,57,647,36417647
19257,43,1805700,1,10,6,57,690,36417690
19258,418,1805600,1,10,6,58,108,36418108
19259,395,1805700,1,10,6,58,503,36418503
19260,302,1805600,1,10,6,58,805,36418805
19261,771,1805600,1,10,6,59,576,36419576
19262,54,1805700,4,10,6,59,630,36419630
19263,1107,1805700,1,10,7,0,737,36420737
19264,128,1805800,6,10,7,0,865,36420865
19265,136,1805800,6,10,7,1,1,36421001
19266,100,1805900,1,10,7,1,101,36421101
19267,9,1805900,1,10,7,1,110,36421110
19268,26,1805900,1,10,7,1,136,36421136
19269,54,1805700,1,10,7,1,190,36421190
19270,36,1805700,1,10,7,1,226,36421226
19271,20,1805700,1,10,7,1,246,36421246
19272,21,1805700,1,10,7,1,267,36421267
19273,35,1805700,1,10,7,1,302,36421302
19274,5,1805700,1,10,7,1,307,36421307
19275,29,1805900,1,10,7,1,336,36421336
19276,12,1805700,1,10,7,1,348,36421348
19277,97,1805600,17,10,7,1,445,36421445
19279,2,1805500,2,10,7,1,447,36421447
19280,1,1805500,31,10,7,1,448,36421448
19281,28,1805700,1,10,7,1,476,36421476
19282,3,1805700,1,10,7,1,479,36421479
19283,8,1805500,1,10,7,1,487,36421487
19284,253,1805600,2,10,7,1,740,36421740
19285,550,1805600,1,10,7,2,290,36422290
19286,133,1805700,1,10,7,2,423,36422423
19287,31,1805600,1,10,7,2,454,36422454
19288,140,1805600,1,10,7,2,594,36422594
19289,8,1805600,1,10,7,2,602,36422602
19290,120,1805600,8,10,7,2,722,36422722
19291,0,1805600,1,10,7,2,722,36422722
19292,508,1805700,4,10,7,3,230,36423230
19293,1115,1805700,1,10,7,4,345,36424345
19294,413,1805500,1,10,7,4,758,36424758
19295,590,1805500,1,10,7,5,348,36425348
19296,15,1805500,1,10,7,5,363,36425363
19297,49,1805500,1,10,7,5,412,36425412
19298,63,1805500,1,10,7,5,475,36425475
19299,160,1805500,1,10,7,5,635,36425635
19300,228,1805600,1,10,7,5,863,36425863
19301,60,1805500,2,10,7,5,923,36425923
19302,314,1805500,1,10,7,6,237,36426237
19303,266,1805600,1,10,7,6,503,36426503
19304,128,1805600,1,10,7,6,631,36426631
19305,401,1805500,4,10,7,7,32,36427032
19306,36,1805600,1,10,7,7,68,36427068
19308,32,1805700,1,10,7,7,100,36427100
19309,1,1805700,1,10,7,7,101,36427101
19310,9,1805500,1,10,7,7,110,36427110
19311,0,1805500,1,10,7,7,110,36427110
19312,0,1805500,2,10,7,7,110,36427110
19313,910,1805500,1,10,7,8,20,36428020
19314,0,1805500,1,10,7,8,20,36428020
19316,1270,1805400,1,10,7,9,290,36429290
19317,233,1805400,1,10,7,9,523,36429523
19318,753,1805400,7,10,7,10,276,36430276
19320,205,1805500,1,10,7,10,481,36430481
19321,335,1805300,2,10,7,10,816,36430816
19322,135,1805400,1,10,7,10,951,36430951
19323,426,1805300,1,10,7,11,377,36431377
19324,788,1805300,1,10,7,12,165,36432165
19325,748,1805400,1,10,7,12,913,36432913
19326,37,1805400,1,10,7,12,950,36432950
19327,261,1805400,1,10,7,13,211,36433211
19328,63,1805300,2,10,7,13,274,36433274
19329,1152,1805400,1,10,7,14,426,36434426
19330,493,1805300,5,10,7,14,919,36434919
19331,241,1805300,1,10,7,15,160,36435160
19332,1285,1805300,1,10,7,16,445,36436445
19333,765,1805400,1,10,7,17,210,36437210
19334,15,1805500,1,10,7,17,225,36437225
19335,231,1805400,1,10,7,17,456,36437456
19336,1628,1805300,1,10,7,19,84,36439084
19337,580,1805300,4,10,7,19,664,36439664
19338,33,1805300,1,10,7,19,697,36439697
19339,1129,1805300,2,10,7,20,826,36440826
19340,636,1805500,1,10,7,21,462,36441462
19341,1027,1805400,1,10,7,22,489,36442489
19342,622,1805400,2,10,7,23,111,36443111
19343,2716,1805500,2,10,7,25,827,36445827
19344,791,1805400,1,10,7,26,618,36446618
19345,121,1805500,1,10,7,26,739,36446739
19346,95,1805400,1,10,7,26,834,36446834
19347,3542,1805600,1,10,7,30,376,36450376
19348,100,1805600,1,10,7,30,476,36450476
19349,0,1805600,1,10,7,30,476,36450476
19350,1,1805700,1,10,7,30,477,36450477
19351,277,1805600,1,10,7,30,754,36450754
19352,3637,1805700,1,10,7,34,391,36454391
19353,1068,1805700,3,10,7,35,459,36455459
19354,0,1805700,1,10,7,35,459,36455459
19355,0,1805700,2,10,7,35,459,36455459
19356,0,1805700,1,10,7,35,459,36455459
19357,0,1805700,1,10,7,35,459,36455459
19358,2,1805700,10,10,7,35,461,36455461
19359,59,1805800,1,10,7,35,520,36455520
19360,66,1805700,2,10,7,35,586,36455586
19361,1420,1805700,1,10,7,37,6,36457006
19362,280,1805700,2,10,7,37,286,36457286
19363,49,1805700,1,10,7,37,335,36457335
19364,520,1805600,1,10,7,37,855,36457855
19365,4781,1805800,1,10,7,42,636,36462636
19366,448,1805900,1,10,7,43,84,36463084
19367,439,1805800,1,10,7,43,523,36463523
19368,426,1805800,1,10,7,43,949,36463949
19369,2,1805800,1,10,7,43,951,36463951
19370,201,1805900,1,10,7,44,152,36464152
19371,304,1805800,1,10,7,44,456,36464456
19372,357,1805900,3,10,7,44,813,36464813
19373,19,1805900,1,10,7,44,832,36464832
19374,247,1805900,2,10,7,45,79,36465079
19375,831,1805800,1,10,7,45,910,36465910
19376,1027,1805800,1,10,7,46,937,36466937
19377,87,1805800,1,10,7,47,24,36467024
19378,39,1805800,1,10,7,47,63,36467063
19379,578,1805900,2,10,7,47,641,36467641
19380,156,1805800,1,10,7,47,797,36467797
19381,1628,1805800,1,10,7,49,425,36469425
19383,1270,1805900,1,10,7,50,695,36470695
19384,855,1805800,1,10,7,51,550,36471550
19385,289,1805800,2,10,7,51,839,36471839
19386,150,1805700,1,10,7,51,989,36471989
19387,815,1805800,2,10,7,52,804,36472804
19388,1734,1805800,1,10,7,54,538,36474538
19389,810,1805800,1,10,7,55,348,36475348
19390,124,1805700,2,10,7,55,472,36475472
19391,7,1805700,5,10,7,55,479,36475479
19392,605,1805700,1,10,7,56,84,36476084
19393,33,1805600,2,10,7,56,117,36476117
19394,174,1805700,1,10,7,56,291,36476291
19395,519,1805700,1,10,7,56,810,36476810
19396,607,1805700,1,10,7,57,417,36477417
19397,504,1805800,3,10,7,57,921,36477921
19398,1115,1805800,3,10,7,59,36,36479036
19399,254,1805800,1,10,7,59,290,36479290
19400,1147,1805800,2,10,8,0,437,36480437
19401,215,1805800,1,10,8,0,652,36480652
19402,260,1805800,1,10,8,0,912,36480912
19403,180,1805800,1,10,8,1,92,36481092
19404,50,1805800,1,10,8,1,142,36481142
19405,21,1805800,2,10,8,1,163,36481163
19406,502,1805700,1,10,8,1,665,36481665
19407,82,1805900,1,10,8,1,747,36481747
19408,782,1805700,3,10,8,2,529,36482529
19409,250,1805800,1,10,8,2,779,36482779
19410,304,1805900,4,10,8,3,83,36483083
19411,1007,1805700,1,10,8,4,90,36484090
19412,1018,1805900,1,10,8,5,108,36485108
19413,139,1805900,6,10,8,5,247,36485247
19414,166,1805900,1,10,8,5,413,36485413
19415,5,1805800,2,10,8,5,418,36485418
19416,75,1805800,1,10,8,5,493,36485493
19417,1802,1805900,1,10,8,7,295,36487295
19418,1345,1805900,2,10,8,8,640,36488640
19419,393,1805900,6,10,8,9,33,36489033
19420,490,1805900,9,10,8,9,523,36489523
19422,88,1806000,1,10,8,9,611,36489611
19423,38,1806000,1,10,8,9,649,36489649
19424,342,1805900,1,10,8,9,991,36489991
19425,1118,1806000,1,10,8,11,109,36491109
19426,420,1805900,1,10,8,11,529,36491529
19427,43,1806000,1,10,8,11,572,36491572
19428,125,1805900,1,10,8,11,697,36491697
19429,181,1806000,3,10,8,11,878,36491878
19430,157,1806000,1,10,8,12,35,36492035
19431,518,1805900,2,10,8,12,553,36492553
19432,61,1806000,2,10,8,12,614,36492614
19433,1477,1805800,1,10,8,14,91,36494091
19434,154,1805900,1,10,8,14,245,36494245
19435,265,1806000,1,10,8,14,510,36494510
19436,92,1805900,1,10,8,14,602,36494602
19437,631,1806000,1,10,8,15,233,36495233
19438,229,1805900,1,10,8,15,462,36495462
19439,467,1806000,1,10,8,15,929,36495929
19440,348,1806000,3,10,8,16,277,36496277
19441,785,1805900,1,10,8,17,62,36497062
19442,48,1806000,1,10,8,17,110,36497110
19443,361,1806000,1,10,8,17,471,36497471
19444,341,1806000,10,10,8,17,812,36497812
19445,475,1806000,3,10,8,18,287,36498287
19446,410,1805900,1,10,8,18,697,36498697
19447,345,1805900,13,10,8,19,42,36499042
19449,180,1806000,3,10,8,19,222,36499222
19450,241,1806000,1,10,8,19,463,36499463
19451,622,1805900,1,10,8,20,85,36500085
19452,873,1806000,1,10,8,20,958,36500958
19453,100,1806000,3,10,8,21,58,36501058
19454,498,1806000,28,10,8,21,556,36501556
19455,170,1806000,1,10,8,21,726,36501726
19456,162,1806000,1,10,8,21,888,36501888
19457,52,1806000,2,10,8,21,940,36501940
19458,1358,1805900,1,10,8,23,298,36503298
19459,273,1805900,5,10,8,23,571,36503571
19460,1,1805800,3,10,8,23,572,36503572
19461,1,1805800,1,10,8,23,573,36503573
19462,1,1805800,3,10,8,23,574,36503574
19463,4,1805700,1,10,8,23,578,36503578
19464,53,1805800,1,10,8,23,631,36503631
19465,18,1805900,2,10,8,23,649,36503649
19466,267,1805900,4,10,8,23,916,36503916
19467,1362,1805800,2,10,8,25,278,36505278
19468,452,1805900,4,10,8,25,730,36505730
19470,2422,1805800,1,10,8,28,152,36508152
19471,236,1805800,1,10,8,28,388,36508388
19472,1951,1805900,1,10,8,30,339,36510339
19473,28,1805900,1,10,8,30,367,36510367
19474,2854,1805900,1,10,8,33,221,36513221
19475,0,1805900,1,10,8,33,221,36513221
19476,0,1805900,1,10,8,33,221,36513221
19477,1,1805900,2,10,8,33,222,36513222
19478,680,1805900,1,10,8,33,902,36513902
19479,524,1805900,3,10,8,34,426,36514426
19480,459,1805900,1,10,8,34,885,36514885
19481,43,1805900,1,10,8,34,928,36514928
19482,1352,1805900,1,10,8,36,280,36516280
19483,338,1806000,10,10,8,36,618,36516618
19484,126,1805900,1,10,8,36,744,36516744
19485,454,1806000,1,10,8,37,198,36517198
19486,1655,1806000,1,10,8,38,853,36518853
19487,1344,1806000,2,10,8,40,197,36520197
19488,2123,1806000,1,10,8,42,320,36522320
19489,870,1805900,3,10,8,43,190,36523190
19490,2,1805900,3,10,8,43,192,36523192
19491,15,1805900,3,10,8,43,207,36523207
19492,573,1805900,1,10,8,43,780,36523780
19493,2624,1805900,1,10,8,46,404,36526404
19494,873,1805900,1,10,8,47,277,36527277
19495,734,1805800,1,10,8,48,11,36528011
19496,333,1805800,1,10,8,48,344,36528344
19497,1045,1805800,1,10,8,49,389,36529389
19498,523,1805800,10,10,8,49,912,36529912
19499,2480,1805800,3,10,8,52,392,36532392
19500,1483,1805700,1,10,8,53,875,36533875
19501,278,1805700,1,10,8,54,153,36534153
19502,207,1805800,2,10,8,54,360,36534360
19504,252,1805900,1,10,8,54,612,36534612
19505,4,1805800,1,10,8,54,616,36534616
19506,75,1805800,2,10,8,54,691,36534691
19507,371,1805800,1,10,8,55,62,36535062
19508,1419,1805800,1,10,8,56,481,36536481
19509,1115,1805800,3,10,8,57,596,36537596
19510,368,1805700,1,10,8,57,964,36537964
19511,65,1805800,1,10,8,58,29,36538029
19512,506,1805800,1,10,8,58,535,36538535
19513,561,1805800,1,10,8,59,96,36539096
19514,610,1805800,1,10,8,59,706,36539706
19515,1502,1805800,1,10,9,1,208,36541208
19516,241,1805900,2,10,9,1,449,36541449
19517,103,1805900,1,10,9,1,552,36541552
19518,58,1805900,1,10,9,1,610,36541610
19519,25,1805900,1,10,9,1,635,36541635
19520,3,1805900,1,10,9,1,638,36541638
19521,39,1805900,1,10,9,1,677,36541677
19522,1,1805900,1,10,9,1,678,36541678
19523,0,1805900,1,10,9,1,678,36541678
19524,24,1805900,1,10,9,1,702,36541702
19525,0,1805900,1,10,9,1,702,36541702
19526,61,1806000,1,10,9,1,763,36541763
19527,18,1806000,1,10,9,1,781,36541781
19528,6,1806000,1,10,9,1,787,36541787
19529,8,1806000,1,10,9,1,795,36541795
19530,27,1806000,1,10,9,1,822,36541822
19531,10,1806000,1,10,9,1,832,36541832
19532,6,1806000,1,10,9,1,838,36541838
19533,3,1806000,1,10,9,1,841,36541841
19534,1,1806000,1,10,9,1,842,36541842
19535,8,1806000,1,10,9,1,850,36541850
19536,32,1805800,2,10,9,1,882,36541882
19537,15,1806000,1,10,9,1,897,36541897
19538,38,1806000,1,10,9,1,935,36541935
19539,0,1806000,1,10,9,1,935,36541935
19540,8,1806000,1,10,9,1,943,36541943
19541,0,1806000,1,10,9,1,943,36541943
19542,7,1806000,1,10,9,1,950,36541950
19543,8,1806000,1,10,9,1,958,36541958
19544,50,1806000,3,10,9,2,8,36542008
19545,114,1806000,1,10,9,2,122,36542122
19546,153,1806000,1,10,9,2,275,36542275
19547,35,1806000,1,10,9,2,310,36542310
19548,750,1806000,1,10,9,3,60,36543060
19549,1,1806000,1,10,9,3,61,36543061
19550,0,1806000,4,10,9,3,61,36543061
19551,0,1806000,1,10,9,3,61,36543061
19552,198,1806000,7,10,9,3,259,36543259
19553,1,1806000,1,10,9,3,260,36543260
19554,0,1806000,1,10,9,3,260,36543260
19555,0,1806000,1,10,9,3,260,36543260
19556,0,1806000,1,10,9,3,260,36543260
19557,518,1806000,1,10,9,3,778,36543778
19558,2,1806000,65,10,9,3,780,36543780
19559,1,1806100,1,10,9,3,781,36543781
19560,0,1806100,1,10,9,3,781,36543781
19561,0,1806100,2,10,9,3,781,36543781
19562,1,1806100,1,10,9,3,782,36543782
19563,0,1806100,1,10,9,3,782,36543782
19564,35,1806100,2,10,9,3,817,36543817
19565,9,1806100,6,10,9,3,826,36543826
19566,315,1806100,1,10,9,4,141,36544141
19567,127,1806100,2,10,9,4,268,36544268
19568,43,1806000,2,10,9,4,311,36544311
19569,4,1806000,1,10,9,4,315,36544315
19570,0,1806000,1,10,9,4,315,36544315
19571,490,1806000,1,10,9,4,805,36544805
19572,128,1806000,3,10,9,4,933,36544933
19573,386,1806000,1,10,9,5,319,36545319
19574,49,1806000,1,10,9,5,368,36545368
19575,25,1806000,1,10,9,5,393,36545393
19576,29,1806000,1,10,9,5,422,36545422
19577,716,1805900,12,10,9,6,138,36546138
19578,187,1805900,1,10,9,6,325,36546325
19579,517,1805900,2,10,9,6,842,36546842
19580,107,1805800,4,10,9,6,949,36546949
19581,2006,1805800,1,10,9,8,955,36548955
19582,503,1805900,1,10,9,9,458,36549458
19583,55,1805900,1,10,9,9,513,36549513
19584,401,1805900,1,10,9,9,914,36549914
19585,898,1805900,2,10,9,10,812,36550812
19586,960,1805900,1,10,9,11,772,36551772
19587,885,1805900,2,10,9,12,657,36552657
19589,299,1805800,1,10,9,12,956,36552956
19590,231,1805800,2,10,9,13,187,36553187
19591,1379,1805800,1,10,9,14,566,36554566
19592,509,1805700,1,10,9,15,75,36555075
19593,709,1805700,1,10,9,15,784,36555784
19594,239,1805700,2,10,9,16,23,36556023
19595,697,1805900,1,10,9,16,720,36556720
19596,129,1805800,1,10,9,16,849,36556849
19597,685,1805800,1,10,9,17,534,36557534
19598,67,1805900,1,10,9,17,601,36557601
19599,2154,1805900,1,10,9,19,755,36559755
19600,2532,1805900,2,10,9,22,287,36562287
19601,565,1805800,1,10,9,22,852,36562852
19602,2480,1805800,1,10,9,25,332,36565332
19603,2337,1805800,3,10,9,27,669,36567669
19604,3102,1805800,3,10,9,30,771,36570771
19606,1023,1805900,1,10,9,31,794,36571794
19607,846,1805900,1,10,9,32,640,36572640
19608,111,1805800,1,10,9,32,751,36572751
19609,26,1805800,1,10,9,32,777,36572777
19610,2876,1805900,1,10,9,35,653,36575653
19611,126,1805900,2,10,9,35,779,36575779
19612,739,1805800,2,10,9,36,518,36576518
19613,549,1805800,1,10,9,37,67,36577067
19614,2220,1805800,1,10,9,39,287,36579287
19615,252,1805800,1,10,9,39,539,36579539
19616,716,1805900,1,10,9,40,255,36580255
19617,1038,1805800,1,10,9,41,293,36581293
19618,3384,1805800,1,10,9,44,677,36584677
19619,4664,1805800,1,10,9,49,341,36589341
19620,131,1805800,1,10,9,49,472,36589472
19621,1618,1805800,1,10,9,51,90,36591090
19622,721,1805800,1,10,9,51,811,36591811
19623,402,1805800,5,10,9,52,213,36592213
19625,134,1805700,1,10,9,52,347,36592347
19626,4867,1805800,1,10,9,57,214,36597214
19627,59,1805800,1,10,9,57,273,36597273
19628,44,1805900,1,10,9,57,317,36597317
19629,1700,1805900,1,10,9,59,17,36599017
19630,1210,1805800,3,10,10,0,227,36600227
19631,133,1805800,1,10,10,0,360,36600360
19632,44,1805900,1,10,10,0,404,36600404
19633,19,1805800,4,10,10,0,423,36600423
19634,1,1805800,6,10,10,0,424,36600424
19635,65,1805900,1,10,10,0,489,36600489
19636,292,1805800,1,10,10,0,781,36600781
19637,187,1805900,8,10,10,0,968,36600968
19638,359,1805900,2,10,10,1,327,36601327
19639,317,1805900,2,10,10,1,644,36601644
19640,18,1805800,1,10,10,1,662,36601662
19641,122,1805900,1,10,10,1,784,36601784
19642,57,1805900,1,10,10,1,841,36601841
19643,96,1805800,2,10,10,1,937,36601937
19644,60,1805900,1,10,10,1,997,36601997
19645,8,1805900,1,10,10,2,5,36602005
19646,6,1805900,1,10,10,2,11,36602011
19647,23,1805900,5,10,10,2,34,36602034
19648,0,1805900,1,10,10,2,34,36602034
19649,154,1806000,3,10,10,2,188,36602188
19650,177,1806000,1,10,10,2,365,36602365
19651,198,1806000,1,10,10,2,563,36602563
19652,439,1806000,1,10,10,3,2,36603002
19653,5,1806000,1,10,10,3,7,36603007
19654,8,1806000,1,10,10,3,15,36603015
19655,657,1806000,1,10,10,3,672,36603672
19656,258,1806000,2,10,10,3,930,36603930
19657,0,1806000,7,10,10,3,930,36603930
19658,1,1806000,1,10,10,3,931,36603931
19659,0,1806000,3,10,10,3,931,36603931
19660,0,1806000,4,10,10,3,931,36603931
19661,0,1806000,7,10,10,3,931,36603931
19662,85,1806100,1,10,10,4,16,36604016
19663,8,1806100,1,10,10,4,24,36604024
19664,330,1805900,1,10,10,4,354,36604354
19665,3217,1806000,3,10,10,7,571,36607571
19666,248,1806000,1,10,10,7,819,36607819
19667,159,1806000,1,10,10,7,978,36607978
19668,2354,1805900,1,10,10,10,332,36610332
19669,610,1805900,1,10,10,10,942,36610942
19670,128,1806000,1,10,10,11,70,36611070
19671,824,1805900,1,10,10,11,894,36611894
19672,700,1805900,1,10,10,12,594,36612594
19673,327,1806000,5,10,10,12,921,36612921
19674,1,1806000,1,10,10,12,922,36612922
19675,89,1806000,1,10,10,13,11,36613011
19676,2353,1805900,1,10,10,15,364,36615364
19677,1294,1806000,3,10,10,16,658,36616658
19678,1642,1805900,1,10,10,18,300,36618300
19679,727,1806000,1,10,10,19,27,36619027
19680,28,1805900,1,10,10,19,55,36619055
19681,198,1806000,1,10,10,19,253,36619253
19682,1311,1806000,1,10,10,20,564,36620564
19683,181,1805900,1,10,10,20,745,36620745
19684,105,1805900,1,10,10,20,850,36620850
19685,1438,1805900,1,10,10,22,288,36622288
19686,127,1806000,1,10,10,22,415,36622415
19687,1188,1805900,1,10,10,23,603,36623603
19688,636,1806000,1,10,10,24,239,36624239
19689,1851,1806000,2,10,10,26,90,36626090
19690,374,1805900,1,10,10,26,464,36626464
19691,206,1806000,1,10,10,26,670,36626670
19692,278,1806000,3,10,10,26,948,36626948
19693,80,1805900,3,10,10,27,28,36627028
19694,1162,1805900,1,10,10,28,190,36628190
19695,1009,1805900,1,10,10,29,199,36629199
19696,720,1805900,1,10,10,29,919,36629919
19697,4968,1805900,1,10,10,34,887,36634887
19698,7625,1805900,1,10,10,42,512,36642512
19699,1856,1805900,1,10,10,44,368,36644368
19700,3736,1806000,2,10,10,48,104,36648104
19701,160,1805900,1,10,10,48,264,36648264
19702,74,1805900,1,10,10,48,338,36648338
19703,635,1805900,1,10,10,48,973,36648973
19704,295,1806000,10,10,10,49,268,36649268
19705,286,1806000,4,10,10,49,554,36649554
19706,35,1805900,1,10,10,49,589,36649589
19707,2199,1805900,1,10,10,51,788,36651788
19708,1807,1805900,1,10,10,53,595,36653595
19709,197,1805900,1,10,10,53,792,36653792
19710,26,1805900,1,10,10,53,818,36653818
19711,328,1805900,1,10,10,54,146,36654146
19712,1348,1805900,1,10,10,55,494,36655494
19713,502,1805900,1,10,10,55,996,36655996
19714,55,1805900,1,10,10,56,51,36656051
19715,58,1805900,1,10,10,56,109,36656109
19716,64,1805900,1,10,10,56,173,36656173
19717,121,1805900,1,10,10,56,294,36656294
19718,315,1805900,1,10,10,56,609,36656609
19719,68,1805900,1,10,10,56,677,36656677
19720,1728,1805900,1,10,10,58,405,36658405
19721,325,1805900,2,10,10,58,730,36658730
19722,279,1805900,1,10,10,59,9,36659009
19723,1391,1805900,5,10,11,0,400,36660400
19724,1,1805900,1,10,11,0,401,36660401
19725,263,1805800,2,10,11,0,664,36660664
19726,374,1805900,1,10,11,1,38,36661038
19727,29,1805900,1,10,11,1,67,36661067
19728,403,1805900,1,10,11,1,470,36661470
19729,0,1805900,1,10,11,1,470,36661470
19730,3689,1806000,10,10,11,5,159,36665159
19731,1,1806000,4,10,11,5,160,36665160
19732,0,1806000,7,10,11,5,160,36665160
19733,550,1806000,1,10,11,5,710,36665710
19734,1005,1806000,1,10,11,6,715,36666715
19735,597,1806000,1,10,11,7,312,36667312
19736,543,1806000,1,10,11,7,855,36667855
19737,654,1806000,1,10,11,8,509,36668509
19738,66,1806000,1,10,11,8,575,36668575
19739,8,1806000,1,10,11,8,583,36668583
19740,71,1806000,2,10,11,8,654,36668654
19741,1368,1806100,1,10,11,10,22,36670022
19742,269,1806000,1,10,11,10,291,36670291
19743,4346,1806000,2,10,11,14,637,36674637
19744,768,1806100,5,10,11,15,405,36675405
19745,0,1806100,1,10,11,15,405,36675405
19746,0,1806100,4,10,11,15,405,36675405
19747,0,1806100,7,10,11,15,405,36675405
19748,0,1806100,1,10,11,15,405,36675405
19749,0,1806100,6,10,11,15,405,36675405
19750,168,1806100,1,10,11,15,573,36675573
19751,237,1806200,1,10,11,15,810,36675810
19752,55,1806200,1,10,11,15,865,36675865
19753,1,1806200,2,10,11,15,866,36675866
19754,192,1806000,1,10,11,16,58,36676058
19755,76,1806200,1,10,11,16,134,36676134
19756,3,1806200,1,10,11,16,137,36676137
19757,5,1806200,1,10,11,16,142,36676142
19758,578,1806100,1,10,11,16,720,36676720
19759,175,1806200,1,10,11,16,895,36676895
19760,51,1806200,1,10,11,16,946,36676946
19761,58,1806200,1,10,11,17,4,36677004
19762,652,1806200,5,10,11,17,656,36677656
19763,0,1806200,1,10,11,17,656,36677656
19764,288,1806200,1,10,11,17,944,36677944
19765,564,1806300,1,10,11,18,508,36678508
19766,96,1806300,1,10,11,18,604,36678604
19767,18,1806300,1,10,11,18,622,36678622
19768,40,1806300,1,10,11,18,662,36678662
19769,18,1806300,4,10,11,18,680,36678680
19770,27,1806300,2,10,11,18,707,36678707
19771,15,1806300,8,10,11,18,722,36678722
19772,29,1806300,1,10,11,18,751,36678751
19773,21,1806300,3,10,11,18,772,36678772
19774,62,1806200,3,10,11,18,834,36678834
19775,167,1806300,1,10,11,19,1,36679001
19776,75,1806300,1,10,11,19,76,36679076
19777,15,1806300,1,10,11,19,91,36679091
19778,234,1806300,1,10,11,19,325,36679325
19779,2,1806300,1,10,11,19,327,36679327
19780,26,1806300,1,10,11,19,353,36679353
19781,3,1806300,1,10,11,19,356,36679356
19782,333,1806300,1,10,11,19,689,36679689
19783,233,1806300,1,10,11,19,922,36679922
19784,3,1806300,1,10,11,19,925,36679925
19785,3,1806300,1,10,11,19,928,36679928
19786,75,1806300,2,10,11,20,3,36680003
19787,169,1806200,1,10,11,20,172,36680172
19788,313,1806300,1,10,11,20,485,36680485
19789,2,1806300,1,10,11,20,487,36680487
19790,252,1806200,1,10,11,20,739,36680739
19791,1833,1806300,1,10,11,22,572,36682572
19792,126,1806300,4,10,11,22,698,36682698
19793,136,1806300,1,10,11,22,834,36682834
19794,112,1806300,1,10,11,22,946,36682946
19795,56,1806300,1,10,11,23,2,36683002
19796,861,1806300,1,10,11,23,863,36683863
19797,166,1806300,1,10,11,24,29,36684029
19798,52,1806400,10,10,11,24,81,36684081
19799,49,1806400,1,10,11,24,130,36684130
19800,12,1806400,2,10,11,24,142,36684142
19801,11,1806400,2,10,11,24,153,36684153
19802,2,1806400,2,10,11,24,155,36684155
19803,0,1806400,2,10,11,24,155,36684155
19804,29,1806400,2,10,11,24,184,36684184
19805,25,1806400,1,10,11,24,209,36684209
19806,46,1806400,1,10,11,24,255,36684255
19807,30,1806400,1,10,11,24,285,36684285
19808,13,1806400,1,10,11,24,298,36684298
19809,5,1806400,1,10,11,24,303,36684303
19810,173,1806300,1,10,11,24,476,36684476
19811,635,1806300,1,10,11,25,111,36685111
19812,260,1806200,1,10,11,25,371,36685371
19813,67,1806300,1,10,11,25,438,36685438
19814,352,1806300,3,10,11,25,790,36685790
19815,4,1806300,2,10,11,25,794,36685794
19816,109,1806300,1,10,11,25,903,36685903
19817,42,1806300,1,10,11,25,945,36685945
19818,246,1806300,1,10,11,26,191,36686191
19819,203,1806300,2,10,11,26,394,36686394
19820,1,1806300,1,10,11,26,395,36686395
19821,0,1806300,1,10,11,26,395,36686395
19822,218,1806200,2,10,11,26,613,36686613
19823,215,1806300,1,10,11,26,828,36686828
19824,432,1806300,1,10,11,27,260,36687260
19825,39,1806400,1,10,11,27,299,36687299
19826,24,1806400,2,10,11,27,323,36687323
19827,28,1806300,1,10,11,27,351,36687351
19828,148,1806400,1,10,11,27,499,36687499
19829,48,1806400,1,10,11,27,547,36687547
19830,33,1806400,1,10,11,27,580,36687580
19831,41,1806300,1,10,11,27,621,36687621
19832,250,1806300,1,10,11,27,871,36687871
19833,46,1806400,1,10,11,27,917,36687917
19834,19,1806400,2,10,11,27,936,36687936
19835,40,1806400,1,10,11,27,976,36687976
19836,95,1806400,1,10,11,28,71,36688071
19837,238,1806400,1,10,11,28,309,36688309
19838,241,1806400,1,10,11,28,550,36688550
19839,196,1806400,1,10,11,28,746,36688746
19840,61,1806400,1,10,11,28,807,36688807
19841,847,1806400,1,10,11,29,654,36689654
19842,990,1806400,1,10,11,30,644,36690644
19843,398,1806400,1,10,11,31,42,36691042
19844,65,1806400,2,10,11,31,107,36691107
19845,0,1806400,1,10,11,31,107,36691107
19846,1152,1806400,1,10,11,32,259,36692259
19847,1184,1806500,2,10,11,33,443,36693443
19848,35,1806500,1,10,11,33,478,36693478
19849,1,1806500,1,10,11,33,479,36693479
19850,37,1806500,1,10,11,33,516,36693516
19851,27,1806500,1,10,11,33,543,36693543
19852,7,1806500,2,10,11,33,550,36693550
19853,176,1806500,16,10,11,33,726,36693726
19854,1,1806500,4,10,11,33,727,36693727
19855,3,1806500,1,10,11,33,730,36693730
19856,1,1806500,2,10,11,33,731,36693731
19857,0,1806500,4,10,11,33,731,36693731
19858,0,1806500,2,10,11,33,731,36693731
19859,32,1806500,1,10,11,33,763,36693763
19860,0,1806500,1,10,11,33,763,36693763
19861,75,1806500,1,10,11,33,838,36693838
19862,137,1806600,2,10,11,33,975,36693975
19863,124,1806600,3,10,11,34,99,36694099
19864,0,1806600,2,10,11,34,99,36694099
19865,26,1806600,1,10,11,34,125,36694125
19866,36,1806600,1,10,11,34,161,36694161
19867,17,1806600,1,10,11,34,178,36694178
19868,74,1806600,1,10,11,34,252,36694252
19869,12,1806600,1,10,11,34,264,36694264
19870,52,1806600,1,10,11,34,316,36694316
19871,287,1806600,1,10,11,34,603,36694603
19872,302,1806500,3,10,11,34,905,36694905
19873,61,1806500,2,10,11,34,966,36694966
19874,22,1806400,1,10,11,34,988,36694988
19875,12,1806400,1,10,11,35,0,36695000
19876,90,1806400,10,10,11,35,90,36695090
19877,1,1806400,1,10,11,35,91,36695091
19878,168,1806300,2,10,11,35,259,36695259
19879,582,1806200,1,10,11,35,841,36695841
19880,108,1806300,2,10,11,35,949,36695949
19881,128,1806300,1,10,11,36,77,36696077
19882,125,1806300,3,10,11,36,202,36696202
19884,33,1806400,2,10,11,36,235,36696235
19885,162,1806400,1,10,11,36,397,36696397
19886,31,1806400,1,10,11,36,428,36696428
19887,3558,1806300,1,10,11,39,986,36699986
19888,115,1806400,1,10,11,40,101,36700101
19889,92,1806400,2,10,11,40,193,36700193
19890,58,1806400,1,10,11,40,251,36700251
19891,257,1806400,1,10,11,40,508,36700508
19892,300,1806400,2,10,11,40,808,36700808
19893,37,1806400,1,10,11,40,845,36700845
19894,491,1806500,1,10,11,41,336,36701336
19895,1372,1806400,1,10,11,42,708,36702708
19896,1766,1806400,2,10,11,44,474,36704474
19897,465,1806500,1,10,11,44,939,36704939
19898,1831,1806300,1,10,11,46,770,36706770
19899,940,1806300,1,10,11,47,710,36707710
19900,19,1806300,18,10,11,47,729,36707729
19901,1636,1806200,1,10,11,49,365,36709365
19902,159,1806200,1,10,11,49,524,36709524
19903,150,1806200,1,10,11,49,674,36709674
19904,472,1806300,9,10,11,50,146,36710146
19905,1772,1806200,1,10,11,51,918,36711918
19906,611,1806200,1,10,11,52,529,36712529
19907,217,1806300,3,10,11,52,746,36712746
19908,223,1806200,1,10,11,52,969,36712969
19909,919,1806200,1,10,11,53,888,36713888
19910,160,1806200,1,10,11,54,48,36714048
19911,1,1806200,8,10,11,54,49,36714049
19912,3,1806100,6,10,11,54,52,36714052
19913,819,1806200,1,10,11,54,871,36714871
19914,570,1806200,2,10,11,55,441,36715441
19915,321,1806300,1,10,11,55,762,36715762
19916,132,1806300,1,10,11,55,894,36715894
19917,570,1806100,1,10,11,56,464,36716464
19918,638,1806300,5,10,11,57,102,36717102
19919,1141,1806200,1,10,11,58,243,36718243
19920,813,1806300,1,10,11,59,56,36719056
19921,116,1806200,5,10,11,59,172,36719172
19922,727,1806200,1,10,11,59,899,36719899
19923,0,1806200,1,10,11,59,899,36719899
19924,1535,1806300,1,10,12,1,434,36721434
19925,43,1806300,1,10,12,1,477,36721477
19926,0,1806300,2,10,12,1,477,36721477
19927,0,1806300,1,10,12,1,477,36721477
19928,0,1806300,1,10,12,1,477,36721477
19929,0,1806300,3,10,12,1,477,36721477
19930,1,1806300,1,10,12,1,478,36721478
19931,96,1806300,1,10,12,1,574,36721574
19932,43,1806300,2,10,12,1,617,36721617
19934,39,1806100,1,10,12,1,656,36721656
19935,8,1806400,2,10,12,1,664,36721664
19936,27,1806400,4,10,12,1,691,36721691
19937,28,1806400,4,10,12,1,719,36721719
19938,5,1806400,1,10,12,1,724,36721724
19939,22,1806400,4,10,12,1,746,36721746
19940,45,1806400,1,10,12,1,791,36721791
19941,23,1806400,4,10,12,1,814,36721814
19942,11,1806300,1,10,12,1,825,36721825
19943,23,1806400,1,10,12,1,848,36721848
19944,9,1806400,4,10,12,1,857,36721857
19945,3,1806400,1,10,12,1,860,36721860
19946,21,1806400,4,10,12,1,881,36721881
19947,5,1806400,1,10,12,1,886,36721886
19948,8,1806400,1,10,12,1,894,36721894
19949,8,1806400,1,10,12,1,902,36721902
19950,26,1806400,1,10,12,1,928,36721928
19951,21,1806400,1,10,12,1,949,36721949
19952,83,1806400,1,10,12,2,32,36722032
19953,2,1806300,2,10,12,2,34,36722034
19954,67,1806400,1,10,12,2,101,36722101
19955,546,1806400,1,10,12,2,647,36722647
19956,260,1806300,1,10,12,2,907,36722907
19957,0,1806300,1,10,12,2,907,36722907
19958,0,1806300,1,10,12,2,907,36722907
19959,785,1806300,1,10,12,3,692,36723692
19960,258,1806300,1,10,12,3,950,36723950
19961,1961,1806300,1,10,12,5,911,36725911
19962,172,1806200,1,10,12,6,83,36726083
19963,39,1806200,1,10,12,6,122,36726122
19964,233,1806300,2,10,12,6,355,36726355
19965,1284,1806300,1,10,12,7,639,36727639
19966,86,1806400,1,10,12,7,725,36727725
19967,1,1806400,1,10,12,7,726,36727726
19968,50,1806300,1,10,12,7,776,36727776
19969,964,1806400,6,10,12,8,740,36728740
19970,363,1806400,1,10,12,9,103,36729103
19971,922,1806400,3,10,12,10,25,36730025
19972,0,1806400,1,10,12,10,25,36730025
19973,1515,1806400,1,10,12,11,540,36731540
19974,0,1806400,1,10,12,11,540,36731540
19975,59,1806400,3,10,12,11,599,36731599
19976,0,1806400,1,10,12,11,599,36731599
19977,0,1806400,1,10,12,11,599,36731599
19978,688,1806300,1,10,12,12,287,36732287
19979,0,1806300,1,10,12,12,287,36732287
19980,0,1806300,1,10,12,12,287,36732287
19981,857,1806300,1,10,12,13,144,36733144
19982,216,1806300,1,10,12,13,360,36733360
19983,521,1806300,1,10,12,13,881,36733881
19984,160,1806300,2,10,12,14,41,36734041
19985,129,1806300,2,10,12,14,170,36734170
19986,744,1806300,1,10,12,14,914,36734914
19987,285,1806200,1,10,12,15,199,36735199
19988,427,1806200,1,10,12,15,626,36735626
19989,372,1806200,5,10,12,15,998,36735998
19990,152,1806200,1,10,12,16,150,36736150
19991,1079,1806300,1,10,12,17,229,36737229
19992,121,1806300,1,10,12,17,350,36737350
19993,0,1806400,1,10,12,17,350,36737350
19994,0,1806400,1,10,12,17,350,36737350
19995,0,1806400,1,10,12,17,350,36737350
19996,0,1806400,1,10,12,17,350,36737350
19997,1,1806400,1,10,12,17,351,36737351
19998,1,1806400,1,10,12,17,352,36737352
19999,644,1806300,1,10,12,17,996,36737996
20000,326,1806200,1,10,12,18,322,36738322
20001,2133,1806300,1,10,12,20,455,36740455
20002,767,1806200,2,10,12,21,222,36741222
20003,4153,1806200,9,10,12,25,375,36745375
20004,387,1806100,1,10,12,25,762,36745762
20005,324,1806200,1,10,12,26,86,36746086
20006,3639,1806200,1,10,12,29,725,36749725
20007,125,1806300,1,10,12,29,850,36749850
20008,0,1806300,1,10,12,29,850,36749850
20009,0,1806300,1,10,12,29,850,36749850
20010,0,1806300,1,10,12,29,850,36749850
20011,0,1806300,1,10,12,29,850,36749850
20012,1258,1806100,17,10,12,31,108,36751108
20013,1076,1806200,1,10,12,32,184,36752184
20014,241,1806200,1,10,12,32,425,36752425
20015,2743,1806200,2,10,12,35,168,36755168
20016,1700,1806100,1,10,12,36,868,36756868
20017,80,1806100,2,10,12,36,948,36756948
20018,388,1806100,1,10,12,37,336,36757336
20019,15,1806200,1,10,12,37,351,36757351
20020,0,1806200,1,10,12,37,351,36757351
20021,549,1806000,1,10,12,37,900,36757900
20022,1623,1806000,1,10,12,39,523,36759523
20023,955,1806000,1,10,12,40,478,36760478
20024,740,1806100,1,10,12,41,218,36761218
20025,95,1806000,1,10,12,41,313,36761313
20026,100,1806000,1,10,12,41,413,36761413
20027,2075,1806000,1,10,12,43,488,36763488
20028,1,1806000,5,10,12,43,489,36763489
20029,1,1806000,2,10,12,43,490,36763490
20030,0,1806000,2,10,12,43,490,36763490
20031,1,1806000,3,10,12,43,491,36763491
20032,529,1806100,5,10,12,44,20,36764020
20033,564,1805900,1,10,12,44,584,36764584
20034,1298,1805900,1,10,12,45,882,36765882
20035,2090,1805900,23,10,12,47,972,36767972
20036,1283,1805800,2,10,12,49,255,36769255
20037,99,1805800,1,10,12,49,354,36769354
20038,22,1805800,1,10,12,49,376,36769376
20039,51,1805900,1,10,12,49,427,36769427
20040,969,1805900,1,10,12,50,396,36770396
20041,1,1806000,1,10,12,50,397,36770397
20042,0,1806000,1,10,12,50,397,36770397
20043,9,1806000,1,10,12,50,406,36770406
20044,1060,1806100,4,10,12,51,466,36771466
20045,474,1806100,1,10,12,51,940,36771940
20046,1366,1806000,1,10,12,53,306,36773306
20047,208,1806000,1,10,12,53,514,36773514
20048,940,1806100,1,10,12,54,454,36774454
20049,0,1806100,2,10,12,54,454,36774454
20050,2549,1806000,5,10,12,57,3,36777003
20051,1110,1806100,2,10,12,58,113,36778113
20052,213,1806000,1,10,12,58,326,36778326
20053,1522,1806000,1,10,12,59,848,36779848
20054,873,1806000,2,10,13,0,721,36780721
20055,666,1806100,1,10,13,1,387,36781387
20056,31,1806100,1,10,13,1,418,36781418
20057,392,1806200,2,10,13,1,810,36781810
20058,6,1806100,2,10,13,1,816,36781816
20059,180,1806100,1,10,13,1,996,36781996
20060,141,1806200,1,10,13,2,137,36782137
20061,910,1806200,3,10,13,3,47,36783047
20062,26,1806200,1,10,13,3,73,36783073
20063,46,1806200,1,10,13,3,119,36783119
20064,1,1806200,1,10,13,3,120,36783120
20065,22,1806200,1,10,13,3,142,36783142
20066,197,1806200,1,10,13,3,339,36783339
20067,615,1806100,1,10,13,3,954,36783954
20068,1579,1806200,2,10,13,5,533,36785533
20069,0,1806200,1,10,13,5,533,36785533
20070,0,1806200,1,10,13,5,533,36785533
20071,3143,1806200,1,10,13,8,676,36788676
20072,163,1806200,1,10,13,8,839,36788839
20073,5056,1806300,1,10,13,13,895,36793895
20074,436,1806200,1,10,13,14,331,36794331
20075,3975,1806300,2,10,13,18,306,36798306
20076,0,1806300,5,10,13,18,306,36798306
20077,0,1806300,1,10,13,18,306,36798306
20078,1,1806300,1,10,13,18,307,36798307
20079,0,1806300,1,10,13,18,307,36798307
20080,41,1806300,1,10,13,18,348,36798348
20081,20,1806300,1,10,13,18,368,36798368
20082,190,1806300,1,10,13,18,558,36798558
20083,269,1806400,1,10,13,18,827,36798827
20084,429,1806400,19,10,13,19,256,36799256
20085,111,1806400,2,10,13,19,367,36799367
20086,71,1806400,1,10,13,19,438,36799438
20087,11,1806400,1,10,13,19,449,36799449
20088,1267,1806400,5,10,13,20,716,36800716
20090,3346,1806400,1,10,13,24,62,36804062
20091,1062,1806500,16,10,13,25,124,36805124
20092,169,1806600,1,10,13,25,293,36805293
20093,56,1806500,1,10,13,25,349,36805349
20094,124,1806600,1,10,13,25,473,36805473
20095,216,1806600,2,10,13,25,689,36805689
20096,13,1806600,1,10,13,25,702,36805702
20097,19,1806600,7,10,13,25,721,36805721
20098,0,1806600,5,10,13,25,721,36805721
20099,0,1806600,8,10,13,25,721,36805721
20100,18,1806700,1,10,13,25,739,36805739
20101,11,1806600,1,10,13,25,750,36805750
20102,91,1806600,1,10,13,25,841,36805841
20103,6,1806600,1,10,13,25,847,36805847
20104,23,1806700,1,10,13,25,870,36805870
20105,12,1806700,2,10,13,25,882,36805882
20106,22,1806700,4,10,13,25,904,36805904
20107,12,1806700,1,10,13,25,916,36805916
20108,24,1806700,1,10,13,25,940,36805940
20109,5,1806700,1,10,13,25,945,36805945
20110,31,1806700,1,10,13,25,976,36805976
20111,4,1806700,1,10,13,25,980,36805980
20112,9,1806700,1,10,13,25,989,36805989
20113,41,1806700,1,10,13,26,30,36806030
20114,123,1806700,5,10,13,26,153,36806153
20115,77,1806800,9,10,13,26,230,36806230
20116,3,1806800,1,10,13,26,233,36806233
20117,5,1806800,1,10,13,26,238,36806238
20118,20,1806700,1,10,13,26,258,36806258
20119,16,1806800,5,10,13,26,274,36806274
20120,90,1806800,1,10,13,26,364,36806364
20121,19,1806700,2,10,13,26,383,36806383
20122,34,1806800,1,10,13,26,417,36806417
20123,19,1806800,2,10,13,26,436,36806436
20124,17,1806700,1,10,13,26,453,36806453
20125,9,1806700,2,10,13,26,462,36806462
20126,27,1806800,1,10,13,26,489,36806489
20127,103,1806800,1,10,13,26,592,36806592
20128,6,1806800,2,10,13,26,598,36806598
20129,81,1806800,1,10,13,26,679,36806679
20130,259,1806700,1,10,13,26,938,36806938
20131,12,1806800,1,10,13,26,950,36806950
20132,1,1806800,1,10,13,26,951,36806951
20133,129,1806800,1,10,13,27,80,36807080
20134,10,1806700,1,10,13,27,90,36807090
20135,7,1806700,1,10,13,27,97,36807097
20136,106,1806800,1,10,13,27,203,36807203
20137,1,1806800,1,10,13,27,204,36807204
20138,0,1806800,1,10,13,27,204,36807204
20139,107,1806800,1,10,13,27,311,36807311
20140,1691,1806900,1,10,13,29,2,36809002
20141,172,1806900,1,10,13,29,174,36809174
20142,5,1806900,1,10,13,29,179,36809179
20143,1,1806900,1,10,13,29,180,36809180
20144,21,1806800,1,10,13,29,201,36809201
20145,12,1806900,1,10,13,29,213,36809213
20146,149,1806900,4,10,13,29,362,36809362
20147,94,1806900,1,10,13,29,456,36809456
20148,22,1806900,1,10,13,29,478,36809478
20149,16,1806900,4,10,13,29,494,36809494
20150,22,1806900,2,10,13,29,516,36809516
20151,30,1806900,2,10,13,29,546,36809546
20152,159,1806800,2,10,13,29,705,36809705
20153,74,1806800,1,10,13,29,779,36809779
20154,63,1806900,2,10,13,29,842,36809842
20155,447,1806800,1,10,13,30,289,36810289
20156,230,1806800,3,10,13,30,519,36810519
20157,180,1806900,1,10,13,30,699,36810699
20158,224,1806700,1,10,13,30,923,36810923
20159,72,1806900,2,10,13,30,995,36810995
20160,354,1806900,1,10,13,31,349,36811349
20161,35,1806900,1,10,13,31,384,36811384
20162,232,1806900,1,10,13,31,616,36811616
20163,129,1806800,1,10,13,31,745,36811745
20164,1036,1806800,1,10,13,32,781,36812781
20165,341,1806900,2,10,13,33,122,36813122
20166,89,1806900,1,10,13,33,211,36813211
20167,812,1806800,2,10,13,34,23,36814023
20168,0,1806800,1,10,13,34,23,36814023
20169,78,1806800,3,10,13,34,101,36814101
20170,2,1806800,1,10,13,34,103,36814103
20171,29,1806800,1,10,13,34,132,36814132
20172,94,1806900,12,10,13,34,226,36814226
20173,9,1806900,1,10,13,34,235,36814235
20174,171,1806900,3,10,13,34,406,36814406
20175,195,1806900,2,10,13,34,601,36814601
20176,37,1806900,3,10,13,34,638,36814638
20177,223,1806700,1,10,13,34,861,36814861
20178,384,1806700,1,10,13,35,245,36815245
20179,565,1806800,9,10,13,35,810,36815810
20180,71,1806800,1,10,13,35,881,36815881
20181,1190,1806800,4,10,13,37,71,36817071
20182,59,1806900,2,10,13,37,130,36817130
20183,116,1806900,1,10,13,37,246,36817246
20184,150,1806800,1,10,13,37,396,36817396
20185,285,1806900,4,10,13,37,681,36817681
20186,269,1806800,2,10,13,37,950,36817950
20187,174,1806900,1,10,13,38,124,36818124
20188,195,1806900,4,10,13,38,319,36818319
20189,0,1806900,10,10,13,38,319,36818319
20190,0,1806900,2,10,13,38,319,36818319
20191,0,1806900,2,10,13,38,319,36818319
20192,0,1806900,2,10,13,38,319,36818319
20193,27,1806900,1,10,13,38,346,36818346
20194,27,1806900,5,10,13,38,373,36818373
20195,125,1806900,7,10,13,38,498,36818498
20196,678,1807000,1,10,13,39,176,36819176
20197,101,1806900,1,10,13,39,277,36819277
20198,2,1807000,2,10,13,39,279,36819279
20199,8,1807000,2,10,13,39,287,36819287
20200,13,1807000,1,10,13,39,300,36819300
20201,51,1807000,15,10,13,39,351,36819351
20202,1,1807000,3,10,13,39,352,36819352
20203,0,1807000,1,10,13,39,352,36819352
20204,0,1807000,2,10,13,39,352,36819352
20205,0,1807000,3,10,13,39,352,36819352
20206,0,1807000,6,10,13,39,352,36819352
20207,0,1807000,1,10,13,39,352,36819352
20208,0,1807000,1,10,13,39,352,36819352
20209,0,1807000,2,10,13,39,352,36819352
20210,0,1807000,1,10,13,39,352,36819352
20211,0,1807000,1,10,13,39,352,36819352
20212,0,1807000,5,10,13,39,352,36819352
20213,51,1807100,1,10,13,39,403,36819403
20214,90,1806900,1,10,13,39,493,36819493
20215,85,1807100,4,10,13,39,578,36819578
20216,410,1807000,1,10,13,39,988,36819988
20217,8,1807000,4,10,13,39,996,36819996
20219,39,1807100,1,10,13,40,35,36820035
20220,110,1807100,2,10,13,40,145,36820145
20221,247,1807100,1,10,13,40,392,36820392
20222,127,1807000,1,10,13,40,519,36820519
20223,86,1807100,1,10,13,40,605,36820605
20224,21,1807100,1,10,13,40,626,36820626
20225,70,1807100,2,10,13,40,696,36820696
20226,21,1807000,1,10,13,40,717,36820717
20227,15,1807100,1,10,13,40,732,36820732
20228,19,1807100,1,10,13,40,751,36820751
20229,84,1807100,1,10,13,40,835,36820835
20230,4,1807000,2,10,13,40,839,36820839
20231,11,1807100,1,10,13,40,850,36820850
20232,97,1807000,1,10,13,40,947,36820947
20233,198,1807100,1,10,13,41,145,36821145
20234,65,1807100,1,10,13,41,210,36821210
20235,388,1807100,1,10,13,41,598,36821598
20236,24,1807200,1,10,13,41,622,36821622
20237,41,1807200,1,10,13,41,663,36821663
20238,0,1807200,1,10,13,41,663,36821663
20239,18,1807100,1,10,13,41,681,36821681
20240,314,1807100,2,10,13,41,995,36821995
20241,52,1807200,1,10,13,42,47,36822047
20242,33,1807000,2,10,13,42,80,36822080
20243,362,1807100,1,10,13,42,442,36822442
20244,89,1807000,1,10,13,42,531,36822531
20245,230,1807000,1,10,13,42,761,36822761
20246,177,1807200,1,10,13,42,938,36822938
20247,64,1807000,5,10,13,43,2,36823002
20248,465,1807000,1,10,13,43,467,36823467
20249,409,1807100,1,10,13,43,876,36823876
20250,371,1807100,1,10,13,44,247,36824247
20251,127,1807100,1,10,13,44,374,36824374
20252,499,1807100,1,10,13,44,873,36824873
20253,92,1807200,1,10,13,44,965,36824965
20254,743,1807100,1,10,13,45,708,36825708
20255,9,1807200,5,10,13,45,717,36825717
20256,32,1807100,1,10,13,45,749,36825749
20257,114,1807100,6,10,13,45,863,36825863
20259,2,1806900,1,10,13,45,865,36825865
20260,0,1806900,3,10,13,45,865,36825865
20261,114,1806900,1,10,13,45,979,36825979
20262,100,1806900,1,10,13,46,79,36826079
20263,87,1806900,2,10,13,46,166,36826166
20264,72,1806900,1,10,13,46,238,36826238
20265,335,1806900,4,10,13,46,573,36826573
20267,48,1806900,1,10,13,46,621,36826621
20268,545,1806800,1,10,13,47,166,36827166
20269,319,1807000,1,10,13,47,485,36827485
20270,78,1806900,1,10,13,47,563,36827563
20271,163,1807000,1,10,13,47,726,36827726
20272,3,1807000,5,10,13,47,729,36827729
20273,116,1806800,2,10,13,47,845,36827845
20274,188,1806800,1,10,13,48,33,36828033
20275,168,1806900,2,10,13,48,201,36828201
20276,75,1806800,1,10,13,48,276,36828276
20277,850,1806900,1,10,13,49,126,36829126
20278,122,1806800,2,10,13,49,248,36829248
20279,281,1807000,1,10,13,49,529,36829529
20280,1064,1806800,1,10,13,50,593,36830593
20281,333,1807000,1,10,13,50,926,36830926
20282,108,1807000,1,10,13,51,34,36831034
20283,56,1806800,1,10,13,51,90,36831090
20284,176,1806900,1,10,13,51,266,36831266
20286,496,1806900,1,10,13,51,762,36831762
20287,438,1806900,1,10,13,52,200,36832200
20288,1835,1806900,2,10,13,54,35,36834035
20289,190,1806900,4,10,13,54,225,36834225
20290,259,1806900,1,10,13,54,484,36834484
20291,254,1806900,1,10,13,54,738,36834738
20292,814,1806900,1,10,13,55,552,36835552
20293,659,1806800,1,10,13,56,211,36836211
20294,63,1806900,1,10,13,56,274,36836274
20295,1253,1806800,1,10,13,57,527,36837527
20296,1799,1806900,1,10,13,59,326,36839326
20297,884,1806900,1,10,14,0,210,36840210
20298,330,1806800,2,10,14,0,540,36840540
20299,19,1807000,1,10,14,0,559,36840559
20300,11,1807000,6,10,14,0,570,36840570
20301,72,1806900,1,10,14,0,642,36840642
20302,586,1806900,1,10,14,1,228,36841228
20303,165,1806900,1,10,14,1,393,36841393
20304,183,1806900,2,10,14,1,576,36841576
20305,187,1806800,1,10,14,1,763,36841763
20306,22,1806800,1,10,14,1,785,36841785
20307,784,1806900,1,10,14,2,569,36842569
20308,991,1806900,1,10,14,3,560,36843560
20309,781,1806800,2,10,14,4,341,36844341
20310,124,1806900,1,10,14,4,465,36844465
20311,2526,1807000,1,10,14,6,991,36846991
20312,24,1806800,2,10,14,7,15,36847015
20313,92,1806900,1,10,14,7,107,36847107
20314,544,1807000,1,10,14,7,651,36847651
20315,226,1806900,1,10,14,7,877,36847877
20316,520,1807000,3,10,14,8,397,36848397
20317,338,1806900,1,10,14,8,735,36848735
20318,487,1807000,1,10,14,9,222,36849222
20319,457,1806900,1,10,14,9,679,36849679
20320,201,1806900,1,10,14,9,880,36849880
20321,120,1807000,1,10,14,10,0,36850000
20322,422,1807000,1,10,14,10,422,36850422
20323,114,1807000,1,10,14,10,536,36850536
20324,88,1807000,1,10,14,10,624,36850624
20325,0,1807000,12,10,14,10,624,36850624
20326,0,1807000,4,10,14,10,624,36850624
20327,0,1807000,8,10,14,10,624,36850624
20328,0,1807000,1,10,14,10,624,36850624
20329,0,1807000,1,10,14,10,624,36850624
20330,0,1807000,1,10,14,10,624,36850624
20331,0,1807000,1,10,14,10,624,36850624
20332,1,1807000,1,10,14,10,625,36850625
20333,0,1807000,12,10,14,10,625,36850625
20334,0,1807000,1,10,14,10,625,36850625
20335,0,1807000,1,10,14,10,625,36850625
20336,0,1807000,1,10,14,10,625,36850625
20337,0,1807000,22,10,14,10,625,36850625
20338,0,1807000,1,10,14,10,625,36850625
20339,0,1807000,1,10,14,10,625,36850625
20340,0,1807000,1,10,14,10,625,36850625
20341,0,1807000,2,10,14,10,625,36850625
20342,258,1807100,2,10,14,10,883,36850883
20343,1,1807100,1,10,14,10,884,36850884
20344,0,1807100,1,10,14,10,884,36850884
20345,0,1807100,2,10,14,10,884,36850884
20346,0,1807100,2,10,14,10,884,36850884
20347,360,1807200,6,10,14,11,244,36851244
20348,211,1807100,1,10,14,11,455,36851455
20349,604,1807100,1,10,14,12,59,36852059
20350,714,1807200,1,10,14,12,773,36852773
20351,155,1807200,3,10,14,12,928,36852928
20352,125,1807200,3,10,14,13,53,36853053
20353,170,1807100,1,10,14,13,223,36853223
20354,17,1807100,1,10,14,13,240,36853240
20355,2,1807100,1,10,14,13,242,36853242
20356,387,1807200,2,10,14,13,629,36853629
20357,1071,1807100,1,10,14,14,700,36854700
20358,0,1807100,3,10,14,14,700,36854700
20359,388,1807100,4,10,14,15,88,36855088
20360,297,1807200,1,10,14,15,385,36855385
20361,51,1807100,1,10,14,15,436,36855436
20362,640,1807200,1,10,14,16,76,36856076
20363,378,1807200,1,10,14,16,454,36856454
20364,558,1807000,2,10,14,17,12,36857012
20365,54,1807000,2,10,14,17,66,36857066
20366,1076,1807000,1,10,14,18,142,36858142
20367,225,1807000,1,10,14,18,367,36858367
20368,2540,1807000,1,10,14,20,907,36860907
20369,435,1807000,1,10,14,21,342,36861342
20370,801,1807000,1,10,14,22,143,36862143
20371,3116,1807100,2,10,14,25,259,36865259
20372,7,1807000,1,10,14,25,266,36865266
20373,781,1807100,2,10,14,26,47,36866047
20374,14,1807100,1,10,14,26,61,36866061
20376,481,1807100,1,10,14,26,542,36866542
20377,2458,1807100,1,10,14,29,0,36869000
20378,1121,1807100,2,10,14,30,121,36870121
20379,413,1807200,2,10,14,30,534,36870534
20380,313,1807000,4,10,14,30,847,36870847
20381,171,1807000,1,10,14,31,18,36871018
20382,124,1807000,1,10,14,31,142,36871142
20383,453,1807000,1,10,14,31,595,36871595
20384,598,1807000,1,10,14,32,193,36872193
20385,221,1807000,3,10,14,32,414,36872414
20386,89,1807100,3,10,14,32,503,36872503
20387,459,1807100,1,10,14,32,962,36872962
20388,504,1807100,1,10,14,33,466,36873466
20390,266,1807200,2,10,14,33,732,36873732
20391,94,1807200,2,10,14,33,826,36873826
20392,1027,1807100,1,10,14,34,853,36874853
20393,376,1807200,2,10,14,35,229,36875229
20394,1457,1807100,1,10,14,36,686,36876686
20395,393,1807100,1,10,14,37,79,36877079
20396,90,1807100,2,10,14,37,169,36877169
20397,486,1807100,1,10,14,37,655,36877655
20398,63,1807100,2,10,14,37,718,36877718
20399,2177,1807000,1,10,14,39,895,36879895
20400,394,1807100,2,10,14,40,289,36880289
20401,844,1807000,5,10,14,41,133,36881133
20402,0,1807000,1,10,14,41,133,36881133
20403,0,1807000,4,10,14,41,133,36881133
20404,0,1807000,2,10,14,41,133,36881133
20405,2552,1807100,1,10,14,43,685,36883685
20406,47,1807000,1,10,14,43,732,36883732
20407,355,1807000,1,10,14,44,87,36884087
20408,1818,1807100,1,10,14,45,905,36885905
20409,599,1807100,4,10,14,46,504,36886504
20410,0,1807100,1,10,14,46,504,36886504
20411,0,1807100,2,10,14,46,504,36886504
20412,1593,1807100,1,10,14,48,97,36888097
20413,1,1807100,1,10,14,48,98,36888098
20414,1144,1807100,2,10,14,49,242,36889242
20415,266,1807000,1,10,14,49,508,36889508
20416,751,1807200,1,10,14,50,259,36890259
20417,1247,1807200,5,10,14,51,506,36891506
20418,0,1807200,7,10,14,51,506,36891506
20419,0,1807200,1,10,14,51,506,36891506
20420,0,1807200,1,10,14,51,506,36891506
20421,0,1807200,1,10,14,51,506,36891506
20422,0,1807200,1,10,14,51,506,36891506
20423,0,1807200,2,10,14,51,506,36891506
20424,0,1807200,2,10,14,51,506,36891506
20425,0,1807200,1,10,14,51,506,36891506
20426,0,1807200,1,10,14,51,506,36891506
20427,0,1807200,1,10,14,51,506,36891506
20428,397,1807100,1,10,14,51,903,36891903
20429,1981,1807100,1,10,14,53,884,36893884
20430,563,1807100,1,10,14,54,447,36894447
20431,1026,1807200,1,10,14,55,473,36895473
20432,1251,1807200,2,10,14,56,724,36896724
20433,19,1807300,1,10,14,56,743,36896743
20434,194,1807300,1,10,14,56,937,36896937
20435,2,1807300,1,10,14,56,939,36896939
20436,6,1807300,1,10,14,56,945,36896945
20437,8,1807300,1,10,14,56,953,36896953
20438,3,1807300,1,10,14,56,956,36896956
20439,10,1807300,1,10,14,56,966,36896966
20440,1,1807300,1,10,14,56,967,36896967
20441,1,1807300,1,10,14,56,968,36896968
20442,5,1807300,1,10,14,56,973,36896973
20443,10,1807200,1,10,14,56,983,36896983
20444,2,1807300,1,10,14,56,985,36896985
20445,24,1807300,1,10,14,57,9,36897009
20446,64,1807200,4,10,14,57,73,36897073
20447,19,1807200,2,10,14,57,92,36897092
20448,83,1807200,2,10,14,57,175,36897175
20449,0,1807200,1,10,14,57,175,36897175
20450,29,1807200,1,10,14,57,204,36897204
20451,17,1807200,1,10,14,57,221,36897221
20452,0,1807200,1,10,14,57,221,36897221
20453,13,1807200,1,10,14,57,234,36897234
20454,4,1807200,1,10,14,57,238,36897238
20455,5,1807200,1,10,14,57,243,36897243
20456,59,1807200,2,10,14,57,302,36897302
20457,7,1807200,1,10,14,57,309,36897309
20458,330,1807200,1,10,14,57,639,36897639
20459,484,1807200,1,10,14,58,123,36898123
20460,724,1807100,1,10,14,58,847,36898847
20461,1422,1807200,2,10,15,0,269,36900269
20462,234,1807200,2,10,15,0,503,36900503
20463,1,1807200,2,10,15,0,504,36900504
20464,0,1807300,7,10,15,0,504,36900504
20465,2,1807300,2,10,15,0,506,36900506
20466,0,1807300,3,10,15,0,506,36900506
20467,0,1807300,6,10,15,0,506,36900506
20468,9,1807300,1,10,15,0,515,36900515
20470,1,1807400,2,10,15,0,516,36900516
20471,0,1807400,7,10,15,0,516,36900516
20472,0,1807400,2,10,15,0,516,36900516
20473,12,1807400,4,10,15,0,528,36900528
20474,25,1807400,1,10,15,0,553,36900553
20475,8,1807300,1,10,15,0,561,36900561
20477,8,1807200,1,10,15,0,569,36900569
20478,22,1807200,1,10,15,0,591,36900591
20479,4,1807200,1,10,15,0,595,36900595
20480,49,1807300,1,10,15,0,644,36900644
20481,19,1807300,1,10,15,0,663,36900663
20482,8,1807300,2,10,15,0,671,36900671
20483,29,1807300,1,10,15,0,700,36900700
20484,8,1807300,2,10,15,0,708,36900708
20485,13,1807300,1,10,15,0,721,36900721
20486,26,1807300,2,10,15,0,747,36900747
20487,11,1807400,1,10,15,0,758,36900758
20488,8,1807400,1,10,15,0,766,36900766
20489,3,1807400,2,10,15,0,769,36900769
20490,17,1807400,1,10,15,0,786,36900786
20491,20,1807400,1,10,15,0,806,36900806
20492,16,1807300,2,10,15,0,822,36900822
20493,5,1807400,2,10,15,0,827,36900827
20494,0,1807400,2,10,15,0,827,36900827
20495,11,1807400,2,10,15,0,838,36900838
20496,2,1807400,2,10,15,0,840,36900840
20497,0,1807400,2,10,15,0,840,36900840
20498,18,1807200,1,10,15,0,858,36900858
20499,14,1807400,1,10,15,0,872,36900872
20500,6,1807200,1,10,15,0,878,36900878
20501,20,1807400,1,10,15,0,898,36900898
20502,46,1807200,2,10,15,0,944,36900944
20503,16,1807300,1,10,15,0,960,36900960
20504,11,1807100,1,10,15,0,971,36900971
20505,13,1807100,1,10,15,0,984,36900984
20506,25,1807300,2,10,15,1,9,36901009
20507,22,1807300,1,10,15,1,31,36901031
20508,10,1807300,1,10,15,1,41,36901041
20509,6,1807300,1,10,15,1,47,36901047
20510,41,1807300,1,10,15,1,88,36901088
20512,13,1807300,1,10,15,1,101,36901101
20513,0,1807300,1,10,15,1,101,36901101
20514,40,1807300,2,10,15,1,141,36901141
20516,1,1807200,5,10,15,1,142,36901142
20517,11,1807300,1,10,15,1,153,36901153
20518,21,1807300,1,10,15,1,174,36901174
20519,46,1807300,1,10,15,1,220,36901220
20520,70,1807300,1,10,15,1,290,36901290
20521,114,1807200,1,10,15,1,404,36901404
20523,33,1807300,1,10,15,1,437,36901437
20524,10,1807100,1,10,15,1,447,36901447
20525,40,1807300,1,10,15,1,487,36901487
20526,17,1807300,2,10,15,1,504,36901504
20527,6,1807300,1,10,15,1,510,36901510
20528,4,1807300,1,10,15,1,514,36901514
20529,39,1807300,2,10,15,1,553,36901553
20530,19,1807100,3,10,15,1,572,36901572
20531,10,1807300,1,10,15,1,582,36901582
20532,6,1807300,1,10,15,1,588,36901588
20533,42,1807300,1,10,15,1,630,36901630
20534,5,1807300,2,10,15,1,635,36901635
20535,2,1807300,1,10,15,1,637,36901637
20536,4,1807300,1,10,15,1,641,36901641
20537,15,1807300,2,10,15,1,656,36901656
20538,0,1807300,1,10,15,1,656,36901656
20539,8,1807300,2,10,15,1,664,36901664
20540,0,1807300,1,10,15,1,664,36901664
20541,0,1807300,1,10,15,1,664,36901664
20542,0,1807200,1,10,15,1,664,36901664
20543,13,1807300,5,10,15,1,677,36901677
20544,1,1807200,1,10,15,1,678,36901678
20545,8,1807300,2,10,15,1,686,36901686
20546,4,1807400,2,10,15,1,690,36901690
20547,14,1807400,1,10,15,1,704,36901704
20548,28,1807400,4,10,15,1,732,36901732
20549,5,1807400,2,10,15,1,737,36901737
20550,18,1807400,1,10,15,1,755,36901755
20551,28,1807400,1,10,15,1,783,36901783
20552,54,1807400,1,10,15,1,837,36901837
20553,19,1807200,1,10,15,1,856,36901856
20554,18,1807200,1,10,15,1,874,36901874
20555,18,1807400,1,10,15,1,892,36901892
20556,29,1807400,2,10,15,1,921,36901921
20557,75,1807200,2,10,15,1,996,36901996
20558,3,1807200,3,10,15,1,999,36901999
20559,1,1807200,1,10,15,2,0,36902000
20560,18,1807400,1,10,15,2,18,36902018
20561,326,1807100,1,10,15,2,344,36902344
20562,186,1807100,2,10,15,2,530,36902530
20563,125,1807100,6,10,15,2,655,36902655
20564,41,1807100,2,10,15,2,696,36902696
20565,5,1807000,2,10,15,2,701,36902701
20566,51,1807000,1,10,15,2,752,36902752
20567,5,1807000,1,10,15,2,757,36902757
20568,54,1807000,18,10,15,2,811,36902811
20569,195,1806900,2,10,15,3,6,36903006
20570,35,1806900,1,10,15,3,41,36903041
20571,18,1806900,1,10,15,3,59,36903059
20572,22,1806900,2,10,15,3,81,36903081
20573,46,1807000,3,10,15,3,127,36903127
20574,61,1807000,1,10,15,3,188,36903188
20575,16,1807100,1,10,15,3,204,36903204
20576,126,1807100,1,10,15,3,330,36903330
20577,9,1807100,1,10,15,3,339,36903339
20578,43,1806900,1,10,15,3,382,36903382
20579,29,1806900,1,10,15,3,411,36903411
20580,7,1806900,1,10,15,3,418,36903418
20581,73,1807000,1,10,15,3,491,36903491
20582,203,1807100,2,10,15,3,694,36903694
20583,689,1807000,1,10,15,4,383,36904383
20584,311,1806900,4,10,15,4,694,36904694
20585,222,1807100,1,10,15,4,916,36904916
20586,428,1807100,1,10,15,5,344,36905344
20587,227,1807100,1,10,15,5,571,36905571
20588,24,1807100,1,10,15,5,595,36905595
20589,358,1807100,1,10,15,5,953,36905953
20590,34,1807100,1,10,15,5,987,36905987
20591,1078,1807000,1,10,15,7,65,36907065
20592,116,1807000,1,10,15,7,181,36907181
20593,297,1807000,1,10,15,7,478,36907478
20594,62,1807000,4,10,15,7,540,36907540
20596,512,1806900,1,10,15,8,52,36908052
20597,246,1807000,3,10,15,8,298,36908298
20598,1469,1806900,1,10,15,9,767,36909767
20599,0,1806900,1,10,15,9,767,36909767
20600,0,1806900,1,10,15,9,767,36909767
20601,0,1806900,6,10,15,9,767,36909767
20602,0,1806900,3,10,15,9,767,36909767
20603,1192,1806800,1,10,15,10,959,36910959
20604,33,1806800,1,10,15,10,992,36910992
20605,83,1806800,2,10,15,11,75,36911075
20606,1,1806800,27,10,15,11,76,36911076
20607,156,1806900,1,10,15,11,232,36911232
20608,391,1806800,1,10,15,11,623,36911623
20609,1321,1806700,1,10,15,12,944,36912944
20610,106,1806800,3,10,15,13,50,36913050
20612,706,1806700,4,10,15,13,756,36913756
20613,589,1806700,1,10,15,14,345,36914345
20614,211,1806900,1,10,15,14,556,36914556
20615,13,1806700,1,10,15,14,569,36914569
20616,123,1806700,1,10,15,14,692,36914692
20617,529,1806800,1,10,15,15,221,36915221
20618,460,1806900,2,10,15,15,681,36915681
20619,78,1806800,1,10,15,15,759,36915759
20620,705,1806900,1,10,15,16,464,36916464
20621,2004,1806800,1,10,15,18,468,36918468
20622,7,1806900,1,10,15,18,475,36918475
20623,2506,1806800,1,10,15,20,981,36920981
20624,173,1806700,3,10,15,21,154,36921154
20625,861,1806600,1,10,15,22,15,36922015
20626,1125,1806600,1,10,15,23,140,36923140
20627,767,1806700,1,10,15,23,907,36923907
20628,234,1806700,1,10,15,24,141,36924141
20629,127,1806800,3,10,15,24,268,36924268
20630,281,1806700,1,10,15,24,549,36924549
20631,1173,1806800,1,10,15,25,722,36925722
20632,0,1806800,1,10,15,25,722,36925722
20633,374,1806800,1,10,15,26,96,36926096
20634,127,1806900,1,10,15,26,223,36926223
20635,804,1806700,2,10,15,27,27,36927027
20636,73,1806900,1,10,15,27,100,36927100
20637,752,1806800,1,10,15,27,852,36927852
20638,187,1806700,2,10,15,28,39,36928039
20639,44,1806700,2,10,15,28,83,36928083
20640,1944,1806700,1,10,15,30,27,36930027
20641,812,1806800,1,10,15,30,839,36930839
20642,302,1806800,2,10,15,31,141,36931141
20643,26,1806900,2,10,15,31,167,36931167
20644,351,1806900,2,10,15,31,518,36931518
20645,85,1806800,1,10,15,31,603,36931603
20646,97,1806900,1,10,15,31,700,36931700
20647,96,1806900,1,10,15,31,796,36931796
20648,267,1806800,1,10,15,32,63,36932063
20649,39,1806900,1,10,15,32,102,36932102
20650,1814,1806700,1,10,15,33,916,36933916
20651,1666,1806800,1,10,15,35,582,36935582
20652,996,1806700,1,10,15,36,578,36936578
20653,607,1806700,3,10,15,37,185,36937185
20654,1681,1806700,5,10,15,38,866,36938866
20655,964,1806800,4,10,15,39,830,36939830
20656,0,1806800,3,10,15,39,830,36939830
20657,125,1806800,1,10,15,39,955,36939955
20658,199,1806700,1,10,15,40,154,36940154
20659,880,1806900,4,10,15,41,34,36941034
20660,1,1806900,9,10,15,41,35,36941035
20661,33,1807000,1,10,15,41,68,36941068
20662,0,1807000,1,10,15,41,68,36941068
20663,8,1806900,1,10,15,41,76,36941076
20664,742,1807000,4,10,15,41,818,36941818
20665,0,1807000,1,10,15,41,818,36941818
20666,0,1807000,1,10,15,41,818,36941818
20667,1,1807000,1,10,15,41,819,36941819
20668,0,1807000,1,10,15,41,819,36941819
20669,1,1807000,12,10,15,41,820,36941820
20670,0,1807000,8,10,15,41,820,36941820
20671,0,1807000,1,10,15,41,820,36941820
20672,0,1807000,1,10,15,41,820,36941820
20673,0,1807000,8,10,15,41,820,36941820
20674,1,1807000,1,10,15,41,821,36941821
20675,0,1807000,2,10,15,41,821,36941821
20676,0,1807000,1,10,15,41,821,36941821
20677,24,1806900,1,10,15,41,845,36941845
20678,1,1807000,9,10,15,41,846,36941846
20679,134,1807000,1,10,15,41,980,36941980
20680,295,1807000,1,10,15,42,275,36942275
20681,1861,1806800,1,10,15,44,136,36944136
20682,494,1806800,1,10,15,44,630,36944630
20683,3870,1806900,3,10,15,48,500,36948500
20684,576,1806900,1,10,15,49,76,36949076
20685,569,1807000,1,10,15,49,645,36949645
20686,81,1807000,1,10,15,49,726,36949726
20687,404,1807000,1,10,15,50,130,36950130
20688,219,1807000,1,10,15,50,349,36950349
20689,532,1807000,1,10,15,50,881,36950881
20690,1020,1807000,1,10,15,51,901,36951901
20691,10,1806900,1,10,15,51,911,36951911
20692,815,1807000,4,10,15,52,726,36952726
20693,892,1806900,1,10,15,53,618,36953618
20694,1173,1806900,2,10,15,54,791,36954791
20695,653,1807000,4,10,15,55,444,36955444
20696,683,1807100,2,10,15,56,127,36956127
20697,76,1807100,2,10,15,56,203,36956203
20698,234,1807000,4,10,15,56,437,36956437
20699,1,1807000,1,10,15,56,438,36956438
20700,465,1807000,1,10,15,56,903,36956903
20701,463,1807000,1,10,15,57,366,36957366
20702,360,1807000,2,10,15,57,726,36957726
20703,302,1806900,1,10,15,58,28,36958028
20704,609,1806900,1,10,15,58,637,36958637
20705,1495,1807000,1,10,16,0,132,36960132
20706,39,1807000,1,10,16,0,171,36960171
20707,322,1807100,2,10,16,0,493,36960493
20708,193,1807100,2,10,16,0,686,36960686
20709,10,1807100,1,10,16,0,696,36960696
20710,1056,1807100,1,10,16,1,752,36961752
20711,386,1807100,1,10,16,2,138,36962138
20712,113,1807100,2,10,16,2,251,36962251
20713,293,1807100,1,10,16,2,544,36962544
20714,3217,1807000,1,10,16,5,761,36965761
20715,0,1807000,3,10,16,5,761,36965761
20716,0,1807000,2,10,16,5,761,36965761
20717,298,1807100,2,10,16,6,59,36966059
20718,1367,1806900,1,10,16,7,426,36967426
20719,2220,1807000,2,10,16,9,646,36969646
20720,1980,1806900,2,10,16,11,626,36971626
20721,479,1806900,1,10,16,12,105,36972105
20722,0,1806900,2,10,16,12,105,36972105
20723,161,1806900,1,10,16,12,266,36972266
20724,1320,1806900,1,10,16,13,586,36973586
20725,74,1806900,2,10,16,13,660,36973660
20726,630,1806900,2,10,16,14,290,36974290
20727,0,1806900,1,10,16,14,290,36974290
20728,22,1806800,2,10,16,14,312,36974312
20729,0,1806800,1,10,16,14,312,36974312
20730,0,1806800,1,10,16,14,312,36974312
20731,0,1806800,27,10,16,14,312,36974312
20732,0,1806800,1,10,16,14,312,36974312
20733,1,1806800,3,10,16,14,313,36974313
20734,0,1806800,4,10,16,14,313,36974313
20735,149,1806900,1,10,16,14,462,36974462
20736,759,1806900,1,10,16,15,221,36975221
20737,2912,1806700,1,10,16,18,133,36978133
20738,1245,1806900,2,10,16,19,378,36979378
20739,3295,1806800,1,10,16,22,673,36982673
20740,1040,1806700,2,10,16,23,713,36983713
20741,385,1806800,1,10,16,24,98,36984098
20742,4810,1806700,1,10,16,28,908,36988908
20743,7,1806700,2,10,16,28,915,36988915
20744,325,1806700,1,10,16,29,240,36989240
20745,847,1806700,1,10,16,30,87,36990087
20746,1193,1806700,1,10,16,31,280,36991280
20747,915,1806800,1,10,16,32,195,36992195
20748,1,1806800,3,10,16,32,196,36992196
20749,0,1806800,4,10,16,32,196,36992196
20750,0,1806800,1,10,16,32,196,36992196
20751,216,1806800,1,10,16,32,412,36992412
20752,1316,1806800,1,10,16,33,728,36993728
20753,466,1806900,1,10,16,34,194,36994194
20754,1555,1806900,1,10,16,35,749,36995749
20755,812,1806900,1,10,16,36,561,36996561
20756,378,1806900,1,10,16,36,939,36996939
20757,2388,1806900,3,10,16,39,327,36999327
20758,53,1806900,1,10,16,39,380,36999380
20759,129,1806900,1,10,16,39,509,36999509
20760,2363,1806800,1,10,16,41,872,37001872
20761,781,1806800,3,10,16,42,653,37002653
20762,131,1806700,1,10,16,42,784,37002784
20763,1176,1806800,1,10,16,43,960,37003960
20764,419,1806900,3,10,16,44,379,37004379
20765,1566,1806900,1,10,16,45,945,37005945
20766,3506,1806800,1,10,16,49,451,37009451
20767,182,1806800,2,10,16,49,633,37009633
20769,1739,1806900,3,10,16,51,372,37011372
20770,119,1806900,1,10,16,51,491,37011491
20771,1588,1806800,1,10,16,53,79,37013079
20772,9141,1806900,3,10,17,2,220,37022220
20773,628,1807000,1,10,17,2,848,37022848
20774,1686,1806900,1,10,17,4,534,37024534
20775,3533,1806900,1,10,17,8,67,37028067
20776,1944,1806900,1,10,17,10,11,37030011
20777,0,1806900,3,10,17,10,11,37030011
20778,4154,1806800,8,10,17,14,165,37034165
20779,124,1806800,1,10,17,14,289,37034289
20780,4894,1806800,1,10,17,19,183,37039183
20781,6161,1806800,1,10,17,25,344,37045344
20782,155,1806800,1,10,17,25,499,37045499
20783,4539,1806700,1,10,17,30,38,37050038
20784,0,1806700,5,10,17,30,38,37050038
20785,0,1806700,3,10,17,30,38,37050038
20786,1,1806700,1,10,17,30,39,37050039
20787,0,1806700,1,10,17,30,39,37050039
20788,0,1806700,1,10,17,30,39,37050039
20789,0,1806700,1,10,17,30,39,37050039
20790,0,1806700,1,10,17,30,39,37050039
20791,101,1806700,1,10,17,30,140,37050140
20792,229,1806800,2,10,17,30,369,37050369
20793,1152,1806700,1,10,17,31,521,37051521
20794,1,1806700,2,10,17,31,522,37051522
20795,82,1806600,2,10,17,31,604,37051604
20796,0,1806600,5,10,17,31,604,37051604
20797,1,1806600,11,10,17,31,605,37051605
20798,0,1806600,1,10,17,31,605,37051605
20799,0,1806600,1,10,17,31,605,37051605
20800,0,1806600,32,10,17,31,605,37051605
20801,2,1806600,3,10,17,31,607,37051607
20802,140,1806500,1,10,17,31,747,37051747
20803,115,1806600,1,10,17,31,862,37051862
20804,15,1806500,1,10,17,31,877,37051877
20805,2,1806500,1,10,17,31,879,37051879
20806,14,1806500,5,10,17,31,893,37051893
20807,24,1806500,1,10,17,31,917,37051917
20808,314,1806600,2,10,17,32,231,37052231
20809,242,1806600,1,10,17,32,473,37052473
20810,549,1806700,1,10,17,33,22,37053022
20811,83,1806600,1,10,17,33,105,37053105
20812,1337,1806500,10,10,17,34,442,37054442
20813,308,1806500,1,10,17,34,750,37054750
20814,2358,1806600,1,10,17,37,108,37057108
20815,694,1806600,1,10,17,37,802,37057802
20816,407,1806600,1,10,17,38,209,37058209
20817,521,1806600,1,10,17,38,730,37058730
20818,1868,1806600,1,10,17,40,598,37060598
20819,179,1806600,1,10,17,40,777,37060777
20820,180,1806600,1,10,17,40,957,37060957
20821,40,1806500,1,10,17,40,997,37060997
20822,426,1806600,1,10,17,41,423,37061423
20823,488,1806500,1,10,17,41,911,37061911
20824,384,1806600,1,10,17,42,295,37062295
20825,309,1806600,1,10,17,42,604,37062604
20826,84,1806700,1,10,17,42,688,37062688
20827,316,1806600,1,10,17,43,4,37063004
20828,427,1806600,1,10,17,43,431,37063431
20829,239,1806600,2,10,17,43,670,37063670
20830,94,1806600,2,10,17,43,764,37063764
20832,30,1806700,1,10,17,43,794,37063794
20833,985,1806700,4,10,17,44,779,37064779
20834,219,1806700,1,10,17,44,998,37064998
20835,51,1806700,1,10,17,45,49,37065049
20836,2,1806700,1,10,17,45,51,37065051
20837,1,1806700,1,10,17,45,52,37065052
20838,1028,1806600,1,10,17,46,80,37066080
20839,1152,1806600,1,10,17,47,232,37067232
20840,239,1806600,1,10,17,47,471,37067471
20841,1411,1806600,1,10,17,48,882,37068882
20843,260,1806500,1,10,17,49,142,37069142
20844,2643,1806500,3,10,17,51,785,37071785
20845,245,1806500,1,10,17,52,30,37072030
20846,266,1806600,1,10,17,52,296,37072296
20847,725,1806600,1,10,17,53,21,37073021
20848,1452,1806500,1,10,17,54,473,37074473
20849,1,1806500,2,10,17,54,474,37074474
20850,377,1806600,4,10,17,54,851,37074851
20851,0,1806600,11,10,17,54,851,37074851
20852,19,1806600,2,10,17,54,870,37074870
20853,877,1806500,1,10,17,55,747,37075747
20854,528,1806500,10,10,17,56,275,37076275
20855,606,1806500,1,10,17,56,881,37076881
20856,0,1806600,1,10,17,56,881,37076881
20857,0,1806500,1,10,17,56,881,37076881
20858,593,1806500,1,10,17,57,474,37077474
20859,1047,1806500,1,10,17,58,521,37078521
20860,720,1806500,1,10,17,59,241,37079241
20861,897,1806600,3,10,18,0,138,37080138
20862,0,1806600,4,10,18,0,138,37080138
20863,89,1806700,1,10,18,0,227,37080227
20864,0,1806700,2,10,18,0,227,37080227
20865,0,1806700,1,10,18,0,227,37080227
20866,0,1806700,1,10,18,0,227,37080227
20867,0,1806700,1,10,18,0,227,37080227
20868,0,1806700,1,10,18,0,227,37080227
20869,1,1806800,1,10,18,0,228,37080228
20870,0,1806800,1,10,18,0,228,37080228
20871,71,1806600,3,10,18,0,299,37080299
20872,66,1806600,1,10,18,0,365,37080365
20873,377,1806600,1,10,18,0,742,37080742
20874,1017,1806600,1,10,18,1,759,37081759
20875,1428,1806700,2,10,18,3,187,37083187
20876,644,1806800,1,10,18,3,831,37083831
20877,1055,1806700,1,10,18,4,886,37084886
20878,2029,1806700,1,10,18,6,915,37086915
20880,1977,1806700,1,10,18,8,892,37088892
20881,83,1806700,1,10,18,8,975,37088975
20882,0,1806700,1,10,18,8,975,37088975
20883,0,1806800,1,10,18,8,975,37088975
20884,1,1806800,1,10,18,8,976,37088976
20885,1,1806700,1,10,18,8,977,37088977
20886,4,1806700,1,10,18,8,981,37088981
20887,1530,1806800,3,10,18,10,511,37090511
20888,484,1806900,1,10,18,10,995,37090995
20889,297,1806700,1,10,18,11,292,37091292
20890,694,1806800,3,10,18,11,986,37091986
20891,512,1806600,1,10,18,12,498,37092498
20892,374,1806600,1,10,18,12,872,37092872
20893,406,1806800,2,10,18,13,278,37093278
20894,0,1806800,2,10,18,13,278,37093278
20895,1034,1806800,1,10,18,14,312,37094312
20896,0,1806900,4,10,18,14,312,37094312
20897,303,1807000,1,10,18,14,615,37094615
20898,404,1806800,1,10,18,15,19,37095019
20899,23,1806900,1,10,18,15,42,37095042
20900,1124,1806900,1,10,18,16,166,37096166
20901,235,1806800,1,10,18,16,401,37096401
20902,1490,1806800,1,10,18,17,891,37097891
20903,85,1806900,1,10,18,17,976,37097976
20904,0,1807000,1,10,18,17,976,37097976
20905,2559,1806800,1,10,18,20,535,37100535
20906,1453,1806800,1,10,18,21,988,37101988
20907,634,1806800,1,10,18,22,622,37102622
20908,566,1806700,1,10,18,23,188,37103188
20909,24,1806800,1,10,18,23,212,37103212
20910,1417,1806900,1,10,18,24,629,37104629
20911,1,1806900,1,10,18,24,630,37104630
20912,0,1806900,1,10,18,24,630,37104630
20913,229,1806900,1,10,18,24,859,37104859
20914,0,1807000,32,10,18,24,859,37104859
20915,38,1807000,1,10,18,24,897,37104897
20916,65,1807100,12,10,18,24,962,37104962
20917,636,1807000,1,10,18,25,598,37105598
20918,68,1807000,1,10,18,25,666,37105666
20919,368,1806900,1,10,18,26,34,37106034
20920,4131,1806900,2,10,18,30,165,37110165
20921,61,1807000,1,10,18,30,226,37110226
20922,81,1806800,2,10,18,30,307,37110307
20923,267,1806800,2,10,18,30,574,37110574
20924,17,1806800,2,10,18,30,591,37110591
20926,4147,1806700,1,10,18,34,738,37114738
20927,880,1806900,7,10,18,35,618,37115618
20929,3,1807000,3,10,18,35,621,37115621
20930,0,1807000,10,10,18,35,621,37115621
20931,0,1807100,2,10,18,35,621,37115621
20932,0,1807100,3,10,18,35,621,37115621
20933,0,1807100,1,10,18,35,621,37115621
20934,0,1807000,95,10,18,35,621,37115621
20935,0,1807100,1,10,18,35,621,37115621
20936,1,1807000,2,10,18,35,622,37115622
20937,0,1807100,4,10,18,35,622,37115622
20938,1,1807100,1,10,18,35,623,37115623
20939,0,1807000,8,10,18,35,623,37115623
20940,0,1807000,13,10,18,35,623,37115623
20941,1,1807100,1,10,18,35,624,37115624
20942,8,1807000,1,10,18,35,632,37115632
20943,628,1807200,1,10,18,36,260,37116260
20944,223,1807000,1,10,18,36,483,37116483
20945,252,1807100,1,10,18,36,735,37116735
20946,1554,1807100,2,10,18,38,289,37118289
20947,62,1807200,1,10,18,38,351,37118351
20948,1895,1807000,5,10,18,40,246,37120246
20949,59,1807200,1,10,18,40,305,37120305
20950,50,1807000,2,10,18,40,355,37120355
20951,1516,1807100,1,10,18,41,871,37121871
20952,34,1807000,1,10,18,41,905,37121905
20953,0,1807000,1,10,18,41,905,37121905
20954,888,1807100,3,10,18,42,793,37122793
20955,92,1807100,1,10,18,42,885,37122885
20956,1482,1807000,1,10,18,44,367,37124367
20957,270,1807100,1,10,18,44,637,37124637
20958,1432,1807100,1,10,18,46,69,37126069
20959,131,1807100,3,10,18,46,200,37126200
20960,1218,1807000,3,10,18,47,418,37127418
20961,58,1807200,1,10,18,47,476,37127476
20962,301,1807000,1,10,18,47,777,37127777
20963,128,1807200,1,10,18,47,905,37127905
20964,1300,1807100,2,10,18,49,205,37129205
20965,739,1807000,1,10,18,49,944,37129944
20966,687,1807100,1,10,18,50,631,37130631
20967,406,1807000,7,10,18,51,37,37131037
20968,1051,1807100,1,10,18,52,88,37132088
20970,800,1807100,1,10,18,52,888,37132888
20971,1826,1807100,2,10,18,54,714,37134714
20972,582,1807100,2,10,18,55,296,37135296
20973,1,1807100,3,10,18,55,297,37135297
20974,2443,1807000,1,10,18,57,740,37137740
20975,1289,1807100,1,10,18,59,29,37139029
20976,484,1807100,1,10,18,59,513,37139513
20977,1492,1807100,1,10,19,1,5,37141005
20978,490,1807200,1,10,19,1,495,37141495
20979,228,1807200,2,10,19,1,723,37141723
20980,540,1807200,13,10,19,2,263,37142263
20982,3,1807300,17,10,19,2,266,37142266
20983,0,1807300,1,10,19,2,266,37142266
20984,617,1807200,1,10,19,2,883,37142883
20985,651,1807200,6,10,19,3,534,37143534
20986,304,1807200,5,10,19,3,838,37143838
20987,640,1807200,1,10,19,4,478,37144478
20988,653,1807100,1,10,19,5,131,37145131
20989,1301,1807300,2,10,19,6,432,37146432
20990,437,1807300,3,10,19,6,869,37146869
20991,643,1807300,1,10,19,7,512,37147512
20992,1066,1807400,1,10,19,8,578,37148578
20993,48,1807400,1,10,19,8,626,37148626
20994,15,1807400,4,10,19,8,641,37148641
20995,10,1807400,1,10,19,8,651,37148651
20996,1,1807400,1,10,19,8,652,37148652
20997,180,1807500,1,10,19,8,832,37148832
20998,34,1807500,1,10,19,8,866,37148866
20999,46,1807500,1,10,19,8,912,37148912
21000,6,1807500,1,10,19,8,918,37148918
21001,19,1807500,3,10,19,8,937,37148937
21002,17,1807500,1,10,19,8,954,37148954
21003,8,1807500,1,10,19,8,962,37148962
21004,20,1807500,2,10,19,8,982,37148982
21005,8,1807500,1,10,19,8,990,37148990
21006,6,1807500,1,10,19,8,996,37148996
21007,6,1807500,1,10,19,9,2,37149002
21008,11,1807500,1,10,19,9,13,37149013
21009,94,1807500,1,10,19,9,107,37149107
21010,15,1807400,1,10,19,9,122,37149122
21011,20,1807500,1,10,19,9,142,37149142
21012,47,1807400,1,10,19,9,189,37149189
21013,0,1807400,1,10,19,9,189,37149189
21014,12,1807400,2,10,19,9,201,37149201
21016,3,1807400,1,10,19,9,204,37149204
21017,92,1807500,1,10,19,9,296,37149296
21018,50,1807300,1,10,19,9,346,37149346
21019,64,1807300,1,10,19,9,410,37149410
21020,157,1807300,2,10,19,9,567,37149567
21022,305,1807400,1,10,19,9,872,37149872
21023,1255,1807400,1,10,19,11,127,37151127
21025,4,1807500,49,10,19,11,131,37151131
21026,0,1807500,1,10,19,11,131,37151131
21027,8,1807400,3,10,19,11,139,37151139
21028,337,1807400,1,10,19,11,476,37151476
21029,20,1807400,1,10,19,11,496,37151496
21030,700,1807500,1,10,19,12,196,37152196
21031,91,1807500,4,10,19,12,287,37152287
21032,1274,1807500,1,10,19,13,561,37153561
21033,106,1807500,1,10,19,13,667,37153667
21034,1472,1807500,1,10,19,15,139,37155139
21035,0,1807500,4,10,19,15,139,37155139
21036,211,1807400,1,10,19,15,350,37155350
21037,632,1807500,1,10,19,15,982,37155982
21038,221,1807500,1,10,19,16,203,37156203
21039,107,1807500,1,10,19,16,310,37156310
21040,678,1807500,1,10,19,16,988,37156988
21041,0,1807500,1,10,19,16,988,37156988
21042,740,1807500,1,10,19,17,728,37157728
21043,256,1807600,2,10,19,17,984,37157984
21044,139,1807600,4,10,19,18,123,37158123
21045,27,1807600,1,10,19,18,150,37158150
21046,3,1807600,1,10,19,18,153,37158153
21047,104,1807600,3,10,19,18,257,37158257
21048,22,1807600,1,10,19,18,279,37158279
21049,94,1807500,2,10,19,18,373,37158373
21050,114,1807500,1,10,19,18,487,37158487
21051,192,1807600,5,10,19,18,679,37158679
21052,19,1807600,4,10,19,18,698,37158698
21053,214,1807600,1,10,19,18,912,37158912
21054,0,1807600,1,10,19,18,912,37158912
21055,0,1807600,1,10,19,18,912,37158912
21056,14,1807600,1,10,19,18,926,37158926
21057,272,1807600,2,10,19,19,198,37159198
21058,30,1807600,2,10,19,19,228,37159228
21059,85,1807600,7,10,19,19,313,37159313
21060,1,1807600,1,10,19,19,314,37159314
21061,0,1807600,3,10,19,19,314,37159314
21062,0,1807600,2,10,19,19,314,37159314
21063,16,1807600,1,10,19,19,330,37159330
21064,500,1807600,1,10,19,19,830,37159830
21065,30,1807600,2,10,19,19,860,37159860
21066,0,1807600,3,10,19,19,860,37159860
21067,171,1807600,3,10,19,20,31,37160031
21068,144,1807600,1,10,19,20,175,37160175
21069,291,1807600,2,10,19,20,466,37160466
21070,27,1807600,1,10,19,20,493,37160493
21071,363,1807600,1,10,19,20,856,37160856
21072,203,1807600,1,10,19,21,59,37161059
21073,206,1807600,1,10,19,21,265,37161265
21074,104,1807600,1,10,19,21,369,37161369
21075,17,1807700,1,10,19,21,386,37161386
21076,68,1807700,1,10,19,21,454,37161454
21077,46,1807700,4,10,19,21,500,37161500
21078,2,1807700,2,10,19,21,502,37161502
21079,2,1807700,1,10,19,21,504,37161504
21080,3,1807700,1,10,19,21,507,37161507
21081,0,1807700,1,10,19,21,507,37161507
21082,83,1807700,4,10,19,21,590,37161590
21083,9,1807700,12,10,19,21,599,37161599
21084,1,1807700,1,10,19,21,600,37161600
21085,69,1807600,1,10,19,21,669,37161669
21086,149,1807700,1,10,19,21,818,37161818
21088,62,1807600,1,10,19,21,880,37161880
21089,2,1807600,1,10,19,21,882,37161882
21090,13,1807800,1,10,19,21,895,37161895
21091,71,1807600,1,10,19,21,966,37161966
21092,28,1807600,1,10,19,21,994,37161994
21093,50,1807700,1,10,19,22,44,37162044
21095,396,1807800,1,10,19,22,440,37162440
21096,103,1807600,1,10,19,22,543,37162543
21097,59,1807700,1,10,19,22,602,37162602
21098,278,1807800,1,10,19,22,880,37162880
21099,153,1807800,1,10,19,23,33,37163033
21100,404,1807800,1,10,19,23,437,37163437
21101,186,1807800,1,10,19,23,623,37163623
21102,135,1807800,1,10,19,23,758,37163758
21103,156,1807700,1,10,19,23,914,37163914
21104,901,1807800,1,10,19,24,815,37164815
21105,842,1807800,2,10,19,25,657,37165657
21106,680,1807800,10,10,19,26,337,37166337
21107,17,1807800,1,10,19,26,354,37166354
21108,336,1807900,1,10,19,26,690,37166690
21109,37,1807900,1,10,19,26,727,37166727
21110,22,1807900,2,10,19,26,749,37166749
21111,28,1807900,1,10,19,26,777,37166777
21112,153,1807900,1,10,19,26,930,37166930
21113,11,1807900,1,10,19,26,941,37166941
21114,43,1807900,1,10,19,26,984,37166984
21115,458,1807900,1,10,19,27,442,37167442
21116,124,1807900,1,10,19,27,566,37167566
21117,127,1807900,2,10,19,27,693,37167693
21118,260,1807900,4,10,19,27,953,37167953
21119,572,1807800,3,10,19,28,525,37168525
21120,385,1807700,1,10,19,28,910,37168910
21121,1428,1807700,1,10,19,30,338,37170338
21122,45,1807700,1,10,19,30,383,37170383
21123,51,1807800,1,10,19,30,434,37170434
21124,692,1807800,2,10,19,31,126,37171126
21125,278,1807800,1,10,19,31,404,37171404
21126,212,1807800,1,10,19,31,616,37171616
21127,400,1807800,1,10,19,32,16,37172016
21128,147,1807800,1,10,19,32,163,37172163
21129,359,1807900,1,10,19,32,522,37172522
21130,522,1807800,4,10,19,33,44,37173044
21131,154,1807800,1,10,19,33,198,37173198
21132,338,1807700,2,10,19,33,536,37173536
21133,766,1807800,1,10,19,34,302,37174302
21134,306,1807800,1,10,19,34,608,37174608
21135,509,1807800,1,10,19,35,117,37175117
21136,1178,1807800,1,10,19,36,295,37176295
21137,338,1807700,2,10,19,36,633,37176633
21138,882,1807900,1,10,19,37,515,37177515
21139,331,1807800,1,10,19,37,846,37177846
21140,24,1807800,1,10,19,37,870,37177870
21141,450,1807800,1,10,19,38,320,37178320
21142,156,1807900,1,10,19,38,476,37178476
21143,403,1807900,1,10,19,38,879,37178879
21144,291,1807800,1,10,19,39,170,37179170
21145,421,1807800,1,10,19,39,591,37179591
21146,121,1807900,1,10,19,39,712,37179712
21147,537,1807800,1,10,19,40,249,37180249
21148,313,1807700,4,10,19,40,562,37180562
21149,106,1807700,1,10,19,40,668,37180668
21150,262,1807900,4,10,19,40,930,37180930
21151,5,1807900,1,10,19,40,935,37180935
21152,36,1807900,1,10,19,40,971,37180971
21153,1336,1807900,1,10,19,42,307,37182307
21154,0,1807900,4,10,19,42,307,37182307
21155,0,1807900,4,10,19,42,307,37182307
21156,0,1807900,1,10,19,42,307,37182307
21157,0,1807900,1,10,19,42,307,37182307
21158,1,1807900,1,10,19,42,308,37182308
21159,0,1807900,1,10,19,42,308,37182308
21160,0,1807900,3,10,19,42,308,37182308
21161,1455,1807800,1,10,19,43,763,37183763
21162,719,1807800,1,10,19,44,482,37184482
21163,46,1807900,1,10,19,44,528,37184528
21164,454,1807800,1,10,19,44,982,37184982
21165,1287,1807800,1,10,19,46,269,37186269
21166,297,1807800,1,10,19,46,566,37186566
21167,348,1807800,1,10,19,46,914,37186914
21168,28,1807800,1,10,19,46,942,37186942
21169,159,1807900,5,10,19,47,101,37187101
21170,360,1807900,2,10,19,47,461,37187461
21171,1566,1807900,1,10,19,49,27,37189027
21172,18,1807800,1,10,19,49,45,37189045
21173,99,1807800,1,10,19,49,144,37189144
21174,601,1807900,1,10,19,49,745,37189745
21175,221,1807800,1,10,19,49,966,37189966
21176,490,1807800,1,10,19,50,456,37190456
21177,50,1807800,1,10,19,50,506,37190506
21178,320,1807800,1,10,19,50,826,37190826
21180,1002,1807800,1,10,19,51,828,37191828
21181,1056,1807800,1,10,19,52,884,37192884
21182,12,1807700,1,10,19,52,896,37192896
21183,144,1807700,8,10,19,53,40,37193040
21185,474,1807800,1,10,19,53,514,37193514
21186,73,1807800,1,10,19,53,587,37193587
21187,351,1807800,1,10,19,53,938,37193938
21188,42,1807800,1,10,19,53,980,37193980
21189,46,1807800,2,10,19,54,26,37194026
21190,1079,1807800,3,10,19,55,105,37195105
21191,2493,1807900,3,10,19,57,598,37197598
21192,104,1807800,1,10,19,57,702,37197702
21193,155,1807800,1,10,19,57,857,37197857
21194,1340,1807800,1,10,19,59,197,37199197
21195,207,1807900,1,10,19,59,404,37199404
21196,766,1807800,5,10,20,0,170,37200170
21197,131,1807900,2,10,20,0,301,37200301
21198,2,1807900,2,10,20,0,303,37200303
21199,1,1807900,2,10,20,0,304,37200304
21200,2,1807900,3,10,20,0,306,37200306
21201,159,1808000,1,10,20,0,465,37200465
21202,2,1808000,1,10,20,0,467,37200467
21203,30,1808000,2,10,20,0,497,37200497
21204,0,1808000,5,10,20,0,497,37200497
21205,5,1807900,1,10,20,0,502,37200502
21206,0,1808000,4,10,20,0,502,37200502
21207,28,1808000,1,10,20,0,530,37200530
21208,54,1808000,4,10,20,0,584,37200584
21209,3,1808000,2,10,20,0,587,37200587
21210,2,1808000,1,10,20,0,589,37200589
21211,5,1808000,1,10,20,0,594,37200594
21212,17,1808000,1,10,20,0,611,37200611
21213,36,1808000,1,10,20,0,647,37200647
21214,24,1807900,1,10,20,0,671,37200671
21215,4,1808000,3,10,20,0,675,37200675
21216,6,1808000,2,10,20,0,681,37200681
21217,179,1808000,2,10,20,0,860,37200860
21218,110,1807900,5,10,20,0,970,37200970
21219,13,1807900,2,10,20,0,983,37200983
21220,129,1807900,1,10,20,1,112,37201112
21221,4,1807900,1,10,20,1,116,37201116
21222,148,1807900,2,10,20,1,264,37201264
21223,67,1807900,2,10,20,1,331,37201331
21224,142,1807900,1,10,20,1,473,37201473
21225,28,1807900,1,10,20,1,501,37201501
21226,53,1808000,1,10,20,1,554,37201554
21227,33,1808000,2,10,20,1,587,37201587
21228,11,1808000,1,10,20,1,598,37201598
21229,0,1808000,1,10,20,1,598,37201598
21230,37,1808000,1,10,20,1,635,37201635
21231,3,1808000,2,10,20,1,638,37201638
21232,196,1807900,3,10,20,1,834,37201834
21233,108,1808000,1,10,20,1,942,37201942
21234,9,1808000,1,10,20,1,951,37201951
21235,74,1807900,3,10,20,2,25,37202025
21236,1,1808000,1,10,20,2,26,37202026
21237,1780,1808000,3,10,20,3,806,37203806
21238,0,1808000,2,10,20,3,806,37203806
21239,1,1808000,3,10,20,3,807,37203807
21240,0,1808000,21,10,20,3,807,37203807
21241,1254,1808000,1,10,20,5,61,37205061
21242,0,1808000,2,10,20,5,61,37205061
21243,1144,1808100,1,10,20,6,205,37206205
21244,36,1808100,1,10,20,6,241,37206241
21245,4,1808100,2,10,20,6,245,37206245
21246,49,1808100,1,10,20,6,294,37206294
21247,2,1808100,2,10,20,6,296,37206296
21248,9,1808100,1,10,20,6,305,37206305
21249,8,1808100,2,10,20,6,313,37206313
21250,10,1808100,1,10,20,6,323,37206323
21251,1,1808100,1,10,20,6,324,37206324
21252,0,1808100,18,10,20,6,324,37206324
21253,37,1808200,1,10,20,6,361,37206361
21254,4,1808200,1,10,20,6,365,37206365
21255,134,1808200,2,10,20,6,499,37206499
21256,1,1808100,1,10,20,6,500,37206500
21257,31,1808200,1,10,20,6,531,37206531
21258,432,1808100,1,10,20,6,963,37206963
21259,481,1808200,1,10,20,7,444,37207444
21260,32,1808200,1,10,20,7,476,37207476
21261,262,1808100,1,10,20,7,738,37207738
21262,755,1808100,1,10,20,8,493,37208493
21263,125,1808200,2,10,20,8,618,37208618
21264,109,1808200,1,10,20,8,727,37208727
21265,14,1808200,1,10,20,8,741,37208741
21266,1115,1808200,2,10,20,9,856,37209856
21267,0,1808200,7,10,20,9,856,37209856
21268,32,1808200,1,10,20,9,888,37209888
21269,144,1808200,1,10,20,10,32,37210032
21270,92,1808300,1,10,20,10,124,37210124
21271,30,1808300,1,10,20,10,154,37210154
21272,78,1808300,3,10,20,10,232,37210232
21273,12,1808300,1,10,20,10,244,37210244
21274,56,1808200,1,10,20,10,300,37210300
21275,4,1808200,2,10,20,10,304,37210304
21276,34,1808300,1,10,20,10,338,37210338
21277,396,1808300,5,10,20,10,734,37210734
21278,0,1808300,1,10,20,10,734,37210734
21279,128,1808300,3,10,20,10,862,37210862
21280,165,1808200,1,10,20,11,27,37211027
21281,179,1808200,1,10,20,11,206,37211206
21282,106,1808300,1,10,20,11,312,37211312
21283,18,1808300,12,10,20,11,330,37211330
21284,159,1808400,2,10,20,11,489,37211489
21285,133,1808400,1,10,20,11,622,37211622
21286,46,1808400,7,10,20,11,668,37211668
21287,3,1808400,1,10,20,11,671,37211671
21288,2,1808300,1,10,20,11,673,37211673
21289,75,1808400,1,10,20,11,748,37211748
21290,145,1808300,3,10,20,11,893,37211893
21291,40,1808400,2,10,20,11,933,37211933
21292,36,1808500,1,10,20,11,969,37211969
21293,5,1808500,1,10,20,11,974,37211974
21294,30,1808500,1,10,20,12,4,37212004
21295,26,1808300,1,10,20,12,30,37212030
21296,23,1808300,4,10,20,12,53,37212053
21297,13,1808300,1,10,20,12,66,37212066
21298,1,1808400,1,10,20,12,67,37212067
21299,4,1808400,2,10,20,12,71,37212071
21300,83,1808400,1,10,20,12,154,37212154
21301,3,1808400,1,10,20,12,157,37212157
21302,70,1808300,1,10,20,12,227,37212227
21303,275,1808300,1,10,20,12,502,37212502
21304,69,1808400,1,10,20,12,571,37212571
21305,76,1808400,1,10,20,12,647,37212647
21306,65,1808400,1,10,20,12,712,37212712
21307,82,1808200,1,10,20,12,794,37212794
21308,42,1808400,1,10,20,12,836,37212836
21309,600,1808400,7,10,20,13,436,37213436
21310,3,1808400,13,10,20,13,439,37213439
21311,212,1808400,2,10,20,13,651,37213651
21312,172,1808400,3,10,20,13,823,37213823
21313,214,1808500,5,10,20,14,37,37214037
21314,62,1808300,1,10,20,14,99,37214099
21315,251,1808400,2,10,20,14,350,37214350
21316,639,1808400,1,10,20,14,989,37214989
21317,383,1808300,3,10,20,15,372,37215372
21318,12,1808400,1,10,20,15,384,37215384
21319,257,1808300,7,10,20,15,641,37215641
21320,67,1808200,16,10,20,15,708,37215708
21321,0,1808200,16,10,20,15,708,37215708
21323,3,1808000,7,10,20,15,711,37215711
21324,0,1808000,1,10,20,15,711,37215711
21325,0,1808000,1,10,20,15,711,37215711
21326,0,1808000,1,10,20,15,711,37215711
21327,2,1808000,1,10,20,15,713,37215713
21328,0,1808000,1,10,20,15,713,37215713
21329,7,1808000,1,10,20,15,720,37215720
21330,0,1808000,1,10,20,15,720,37215720
21331,2,1808000,1,10,20,15,722,37215722
21332,1,1808000,1,10,20,15,723,37215723
21333,27,1807900,2,10,20,15,750,37215750
21334,0,1807900,1,10,20,15,750,37215750
21335,0,1807900,2,10,20,15,750,37215750
21336,59,1807900,5,10,20,15,809,37215809
21337,7,1807900,2,10,20,15,816,37215816
21338,262,1808000,1,10,20,16,78,37216078
21339,282,1808100,2,10,20,16,360,37216360
21340,30,1808100,1,10,20,16,390,37216390
21341,4,1808100,1,10,20,16,394,37216394
21342,203,1808000,1,10,20,16,597,37216597
21343,4,1807900,2,10,20,16,601,37216601
21344,28,1808000,2,10,20,16,629,37216629
21346,25,1808000,1,10,20,16,654,37216654
21347,380,1807900,1,10,20,17,34,37217034
21348,9,1807900,1,10,20,17,43,37217043
21349,57,1808100,1,10,20,17,100,37217100
21350,1,1808100,1,10,20,17,101,37217101
21351,0,1808100,1,10,20,17,101,37217101
21352,0,1808100,1,10,20,17,101,37217101
21353,317,1808100,1,10,20,17,418,37217418
21354,80,1808000,1,10,20,17,498,37217498
21355,179,1808000,1,10,20,17,677,37217677
21356,219,1808000,1,10,20,17,896,37217896
21357,605,1808100,1,10,20,18,501,37218501
21358,171,1808000,1,10,20,18,672,37218672
21359,14,1808100,1,10,20,18,686,37218686
21360,363,1808000,1,10,20,19,49,37219049
21361,629,1808100,1,10,20,19,678,37219678
21362,1051,1808100,1,10,20,20,729,37220729
21363,201,1808200,2,10,20,20,930,37220930
21364,121,1808100,1,10,20,21,51,37221051
21365,151,1808100,1,10,20,21,202,37221202
21366,162,1808200,1,10,20,21,364,37221364
21367,794,1808100,1,10,20,22,158,37222158
21368,220,1808100,1,10,20,22,378,37222378
21369,243,1808000,1,10,20,22,621,37222621
21370,324,1808100,5,10,20,22,945,37222945
21371,100,1808100,1,10,20,23,45,37223045
21372,117,1808100,2,10,20,23,162,37223162
21373,1829,1808100,1,10,20,24,991,37224991
21374,188,1808100,1,10,20,25,179,37225179
21375,376,1808100,6,10,20,25,555,37225555
21377,209,1807900,1,10,20,25,764,37225764
21378,1139,1807900,1,10,20,26,903,37226903
21379,25,1808000,1,10,20,26,928,37226928
21380,104,1808000,1,10,20,27,32,37227032
21381,69,1808000,1,10,20,27,101,37227101
21382,711,1807900,1,10,20,27,812,37227812
21383,531,1807900,1,10,20,28,343,37228343
21384,109,1808000,1,10,20,28,452,37228452
21385,22,1807900,1,10,20,28,474,37228474
21386,337,1807900,1,10,20,28,811,37228811
21387,282,1808000,1,10,20,29,93,37229093
21388,1084,1807900,8,10,20,30,177,37230177
21389,1,1807900,3,10,20,30,178,37230178
21390,75,1807900,2,10,20,30,253,37230253
21391,74,1807800,1,10,20,30,327,37230327
21392,655,1807900,3,10,20,30,982,37230982
21393,209,1807900,1,10,20,31,191,37231191
21394,433,1807900,2,10,20,31,624,37231624
21395,231,1807800,4,10,20,31,855,37231855
21396,108,1807900,2,10,20,31,963,37231963
21397,167,1807900,1,10,20,32,130,37232130
21398,501,1807900,3,10,20,32,631,37232631
21399,765,1807800,10,10,20,33,396,37233396
21400,1,1807800,2,10,20,33,397,37233397
21401,0,1807800,1,10,20,33,397,37233397
21402,0,1807800,1,10,20,33,397,37233397
21403,90,1807800,1,10,20,33,487,37233487
21404,246,1807800,1,10,20,33,733,37233733
21405,137,1807800,1,10,20,33,870,37233870
21406,12,1807700,1,10,20,33,882,37233882
21407,349,1807900,1,10,20,34,231,37234231
21408,277,1807800,1,10,20,34,508,37234508
21409,18,1807900,5,10,20,34,526,37234526
21410,99,1807700,1,10,20,34,625,37234625
21411,354,1807800,1,10,20,34,979,37234979
21412,272,1807800,1,10,20,35,251,37235251
21413,378,1807800,1,10,20,35,629,37235629
21414,38,1807800,1,10,20,35,667,37235667
21415,1087,1807900,1,10,20,36,754,37236754
21416,264,1807900,1,10,20,37,18,37237018
21417,700,1807900,1,10,20,37,718,37237718
21418,516,1807800,1,10,20,38,234,37238234
21420,625,1807800,1,10,20,38,859,37238859
21421,680,1807700,1,10,20,39,539,37239539
21422,483,1807700,1,10,20,40,22,37240022
21423,366,1807900,2,10,20,40,388,37240388
21424,513,1807700,1,10,20,40,901,37240901
21425,137,1807900,3,10,20,41,38,37241038
21426,1367,1807900,1,10,20,42,405,37242405
21427,172,1807800,4,10,20,42,577,37242577
21428,164,1807900,1,10,20,42,741,37242741
21429,352,1807900,1,10,20,43,93,37243093
21430,376,1807900,1,10,20,43,469,37243469
21431,102,1808000,1,10,20,43,571,37243571
21432,155,1807800,1,10,20,43,726,37243726
21433,330,1807900,2,10,20,44,56,37244056
21434,1905,1807900,1,10,20,45,961,37245961
21435,326,1808000,1,10,20,46,287,37246287
21436,1173,1807900,1,10,20,47,460,37247460
21437,10,1807900,1,10,20,47,470,37247470
21438,56,1807900,1,10,20,47,526,37247526
21439,252,1807900,1,10,20,47,778,37247778
21440,339,1808000,1,10,20,48,117,37248117
21441,193,1807800,16,10,20,48,310,37248310
21442,1,1807800,11,10,20,48,311,37248311
21443,17,1807700,1,10,20,48,328,37248328
21444,424,1807900,1,10,20,48,752,37248752
21445,66,1807800,2,10,20,48,818,37248818
21446,1013,1807900,3,10,20,49,831,37249831
21447,2944,1807800,5,10,20,52,775,37252775
21448,118,1807800,3,10,20,52,893,37252893
21449,107,1807800,1,10,20,53,0,37253000
21450,419,1807800,1,10,20,53,419,37253419
21451,92,1807700,1,10,20,53,511,37253511
21452,1569,1807700,1,10,20,55,80,37255080
21453,97,1807700,2,10,20,55,177,37255177
21454,513,1807800,1,10,20,55,690,37255690
21455,128,1807700,1,10,20,55,818,37255818
21456,378,1807700,1,10,20,56,196,37256196
21457,90,1807800,3,10,20,56,286,37256286
21458,95,1807800,6,10,20,56,381,37256381
21459,17,1807800,2,10,20,56,398,37256398
21460,1316,1807800,1,10,20,57,714,37257714
21461,785,1807700,2,10,20,58,499,37258499
21462,21,1807800,2,10,20,58,520,37258520
21463,269,1807700,1,10,20,58,789,37258789
21464,1209,1807800,1,10,20,59,998,37259998
21465,86,1807700,1,10,21,0,84,37260084
21466,177,1807800,1,10,21,0,261,37260261
21467,32,1807700,3,10,21,0,293,37260293
21468,44,1807700,1,10,21,0,337,37260337
21469,28,1807800,1,10,21,0,365,37260365
21471,1,1807900,2,10,21,0,366,37260366
21472,22,1807800,1,10,21,0,388,37260388
21474,110,1807900,1,10,21,0,498,37260498
21475,12,1807900,2,10,21,0,510,37260510
21476,41,1807900,1,10,21,0,551,37260551
21477,23,1807900,2,10,21,0,574,37260574
21478,2,1807900,1,10,21,0,576,37260576
21479,81,1807900,2,10,21,0,657,37260657
21480,5,1807900,2,10,21,0,662,37260662
21481,537,1807900,1,10,21,1,199,37261199
21482,136,1807900,2,10,21,1,335,37261335
21483,180,1807900,1,10,21,1,515,37261515
21484,25,1807900,1,10,21,1,540,37261540
21485,84,1807800,2,10,21,1,624,37261624
21486,68,1808000,1,10,21,1,692,37261692
21487,27,1808000,5,10,21,1,719,37261719
21488,161,1808000,1,10,21,1,880,37261880
21489,147,1807900,2,10,21,2,27,37262027
21490,451,1807900,2,10,21,2,478,37262478
21491,254,1808000,2,10,21,2,732,37262732
21492,681,1808000,1,10,21,3,413,37263413
21493,321,1808000,2,10,21,3,734,37263734
21494,234,1808000,1,10,21,3,968,37263968
21495,756,1808000,1,10,21,4,724,37264724
21496,37,1807900,1,10,21,4,761,37264761
21497,626,1808000,1,10,21,5,387,37265387
21498,385,1808000,1,10,21,5,772,37265772
21499,256,1807900,2,10,21,6,28,37266028
21500,1821,1807900,1,10,21,7,849,37267849
21501,664,1807900,9,10,21,8,513,37268513
21502,33,1807800,2,10,21,8,546,37268546
21503,2390,1807800,2,10,21,10,936,37270936
21504,381,1807900,1,10,21,11,317,37271317
21505,83,1807800,2,10,21,11,400,37271400
21506,28,1807900,1,10,21,11,428,37271428
21507,1075,1807800,1,10,21,12,503,37272503
21508,1,1807800,2,10,21,12,504,37272504
21509,0,1807800,1,10,21,12,504,37272504
21510,783,1807900,5,10,21,13,287,37273287
21511,288,1807900,1,10,21,13,575,37273575
21512,479,1807900,17,10,21,14,54,37274054
21514,668,1807900,1,10,21,14,722,37274722
21515,792,1807800,1,10,21,15,514,37275514
21516,575,1807900,1,10,21,16,89,37276089
21517,1365,1807800,1,10,21,17,454,37277454
21518,2607,1807800,2,10,21,20,61,37280061
21519,219,1807800,1,10,21,20,280,37280280
21520,1678,1807800,1,10,21,21,958,37281958
21521,0,1807800,3,10,21,21,958,37281958
21522,0,1807700,3,10,21,21,958,37281958
21523,0,1807700,2,10,21,21,958,37281958
21524,0,1807700,1,10,21,21,958,37281958
21525,521,1807700,1,10,21,22,479,37282479
21526,878,1807800,1,10,21,23,357,37283357
21527,1258,1807800,1,10,21,24,615,37284615
21528,1070,1807700,1,10,21,25,685,37285685
21529,75,1807900,3,10,21,25,760,37285760
21530,1617,1807800,1,10,21,27,377,37287377
21531,931,1807800,1,10,21,28,308,37288308
21532,335,1807800,1,10,21,28,643,37288643
21533,75,1807700,24,10,21,28,718,37288718
21534,337,1807700,1,10,21,29,55,37289055
21535,1272,1807600,1,10,21,30,327,37290327
21536,44,1807600,1,10,21,30,371,37290371
21537,34,1807600,2,10,21,30,405,37290405
21538,124,1807600,1,10,21,30,529,37290529
21539,118,1807600,1,10,21,30,647,37290647
21540,1011,1807700,1,10,21,31,658,37291658
21541,386,1807600,1,10,21,32,44,37292044
21542,502,1807600,1,10,21,32,546,37292546
21543,2477,1807700,5,10,21,35,23,37295023
21544,1045,1807600,1,10,21,36,68,37296068
21545,972,1807600,1,10,21,37,40,37297040
21546,490,1807600,1,10,21,37,530,37297530
21547,2821,1807600,1,10,21,40,351,37300351
21548,53,1807700,20,10,21,40,404,37300404
21549,1038,1807600,1,10,21,41,442,37301442
21550,1339,1807700,1,10,21,42,781,37302781
21551,1,1807700,5,10,21,42,782,37302782
21552,0,1807700,1,10,21,42,782,37302782
21553,51,1807700,17,10,21,42,833,37302833
21554,241,1807700,1,10,21,43,74,37303074
21555,357,1807700,1,10,21,43,431,37303431
21556,696,1807700,2,10,21,44,127,37304127
21557,4009,1807700,1,10,21,48,136,37308136
21558,218,1807700,1,10,21,48,354,37308354
21559,1092,1807800,1,10,21,49,446,37309446
21560,359,1807800,1,10,21,49,805,37309805
21561,516,1807700,1,10,21,50,321,37310321
21562,1087,1807800,1,10,21,51,408,37311408
21563,14,1807800,2,10,21,51,422,37311422
21564,180,1807800,1,10,21,51,602,37311602
21565,825,1807800,2,10,21,52,427,37312427
21566,536,1807900,1,10,21,52,963,37312963
21567,272,1807700,1,10,21,53,235,37313235
21568,1469,1807900,1,10,21,54,704,37314704
21569,1627,1807900,7,10,21,56,331,37316331
21570,311,1808000,5,10,21,56,642,37316642
21571,0,1808000,1,10,21,56,642,37316642
21572,0,1808000,7,10,21,56,642,37316642
21573,0,1808000,3,10,21,56,642,37316642
21574,42,1808100,5,10,21,56,684,37316684
21575,15,1808100,2,10,21,56,699,37316699
21576,46,1808000,1,10,21,56,745,37316745
21577,42,1808000,1,10,21,56,787,37316787
21578,103,1808000,1,10,21,56,890,37316890
21579,2295,1808100,2,10,21,59,185,37319185
21581,269,1808100,1,10,21,59,454,37319454
21582,734,1808100,1,10,22,0,188,37320188
21583,0,1808100,1,10,22,0,188,37320188
21585,3,1807900,7,10,22,0,191,37320191
21586,0,1807900,1,10,22,0,191,37320191
21587,0,1807900,22,10,22,0,191,37320191
21588,48,1808000,2,10,22,0,239,37320239
21590,904,1808100,1,10,22,1,143,37321143
21591,38,1808000,1,10,22,1,181,37321181
21592,1459,1808000,1,10,22,2,640,37322640
21593,1149,1808000,1,10,22,3,789,37323789
21594,0,1808000,6,10,22,3,789,37323789
21595,500,1808000,1,10,22,4,289,37324289
21596,81,1807900,2,10,22,4,370,37324370
21598,1184,1808000,10,10,22,5,554,37325554
21599,279,1808100,1,10,22,5,833,37325833
21600,5474,1807900,1,10,22,11,307,37331307
21601,1523,1807900,1,10,22,12,830,37332830
21602,165,1808000,1,10,22,12,995,37332995
21603,336,1807900,1,10,22,13,331,37333331
21604,448,1807900,1,10,22,13,779,37333779
21605,75,1807900,1,10,22,13,854,37333854
21606,1,1807900,2,10,22,13,855,37333855
21607,738,1808000,1,10,22,14,593,37334593
21608,1845,1807900,1,10,22,16,438,37336438
21609,2105,1807900,1,10,22,18,543,37338543
21610,59,1808000,19,10,22,18,602,37338602
21611,1877,1807900,1,10,22,20,479,37340479
21612,672,1807900,1,10,22,21,151,37341151
21613,4228,1808000,2,10,22,25,379,37345379
21614,1425,1808000,8,10,22,26,804,37346804
21616,2,1807900,1,10,22,26,806,37346806
21617,0,1807900,38,10,22,26,806,37346806
21618,389,1807900,1,10,22,27,195,37347195
21619,521,1808000,1,10,22,27,716,37347716
21620,2064,1808000,1,10,22,29,780,37349780
21621,79,1808000,1,10,22,29,859,37349859
21622,2058,1808100,2,10,22,31,917,37351917
21623,199,1808000,1,10,22,32,116,37352116
21624,210,1808000,1,10,22,32,326,37352326
21625,146,1808000,1,10,22,32,472,37352472
21626,1090,1808000,1,10,22,33,562,37353562
21627,100,1808000,1,10,22,33,662,37353662
21628,2379,1808000,6,10,22,36,41,37356041
21630,579,1808000,1,10,22,36,620,37356620
21631,573,1808000,1,10,22,37,193,37357193
21632,680,1808000,2,10,22,37,873,37357873
21633,1155,1807900,1,10,22,39,28,37359028
21634,3259,1807900,1,10,22,42,287,37362287
21635,1684,1808000,1,10,22,43,971,37363971
21636,364,1808000,1,10,22,44,335,37364335
21637,477,1807900,5,10,22,44,812,37364812
21638,619,1807900,1,10,22,45,431,37365431
21639,745,1808000,1,10,22,46,176,37366176
21640,0,1808000,6,10,22,46,176,37366176
21641,0,1808000,1,10,22,46,176,37366176
21642,461,1807900,2,10,22,46,637,37366637
21643,28,1808000,4,10,22,46,665,37366665
21644,1610,1808000,1,10,22,48,275,37368275
21645,809,1808000,1,10,22,49,84,37369084
21646,5258,1807900,1,10,22,54,342,37374342
21647,1624,1807900,2,10,22,55,966,37375966
21648,0,1807900,2,10,22,55,966,37375966
21649,0,1807900,2,10,22,55,966,37375966
21650,0,1807900,1,10,22,55,966,37375966
21651,0,1807900,1,10,22,55,966,37375966
21652,887,1807800,1,10,22,56,853,37376853
21653,7,1807800,19,10,22,56,860,37376860
21654,585,1807700,1,10,22,57,445,37377445
21655,424,1807700,1,10,22,57,869,37377869
21656,2284,1807700,10,10,23,0,153,37380153
21657,1213,1807800,1,10,23,1,366,37381366
21658,168,1807800,2,10,23,1,534,37381534
21659,50,1807700,10,10,23,1,584,37381584
21660,192,1807800,4,10,23,1,776,37381776
21661,104,1807900,1,10,23,1,880,37381880
21662,177,1807900,1,10,23,2,57,37382057
21663,199,1807900,1,10,23,2,256,37382256
21664,173,1807700,1,10,23,2,429,37382429
21665,301,1807800,2,10,23,2,730,37382730
21666,274,1807900,3,10,23,3,4,37383004
21667,865,1807900,1,10,23,3,869,37383869
21668,1056,1807900,1,10,23,4,925,37384925
21669,230,1807900,1,10,23,5,155,37385155
21670,1232,1807900,3,10,23,6,387,37386387
21671,796,1807800,1,10,23,7,183,37387183
21672,1997,1807900,1,10,23,9,180,37389180
21673,1067,1807900,1,10,23,10,247,37390247
21674,6887,1807800,1,10,23,17,134,37397134
21675,224,1807800,1,10,23,17,358,37397358
21676,2793,1807800,1,10,23,20,151,37400151
21677,1197,1807800,3,10,23,21,348,37401348
21678,838,1807800,1,10,23,22,186,37402186
21679,243,1807800,10,10,23,22,429,37402429
21681,131,1807700,2,10,23,22,560,37402560
21682,204,1807700,1,10,23,22,764,37402764
21683,490,1807700,10,10,23,23,254,37403254
21684,2240,1807700,1,10,23,25,494,37405494
21685,3439,1807600,1,10,23,28,933,37408933
21686,268,1807700,1,10,23,29,201,37409201
21687,1403,1807600,41,10,23,30,604,37410604
21688,2,1807500,1,10,23,30,606,37410606
21689,0,1807500,3,10,23,30,606,37410606
21690,0,1807500,10,10,23,30,606,37410606
21691,1,1807500,27,10,23,30,607,37410607
21692,2,1807400,3,10,23,30,609,37410609
21693,148,1807400,1,10,23,30,757,37410757
21694,25,1807500,1,10,23,30,782,37410782
21695,82,1807500,1,10,23,30,864,37410864
21696,29,1807400,1,10,23,30,893,37410893
21697,26,1807500,2,10,23,30,919,37410919
21699,174,1807600,1,10,23,31,93,37411093
21700,1184,1807600,3,10,23,32,277,37412277
21701,1002,1807500,1,10,23,33,279,37413279
21702,25,1807500,1,10,23,33,304,37413304
21703,1736,1807500,1,10,23,35,40,37415040
21704,1021,1807500,1,10,23,36,61,37416061
21705,157,1807500,1,10,23,36,218,37416218
21707,661,1807400,1,10,23,36,879,37416879
21708,1128,1807500,3,10,23,38,7,37418007
21709,438,1807500,1,10,23,38,445,37418445
21711,132,1807400,1,10,23,38,577,37418577
21712,133,1807500,1,10,23,38,710,37418710
21713,1850,1807400,3,10,23,40,560,37420560
21714,427,1807400,1,10,23,40,987,37420987
21715,0,1807400,4,10,23,40,987,37420987
21716,2,1807400,2,10,23,40,989,37420989
21717,4,1807400,2,10,23,40,993,37420993
21718,331,1807400,3,10,23,41,324,37421324
21719,464,1807400,5,10,23,41,788,37421788
21720,235,1807400,2,10,23,42,23,37422023
21721,529,1807400,3,10,23,42,552,37422552
21722,1,1807400,2,10,23,42,553,37422553
21723,133,1807400,1,10,23,42,686,37422686
21724,272,1807300,18,10,23,42,958,37422958
21726,3,1807200,1,10,23,42,961,37422961
21727,0,1807200,8,10,23,42,961,37422961
21728,0,1807200,2,10,23,42,961,37422961
21729,75,1807200,1,10,23,43,36,37423036
21730,12,1807200,6,10,23,43,48,37423048
21732,91,1807200,4,10,23,43,139,37423139
21733,67,1807200,1,10,23,43,206,37423206
21734,501,1807300,1,10,23,43,707,37423707
21735,628,1807200,2,10,23,44,335,37424335
21736,50,1807200,1,10,23,44,385,37424385
21737,145,1807300,1,10,23,44,530,37424530
21738,237,1807300,2,10,23,44,767,37424767
21739,155,1807300,1,10,23,44,922,37424922
21740,6,1807300,1,10,23,44,928,37424928
21741,79,1807300,1,10,23,45,7,37425007
21742,727,1807500,3,10,23,45,734,37425734
21743,147,1807400,1,10,23,45,881,37425881
21744,509,1807300,1,10,23,46,390,37426390
21745,244,1807400,2,10,23,46,634,37426634
21746,273,1807300,1,10,23,46,907,37426907
21747,1342,1807300,1,10,23,48,249,37428249
21748,355,1807300,1,10,23,48,604,37428604
21749,308,1807300,3,10,23,48,912,37428912
21750,2,1807300,4,10,23,48,914,37428914
21751,221,1807300,1,10,23,49,135,37429135
21752,973,1807400,2,10,23,50,108,37430108
21753,302,1807300,1,10,23,50,410,37430410
21754,639,1807400,2,10,23,51,49,37431049
21755,1190,1807400,4,10,23,52,239,37432239
21756,94,1807400,3,10,23,52,333,37432333
21757,0,1807400,3,10,23,52,333,37432333
21759,42,1807600,5,10,23,52,375,37432375
21760,75,1807600,1,10,23,52,450,37432450
21761,280,1807500,1,10,23,52,730,37432730
21762,704,1807500,1,10,23,53,434,37433434
21764,386,1807600,1,10,23,53,820,37433820
21765,788,1807500,1,10,23,54,608,37434608
21766,1,1807500,2,10,23,54,609,37434609
21767,608,1807600,1,10,23,55,217,37435217
21768,715,1807700,3,10,23,55,932,37435932
21769,74,1807700,1,10,23,56,6,37436006
21770,2958,1807600,3,10,23,58,964,37438964
21771,284,1807700,1,10,23,59,248,37439248
21772,458,1807600,1,10,23,59,706,37439706
21773,291,1807500,1,10,23,59,997,37439997
21774,632,1807700,4,10,24,0,629,37440629
21775,326,1807600,1,10,24,0,955,37440955
21776,107,1807800,1,10,24,1,62,37441062
21777,2295,1807800,4,10,24,3,357,37443357
21778,0,1807800,4,10,24,3,357,37443357
21779,0,1807800,4,10,24,3,357,37443357
21781,42,1808000,5,10,24,3,399,37443399
21782,3,1808000,2,10,24,3,402,37443402
21783,41,1808000,1,10,24,3,443,37443443
21784,646,1807900,1,10,24,4,89,37444089
21785,2076,1807900,2,10,24,6,165,37446165
21786,890,1808000,1,10,24,7,55,37447055
21787,1,1808000,1,10,24,7,56,37447056
21788,44,1808100,1,10,24,7,100,37447100
21789,1487,1808000,2,10,24,8,587,37448587
21790,431,1807900,4,10,24,9,18,37449018
21792,483,1807800,1,10,24,9,501,37449501
21793,235,1807800,3,10,24,9,736,37449736
21795,1217,1807700,4,10,24,10,953,37450953
21796,434,1807900,10,10,24,11,387,37451387
21797,2,1807900,1,10,24,11,389,37451389
21798,1490,1807900,1,10,24,12,879,37452879
21799,3908,1807800,1,10,24,16,787,37456787
21800,21,1807700,1,10,24,16,808,37456808
21801,477,1807700,1,10,24,17,285,37457285
21802,2500,1807800,1,10,24,19,785,37459785
21803,411,1807800,1,10,24,20,196,37460196
21804,3265,1807700,1,10,24,23,461,37463461
21805,132,1807700,1,10,24,23,593,37463593
21806,752,1807700,5,10,24,24,345,37464345
21807,3,1807700,2,10,24,24,348,37464348
21808,16,1807600,1,10,24,24,364,37464364
21809,1268,1807600,1,10,24,25,632,37465632
21810,2250,1807600,1,10,24,27,882,37467882
21811,0,1807600,6,10,24,27,882,37467882
21812,1806,1807500,1,10,24,29,688,37469688
21813,22,1807500,2,10,24,29,710,37469710
21814,225,1807600,1,10,24,29,935,37469935
21815,1927,1807600,1,10,24,31,862,37471862
21816,560,1807600,1,10,24,32,422,37472422
21817,4,1807600,1,10,24,32,426,37472426
21818,78,1807600,1,10,24,32,504,37472504
21819,1873,1807600,1,10,24,34,377,37474377
21820,1506,1807600,1,10,24,35,883,37475883
21821,4003,1807500,2,10,24,39,886,37479886
21822,187,1807600,1,10,24,40,73,37480073
21823,829,1807500,1,10,24,40,902,37480902
21824,1,1807500,13,10,24,40,903,37480903
21825,99,1807400,5,10,24,41,2,37481002
21826,1572,1807500,2,10,24,42,574,37482574
21827,1967,1807400,1,10,24,44,541,37484541
21828,133,1807400,1,10,24,44,674,37484674
21829,3370,1807400,7,10,24,48,44,37488044
21830,1322,1807500,2,10,24,49,366,37489366
21831,1,1807500,1,10,24,49,367,37489367
21832,0,1807500,1,10,24,49,367,37489367
21833,1480,1807400,1,10,24,50,847,37490847
21834,529,1807400,10,10,24,51,376,37491376
21835,1372,1807500,1,10,24,52,748,37492748
21836,387,1807400,1,10,24,53,135,37493135
21837,74,1807500,1,10,24,53,209,37493209
21838,39,1807400,1,10,24,53,248,37493248
21839,1698,1807300,3,10,24,54,946,37494946
21840,71,1807300,1,10,24,55,17,37495017
21841,175,1807400,10,10,24,55,192,37495192
21842,320,1807400,1,10,24,55,512,37495512
21843,620,1807500,2,10,24,56,132,37496132
21844,356,1807500,2,10,24,56,488,37496488
21845,0,1807500,2,10,24,56,488,37496488
21847,1467,1807500,6,10,24,57,955,37497955
21849,3,1807600,6,10,24,57,958,37497958
21850,72,1807700,13,10,24,58,30,37498030
21851,71,1807600,1,10,24,58,101,37498101
21852,67,1807600,1,10,24,58,168,37498168
21853,918,1807600,1,10,24,59,86,37499086
21854,599,1807700,1,10,24,59,685,37499685
21855,137,1807800,2,10,24,59,822,37499822
21856,2,1807800,2,10,24,59,824,37499824
21857,2,1807800,2,10,24,59,826,37499826
21858,333,1807700,6,10,25,0,159,37500159
21860,165,1807800,1,10,25,0,324,37500324
21861,38,1807800,3,10,25,0,362,37500362
21862,53,1807800,1,10,25,0,415,37500415
21863,42,1807800,1,10,25,0,457,37500457
21864,13,1807800,2,10,25,0,470,37500470
21865,4,1807800,4,10,25,0,474,37500474
21866,31,1807700,2,10,25,0,505,37500505
21867,50,1807800,6,10,25,0,555,37500555
21868,1,1807700,1,10,25,0,556,37500556
21869,16,1807800,1,10,25,0,572,37500572
21870,19,1807800,1,10,25,0,591,37500591
21871,94,1807800,3,10,25,0,685,37500685
21872,3,1807700,2,10,25,0,688,37500688
21873,7,1807800,1,10,25,0,695,37500695
21874,278,1807800,1,10,25,0,973,37500973
21875,160,1807800,1,10,25,1,133,37501133
21876,1,1807700,1,10,25,1,134,37501134
21877,18,1807800,1,10,25,1,152,37501152
21878,17,1807800,1,10,25,1,169,37501169
21879,11,1807800,2,10,25,1,180,37501180
21880,214,1807800,5,10,25,1,394,37501394
21881,1,1807700,1,10,25,1,395,37501395
21882,165,1807800,1,10,25,1,560,37501560
21883,118,1807800,1,10,25,1,678,37501678
21884,267,1807900,2,10,25,1,945,37501945
21885,205,1807700,2,10,25,2,150,37502150
21886,244,1807900,1,10,25,2,394,37502394
21887,138,1807900,1,10,25,2,532,37502532
21888,24,1807900,1,10,25,2,556,37502556
21889,50,1807800,1,10,25,2,606,37502606
21890,402,1807700,7,10,25,3,8,37503008
21891,1,1807700,1,10,25,3,9,37503009
21892,0,1807700,1,10,25,3,9,37503009
21893,0,1807700,1,10,25,3,9,37503009
21894,19,1807600,3,10,25,3,28,37503028
21895,233,1807800,1,10,25,3,261,37503261
21896,210,1807700,1,10,25,3,471,37503471
21897,1153,1807700,2,10,25,4,624,37504624
21898,281,1807600,1,10,25,4,905,37504905
21899,836,1807600,3,10,25,5,741,37505741
21900,172,1807700,3,10,25,5,913,37505913
21902,370,1807600,7,10,25,6,283,37506283
21903,266,1807600,7,10,25,6,549,37506549
21904,0,1807600,7,10,25,6,549,37506549
21906,33,1807600,1,10,25,6,582,37506582
21907,7,1807700,3,10,25,6,589,37506589
21908,1247,1807700,1,10,25,7,836,37507836
21909,640,1807700,3,10,25,8,476,37508476
21910,185,1807700,1,10,25,8,661,37508661
21911,1107,1807700,1,10,25,9,768,37509768
21912,1,1807700,4,10,25,9,769,37509769
21913,1033,1807600,1,10,25,10,802,37510802
21914,1380,1807700,1,10,25,12,182,37512182
21916,1111,1807700,1,10,25,13,293,37513293
21917,2655,1807800,1,10,25,15,948,37515948
21918,666,1807700,2,10,25,16,614,37516614
21919,87,1807700,1,10,25,16,701,37516701
21920,319,1807700,1,10,25,17,20,37517020
21921,160,1807700,1,10,25,17,180,37517180
21922,1008,1807800,2,10,25,18,188,37518188
21923,1056,1807700,1,10,25,19,244,37519244
21924,0,1807700,2,10,25,19,244,37519244
21925,1725,1807700,5,10,25,20,969,37520969
21926,1228,1807700,1,10,25,22,197,37522197
21927,577,1807800,1,10,25,22,774,37522774
21928,241,1807800,5,10,25,23,15,37523015
21929,30,1807900,5,10,25,23,45,37523045
21930,189,1808000,1,10,25,23,234,37523234
21931,0,1808000,19,10,25,23,234,37523234
21932,2,1808100,1,10,25,23,236,37523236
21933,18,1808100,1,10,25,23,254,37523254
21934,40,1808100,2,10,25,23,294,37523294
21935,1,1808100,1,10,25,23,295,37523295
21936,0,1808100,35,10,25,23,295,37523295
21937,0,1808100,4,10,25,23,295,37523295
21938,1,1808200,4,10,25,23,296,37523296
21939,58,1808100,3,10,25,23,354,37523354
21940,1,1808100,2,10,25,23,355,37523355
21941,400,1808100,2,10,25,23,755,37523755
21942,248,1808100,1,10,25,24,3,37524003
21943,53,1808100,2,10,25,24,56,37524056
21944,50,1808100,2,10,25,24,106,37524106
21945,60,1808100,2,10,25,24,166,37524166
21946,117,1808000,5,10,25,24,283,37524283
21947,0,1808000,5,10,25,24,283,37524283
21949,2099,1808000,2,10,25,26,382,37526382
21950,2197,1807800,1,10,25,28,579,37528579
21951,316,1807700,1,10,25,28,895,37528895
21952,932,1807800,1,10,25,29,827,37529827
21953,149,1807900,2,10,25,29,976,37529976
21954,1283,1807900,1,10,25,31,259,37531259
21955,2054,1807900,3,10,25,33,313,37533313
21956,13,1808000,5,10,25,33,326,37533326
21957,1019,1808100,1,10,25,34,345,37534345
21958,162,1808100,1,10,25,34,507,37534507
21959,660,1808100,1,10,25,35,167,37535167
21960,429,1808100,1,10,25,35,596,37535596
21961,208,1808100,1,10,25,35,804,37535804
21962,416,1808100,2,10,25,36,220,37536220
21963,1,1808100,3,10,25,36,221,37536221
21964,56,1808100,3,10,25,36,277,37536277
21965,801,1808100,1,10,25,37,78,37537078
21966,1296,1808100,1,10,25,38,374,37538374
21967,1,1808100,2,10,25,38,375,37538375
21968,161,1808100,1,10,25,38,536,37538536
21969,3564,1808100,1,10,25,42,100,37542100
21970,164,1808100,1,10,25,42,264,37542264
21971,157,1808100,1,10,25,42,421,37542421
21972,178,1808100,1,10,25,42,599,37542599
21973,1,1808100,1,10,25,42,600,37542600
21974,1109,1808100,1,10,25,43,709,37543709
21975,226,1808100,1,10,25,43,935,37543935
21976,182,1808100,1,10,25,44,117,37544117
21977,567,1808100,1,10,25,44,684,37544684
21978,462,1808100,1,10,25,45,146,37545146
21979,209,1808100,1,10,25,45,355,37545355
21980,1536,1808100,3,10,25,46,891,37546891
21981,1494,1808000,2,10,25,48,385,37548385
21982,1245,1808100,2,10,25,49,630,37549630
21983,202,1808100,3,10,25,49,832,37549832
21984,746,1808200,2,10,25,50,578,37550578
21985,1291,1808200,1,10,25,51,869,37551869
21986,1029,1808100,1,10,25,52,898,37552898
21987,532,1808100,1,10,25,53,430,37553430
21988,2288,1808200,1,10,25,55,718,37555718
21989,670,1808200,1,10,25,56,388,37556388
21990,6,1808200,11,10,25,56,394,37556394
21991,1,1808200,6,10,25,56,395,37556395
21992,84,1808100,8,10,25,56,479,37556479
21993,414,1808200,1,10,25,56,893,37556893
21994,634,1808200,2,10,25,57,527,37557527
21995,554,1808100,1,10,25,58,81,37558081
21996,2,1808100,1,10,25,58,83,37558083
21998,1027,1808100,1,10,25,59,110,37559110
21999,132,1808100,1,10,25,59,242,37559242
22000,1131,1808200,2,10,26,0,373,37560373
22001,85,1808300,3,10,26,0,458,37560458
22002,2,1808300,3,10,26,0,460,37560460
22003,0,1808300,6,10,26,0,460,37560460
22004,72,1808300,4,10,26,0,532,37560532
22005,0,1808300,1,10,26,0,532,37560532
22007,39,1808400,4,10,26,0,571,37560571
22008,68,1808400,1,10,26,0,639,37560639
22009,0,1808400,2,10,26,0,639,37560639
22010,9,1808400,2,10,26,0,648,37560648
22011,0,1808400,2,10,26,0,648,37560648
22012,60,1808200,1,10,26,0,708,37560708
22013,65,1808300,2,10,26,0,773,37560773
22014,2,1808300,2,10,26,0,775,37560775
22015,0,1808300,2,10,26,0,775,37560775
22016,12,1808100,1,10,26,0,787,37560787
22017,107,1808300,5,10,26,0,894,37560894
22018,241,1808300,4,10,26,1,135,37561135
22019,666,1808200,1,10,26,1,801,37561801
22020,1,1808400,1,10,26,1,802,37561802
22021,1214,1808400,15,10,26,3,16,37563016
22022,150,1808400,1,10,26,3,166,37563166
22023,1055,1808400,1,10,26,4,221,37564221
22024,0,1808400,1,10,26,4,221,37564221
22025,936,1808300,1,10,26,5,157,37565157
22026,0,1808300,1,10,26,5,157,37565157
22027,0,1808300,1,10,26,5,157,37565157
22028,0,1808300,1,10,26,5,157,37565157
22029,0,1808300,1,10,26,5,157,37565157
22030,235,1808300,1,10,26,5,392,37565392
22031,848,1808200,1,10,26,6,240,37566240
22032,0,1808200,1,10,26,6,240,37566240
22033,4572,1808300,1,10,26,10,812,37570812
22034,232,1808400,1,10,26,11,44,37571044
22035,257,1808200,1,10,26,11,301,37571301
22036,14,1808400,1,10,26,11,315,37571315
22037,1064,1808300,1,10,26,12,379,37572379
22038,101,1808300,5,10,26,12,480,37572480
22039,0,1808300,5,10,26,12,480,37572480
22041,191,1808100,1,10,26,12,671,37572671
22042,516,1808200,1,10,26,13,187,37573187
22043,144,1808300,1,10,26,13,331,37573331
22044,1394,1808200,1,10,26,14,725,37574725
22045,295,1808200,1,10,26,15,20,37575020
22046,35,1808300,1,10,26,15,55,37575055
22047,633,1808300,1,10,26,15,688,37575688
22048,235,1808300,1,10,26,15,923,37575923
22049,213,1808300,1,10,26,16,136,37576136
22050,84,1808200,1,10,26,16,220,37576220
22051,123,1808300,1,10,26,16,343,37576343
22052,234,1808400,1,10,26,16,577,37576577
22053,191,1808200,2,10,26,16,768,37576768
22054,137,1808200,1,10,26,16,905,37576905
22055,223,1808200,1,10,26,17,128,37577128
22056,642,1808400,1,10,26,17,770,37577770
22057,263,1808200,1,10,26,18,33,37578033
22058,242,1808200,1,10,26,18,275,37578275
22059,245,1808200,1,10,26,18,520,37578520
22060,1638,1808200,1,10,26,20,158,37580158
22061,0,1808200,1,10,26,20,158,37580158
22062,0,1808200,1,10,26,20,158,37580158
22063,0,1808200,1,10,26,20,158,37580158
22064,3591,1808200,2,10,26,23,749,37583749
22065,695,1808200,1,10,26,24,444,37584444
22066,46,1808200,2,10,26,24,490,37584490
22067,919,1808300,1,10,26,25,409,37585409
22068,1,1808300,3,10,26,25,410,37585410
22069,622,1808300,1,10,26,26,32,37586032
22070,767,1808300,1,10,26,26,799,37586799
22071,635,1808300,1,10,26,27,434,37587434
22072,101,1808300,1,10,26,27,535,37587535
22073,103,1808400,6,10,26,27,638,37587638
22074,38,1808300,1,10,26,27,676,37587676
22075,329,1808400,6,10,26,28,5,37588005
22076,237,1808400,1,10,26,28,242,37588242
22077,333,1808500,2,10,26,28,575,37588575
22078,57,1808500,1,10,26,28,632,37588632
22079,1,1808500,1,10,26,28,633,37588633
22080,1,1808500,2,10,26,28,634,37588634
22081,1,1808500,1,10,26,28,635,37588635
22082,0,1808500,1,10,26,28,635,37588635
22083,0,1808500,4,10,26,28,635,37588635
22084,0,1808500,1,10,26,28,635,37588635
22085,0,1808500,1,10,26,28,635,37588635
22086,0,1808500,1,10,26,28,635,37588635
22087,1,1808500,2,10,26,28,636,37588636
22088,0,1808500,7,10,26,28,636,37588636
22089,0,1808500,13,10,26,28,636,37588636
22090,1,1808600,1,10,26,28,637,37588637
22091,0,1808600,1,10,26,28,637,37588637
22092,1,1808600,1,10,26,28,638,37588638
22093,0,1808600,1,10,26,28,638,37588638
22094,0,1808600,1,10,26,28,638,37588638
22095,3,1808600,2,10,26,28,641,37588641
22096,3,1808600,2,10,26,28,644,37588644
22097,13,1808500,1,10,26,28,657,37588657
22098,10,1808600,2,10,26,28,667,37588667
22099,45,1808700,1,10,26,28,712,37588712
22100,2,1808700,1,10,26,28,714,37588714
22101,3,1808700,4,10,26,28,717,37588717
22102,2,1808700,1,10,26,28,719,37588719
22103,4,1808700,2,10,26,28,723,37588723
22104,9,1808700,1,10,26,28,732,37588732
22105,6,1808700,2,10,26,28,738,37588738
22106,2,1808700,1,10,26,28,740,37588740
22107,10,1808700,4,10,26,28,750,37588750
22108,23,1808700,1,10,26,28,773,37588773
22109,7,1808700,2,10,26,28,780,37588780
22110,1,1808700,2,10,26,28,781,37588781
22111,0,1808700,2,10,26,28,781,37588781
22112,9,1808700,2,10,26,28,790,37588790
22113,90,1808600,1,10,26,28,880,37588880
22114,26,1808600,1,10,26,28,906,37588906
22115,12,1808700,1,10,26,28,918,37588918
22116,10,1808700,1,10,26,28,928,37588928
22117,10,1808600,1,10,26,28,938,37588938
22118,7,1808800,2,10,26,28,945,37588945
22119,34,1808800,1,10,26,28,979,37588979
22120,42,1808800,1,10,26,29,21,37589021
22121,83,1808800,1,10,26,29,104,37589104
22122,15,1808800,1,10,26,29,119,37589119
22123,40,1808800,1,10,26,29,159,37589159
22124,81,1808800,1,10,26,29,240,37589240
22125,82,1808800,2,10,26,29,322,37589322
22126,1,1808800,3,10,26,29,323,37589323
22127,18,1808800,2,10,26,29,341,37589341
22128,9,1808800,1,10,26,29,350,37589350
22129,9,1808700,1,10,26,29,359,37589359
22130,13,1808800,1,10,26,29,372,37589372
22131,43,1808800,1,10,26,29,415,37589415
22132,27,1808800,1,10,26,29,442,37589442
22133,31,1808800,1,10,26,29,473,37589473
22134,35,1808600,1,10,26,29,508,37589508
22135,1,1808800,4,10,26,29,509,37589509
22136,13,1808800,3,10,26,29,522,37589522
22137,1,1808800,1,10,26,29,523,37589523
22138,18,1808800,1,10,26,29,541,37589541
22139,33,1808700,1,10,26,29,574,37589574
22140,385,1808800,1,10,26,29,959,37589959
22141,27,1808600,5,10,26,29,986,37589986
22142,154,1808600,1,10,26,30,140,37590140
22143,72,1808600,2,10,26,30,212,37590212
22144,46,1808700,1,10,26,30,258,37590258
22145,3,1808600,1,10,26,30,261,37590261
22146,4,1808800,1,10,26,30,265,37590265
22147,692,1808700,2,10,26,30,957,37590957
22148,12,1808700,3,10,26,30,969,37590969
22150,285,1808700,1,10,26,31,254,37591254
22151,107,1808700,1,10,26,31,361,37591361
22152,159,1808800,1,10,26,31,520,37591520
22153,486,1808800,1,10,26,32,6,37592006
22154,36,1808800,1,10,26,32,42,37592042
22155,249,1808800,2,10,26,32,291,37592291
22156,9,1808800,2,10,26,32,300,37592300
22157,199,1808800,3,10,26,32,499,37592499
22158,17,1808800,4,10,26,32,516,37592516
22159,9,1808800,4,10,26,32,525,37592525
22160,631,1808900,1,10,26,33,156,37593156
22161,18,1808900,1,10,26,33,174,37593174
22162,10,1808900,1,10,26,33,184,37593184
22163,97,1808900,2,10,26,33,281,37593281
22164,6,1808900,1,10,26,33,287,37593287
22165,0,1808900,1,10,26,33,287,37593287
22166,19,1808900,2,10,26,33,306,37593306
22167,5,1808800,1,10,26,33,311,37593311
22168,524,1808900,1,10,26,33,835,37593835
22169,570,1808900,1,10,26,34,405,37594405
22170,297,1808900,2,10,26,34,702,37594702
22171,10,1808900,1,10,26,34,712,37594712
22172,49,1808900,1,10,26,34,761,37594761
22173,160,1808800,1,10,26,34,921,37594921
22174,83,1808900,1,10,26,35,4,37595004
22175,63,1808900,1,10,26,35,67,37595067
22176,71,1809000,1,10,26,35,138,37595138
22177,8,1809000,1,10,26,35,146,37595146
22178,15,1809000,1,10,26,35,161,37595161
22179,45,1809000,1,10,26,35,206,37595206
22180,5,1809000,1,10,26,35,211,37595211
22181,16,1809000,1,10,26,35,227,37595227
22182,6,1809000,1,10,26,35,233,37595233
22183,20,1808900,1,10,26,35,253,37595253
22184,4,1809000,1,10,26,35,257,37595257
22185,3,1809000,4,10,26,35,260,37595260
22186,29,1809000,1,10,26,35,289,37595289
22187,4,1809000,1,10,26,35,293,37595293
22188,18,1809000,1,10,26,35,311,37595311
22189,4,1809000,1,10,26,35,315,37595315
22190,1,1809000,1,10,26,35,316,37595316
22191,58,1809000,1,10,26,35,374,37595374
22192,8,1809000,4,10,26,35,382,37595382
22193,34,1809000,1,10,26,35,416,37595416
22194,33,1809000,3,10,26,35,449,37595449
22195,21,1809000,1,10,26,35,470,37595470
22196,27,1809000,1,10,26,35,497,37595497
22197,41,1809000,2,10,26,35,538,37595538
22198,210,1809000,1,10,26,35,748,37595748
22199,24,1809000,2,10,26,35,772,37595772
22200,4,1809000,1,10,26,35,776,37595776
22201,27,1809000,1,10,26,35,803,37595803
22202,25,1809000,1,10,26,35,828,37595828
22203,216,1808900,1,10,26,36,44,37596044
22204,148,1809000,1,10,26,36,192,37596192
22205,101,1809000,1,10,26,36,293,37596293
22206,58,1809000,1,10,26,36,351,37596351
22207,93,1809000,1,10,26,36,444,37596444
22208,78,1809000,1,10,26,36,522,37596522
22209,247,1808900,1,10,26,36,769,37596769
22210,153,1809000,1,10,26,36,922,37596922
22211,42,1809000,1,10,26,36,964,37596964
22212,75,1809000,1,10,26,37,39,37597039
22213,284,1809000,1,10,26,37,323,37597323
22214,20,1809000,1,10,26,37,343,37597343
22215,220,1809000,1,10,26,37,563,37597563
22216,69,1808900,1,10,26,37,632,37597632
22217,0,1808900,1,10,26,37,632,37597632
22218,10,1809000,1,10,26,37,642,37597642
22219,33,1808900,1,10,26,37,675,37597675
22220,167,1808900,1,10,26,37,842,37597842
22221,10,1809000,1,10,26,37,852,37597852
22222,92,1808900,1,10,26,37,944,37597944
22223,29,1808900,1,10,26,37,973,37597973
22224,188,1809000,2,10,26,38,161,37598161
22225,69,1808900,1,10,26,38,230,37598230
22226,216,1809000,1,10,26,38,446,37598446
22227,8,1808900,1,10,26,38,454,37598454
22228,278,1809000,2,10,26,38,732,37598732
22229,116,1808900,5,10,26,38,848,37598848
22230,6,1808900,1,10,26,38,854,37598854
22231,14,1808900,10,10,26,38,868,37598868
22232,105,1808900,4,10,26,38,973,37598973
22233,714,1808800,1,10,26,39,687,37599687
22234,59,1808800,1,10,26,39,746,37599746
22235,1161,1808800,1,10,26,40,907,37600907
22236,1,1808800,19,10,26,40,908,37600908
22237,648,1808700,1,10,26,41,556,37601556
22238,1,1808700,1,10,26,41,557,37601557
22239,0,1808700,3,10,26,41,557,37601557
22240,0,1808700,1,10,26,41,557,37601557
22241,0,1808700,1,10,26,41,557,37601557
22242,0,1808700,8,10,26,41,557,37601557
22243,1,1808700,1,10,26,41,558,37601558
22244,206,1808600,1,10,26,41,764,37601764
22245,204,1808600,1,10,26,41,968,37601968
22246,1120,1808700,2,10,26,43,88,37603088
22248,74,1808800,1,10,26,43,162,37603162
22249,240,1808700,1,10,26,43,402,37603402
22250,29,1808800,6,10,26,43,431,37603431
22251,545,1808800,2,10,26,43,976,37603976
22252,72,1808700,1,10,26,44,48,37604048
22253,525,1808800,1,10,26,44,573,37604573
22254,118,1808800,1,10,26,44,691,37604691
22255,430,1808700,1,10,26,45,121,37605121
22256,1254,1808700,5,10,26,46,375,37606375
22257,65,1808600,1,10,26,46,440,37606440
22258,47,1808700,2,10,26,46,487,37606487
22259,1264,1808600,3,10,26,47,751,37607751
22260,212,1808700,1,10,26,47,963,37607963
22261,1969,1808700,1,10,26,49,932,37609932
22262,372,1808700,1,10,26,50,304,37610304
22263,777,1808700,5,10,26,51,81,37611081
22264,431,1808600,1,10,26,51,512,37611512
22265,40,1808600,1,10,26,51,552,37611552
22266,194,1808600,1,10,26,51,746,37611746
22267,115,1808700,3,10,26,51,861,37611861
22268,618,1808600,1,10,26,52,479,37612479
22269,0,1808600,1,10,26,52,479,37612479
22270,1282,1808500,4,10,26,53,761,37613761
22271,36,1808600,1,10,26,53,797,37613797
22272,664,1808500,1,10,26,54,461,37614461
22273,632,1808600,2,10,26,55,93,37615093
22274,63,1808600,1,10,26,55,156,37615156
22276,34,1808500,1,10,26,55,190,37615190
22277,2093,1808500,1,10,26,57,283,37617283
22278,467,1808600,8,10,26,57,750,37617750
22279,108,1808600,1,10,26,57,858,37617858
22280,373,1808700,11,10,26,58,231,37618231
22281,0,1808700,1,10,26,58,231,37618231
22282,0,1808700,1,10,26,58,231,37618231
22283,1,1808700,1,10,26,58,232,37618232
22284,1139,1808700,1,10,26,59,371,37619371
22285,409,1808600,1,10,26,59,780,37619780
22286,1145,1808600,1,10,27,0,925,37620925
22287,65,1808700,3,10,27,0,990,37620990
22288,1,1808700,11,10,27,0,991,37620991
22289,457,1808700,1,10,27,1,448,37621448
22290,28,1808800,1,10,27,1,476,37621476
22291,143,1808800,2,10,27,1,619,37621619
22292,3,1808800,1,10,27,1,622,37621622
22293,22,1808700,1,10,27,1,644,37621644
22294,20,1808800,2,10,27,1,664,37621664
22295,83,1808800,2,10,27,1,747,37621747
22296,9,1808800,2,10,27,1,756,37621756
22297,63,1808800,1,10,27,1,819,37621819
22298,0,1808800,1,10,27,1,819,37621819
22299,0,1808800,2,10,27,1,819,37621819
22300,1,1808800,3,10,27,1,820,37621820
22301,0,1808800,4,10,27,1,820,37621820
22302,5,1808900,2,10,27,1,825,37621825
22303,2,1808800,1,10,27,1,827,37621827
22305,9,1808700,2,10,27,1,836,37621836
22306,40,1808900,1,10,27,1,876,37621876
22307,7,1808900,1,10,27,1,883,37621883
22308,66,1808900,5,10,27,1,949,37621949
22309,261,1808700,2,10,27,2,210,37622210
22310,2,1808600,2,10,27,2,212,37622212
22311,192,1808800,1,10,27,2,404,37622404
22312,194,1808800,1,10,27,2,598,37622598
22313,25,1808800,1,10,27,2,623,37622623
22314,80,1808600,1,10,27,2,703,37622703
22315,258,1808800,2,10,27,2,961,37622961
22316,487,1808800,2,10,27,3,448,37623448
22318,130,1808800,1,10,27,3,578,37623578
22319,0,1808800,2,10,27,3,578,37623578
22320,384,1808800,2,10,27,3,962,37623962
22321,932,1808600,1,10,27,4,894,37624894
22322,1361,1808600,7,10,27,6,255,37626255
22323,201,1808700,1,10,27,6,456,37626456
22324,795,1808500,1,10,27,7,251,37627251
22325,0,1808500,6,10,27,7,251,37627251
22326,1,1808500,4,10,27,7,252,37627252
22327,54,1808600,1,10,27,7,306,37627306
22328,45,1808600,1,10,27,7,351,37627351
22329,1040,1808600,1,10,27,8,391,37628391
22330,961,1808600,2,10,27,9,352,37629352
22331,698,1808500,1,10,27,10,50,37630050
22332,1954,1808600,1,10,27,12,4,37632004
22333,961,1808500,4,10,27,12,965,37632965
22334,1301,1808600,1,10,27,14,266,37634266
22335,204,1808600,2,10,27,14,470,37634470
22336,74,1808600,1,10,27,14,544,37634544
22337,1802,1808700,1,10,27,16,346,37636346
22338,688,1808600,1,10,27,17,34,37637034
22339,66,1808700,1,10,27,17,100,37637100
22340,1209,1808700,2,10,27,18,309,37638309
22341,1606,1808600,1,10,27,19,915,37639915
22342,271,1808700,1,10,27,20,186,37640186
22343,605,1808800,1,10,27,20,791,37640791
22344,423,1808800,3,10,27,21,214,37641214
22345,0,1808800,2,10,27,21,214,37641214
22346,0,1808800,2,10,27,21,214,37641214
22347,1530,1808800,1,10,27,22,744,37642744
22348,180,1808800,1,10,27,22,924,37642924
22349,607,1808800,1,10,27,23,531,37643531
22350,88,1808900,1,10,27,23,619,37643619
22351,912,1808800,1,10,27,24,531,37644531
22352,176,1808800,1,10,27,24,707,37644707
22353,141,1808700,1,10,27,24,848,37644848
22354,4,1808700,2,10,27,24,852,37644852
22355,7,1808600,1,10,27,24,859,37644859
22356,390,1808700,1,10,27,25,249,37645249
22357,587,1808800,1,10,27,25,836,37645836
22358,372,1808700,1,10,27,26,208,37646208
22359,2696,1808600,1,10,27,28,904,37648904
22360,71,1808700,1,10,27,28,975,37648975
22361,1,1808700,1,10,27,28,976,37648976
22362,0,1808700,1,10,27,28,976,37648976
22363,0,1808800,1,10,27,28,976,37648976
22364,0,1808800,1,10,27,28,976,37648976
22365,0,1808800,1,10,27,28,976,37648976
22366,0,1808800,1,10,27,28,976,37648976
22367,1,1808700,1,10,27,28,977,37648977
22368,472,1808700,1,10,27,29,449,37649449
22369,168,1808800,1,10,27,29,617,37649617
22370,177,1808600,1,10,27,29,794,37649794
22371,307,1808700,1,10,27,30,101,37650101
22372,136,1808700,1,10,27,30,237,37650237
22373,1359,1808700,1,10,27,31,596,37651596
22374,1289,1808700,1,10,27,32,885,37652885
22375,300,1808700,1,10,27,33,185,37653185
22376,347,1808800,1,10,27,33,532,37653532
22377,1834,1808700,2,10,27,35,366,37655366
22378,1631,1808700,1,10,27,36,997,37656997
22379,2009,1808700,1,10,27,39,6,37659006
22380,175,1808600,1,10,27,39,181,37659181
22381,1364,1808600,1,10,27,40,545,37660545
22382,762,1808600,1,10,27,41,307,37661307
22383,1916,1808700,1,10,27,43,223,37663223
22384,1403,1808600,2,10,27,44,626,37664626
22385,185,1808600,1,10,27,44,811,37664811
22386,2082,1808600,1,10,27,46,893,37666893
22387,107,1808600,1,10,27,47,0,37667000
22388,1737,1808700,1,10,27,48,737,37668737
22389,3866,1808700,1,10,27,52,603,37672603
22390,2409,1808600,1,10,27,55,12,37675012
22391,247,1808600,1,10,27,55,259,37675259
22392,843,1808700,3,10,27,56,102,37676102
22393,80,1808700,4,10,27,56,182,37676182
22394,1349,1808700,2,10,27,57,531,37677531
22395,0,1808700,1,10,27,57,531,37677531
22396,127,1808700,2,10,27,57,658,37677658
22397,1853,1808700,1,10,27,59,511,37679511
22398,0,1808700,1,10,27,59,511,37679511
22399,264,1808700,1,10,27,59,775,37679775
22401,1690,1808700,1,10,28,1,465,37681465
22402,95,1808700,1,10,28,1,560,37681560
22403,2658,1808800,8,10,28,4,218,37684218
22404,7,1808900,1,10,28,4,225,37684225
22405,122,1808800,1,10,28,4,347,37684347
22406,1204,1808900,1,10,28,5,551,37685551
22407,469,1808900,1,10,28,6,20,37686020
22408,135,1808900,5,10,28,6,155,37686155
22409,1,1808900,1,10,28,6,156,37686156
22410,0,1808900,1,10,28,6,156,37686156
22411,0,1808900,2,10,28,6,156,37686156
22412,0,1808900,1,10,28,6,156,37686156
22413,41,1808900,1,10,28,6,197,37686197
22414,1,1808900,8,10,28,6,198,37686198
22415,23,1808900,1,10,28,6,221,37686221
22416,565,1809000,1,10,28,6,786,37686786
22417,826,1808900,2,10,28,7,612,37687612
22418,114,1809000,1,10,28,7,726,37687726
22419,0,1809000,1,10,28,7,726,37687726
22420,115,1808800,2,10,28,7,841,37687841
22421,82,1809000,1,10,28,7,923,37687923
22422,304,1809000,1,10,28,8,227,37688227
22423,158,1808800,2,10,28,8,385,37688385
22424,1523,1809000,1,10,28,9,908,37689908
22425,2911,1808900,1,10,28,12,819,37692819
22426,2137,1808800,2,10,28,14,956,37694956
22427,1525,1808900,1,10,28,16,481,37696481
22428,89,1808800,1,10,28,16,570,37696570
22429,605,1808800,3,10,28,17,175,37697175
22430,50,1808800,1,10,28,17,225,37697225
22431,1,1808800,1,10,28,17,226,37697226
22432,0,1808800,1,10,28,17,226,37697226
22433,0,1808900,1,10,28,17,226,37697226
22434,0,1808800,1,10,28,17,226,37697226
22435,1,1808800,1,10,28,17,227,37697227
22436,914,1808700,9,10,28,18,141,37698141
22437,99,1808700,1,10,28,18,240,37698240
22438,120,1808600,1,10,28,18,360,37698360
22439,51,1808600,2,10,28,18,411,37698411
22440,0,1808600,1,10,28,18,411,37698411
22441,0,1808600,1,10,28,18,411,37698411
22442,0,1808600,1,10,28,18,411,37698411
22443,1,1808600,9,10,28,18,412,37698412
22444,115,1808600,1,10,28,18,527,37698527
22445,438,1808700,1,10,28,18,965,37698965
22447,184,1808800,1,10,28,19,149,37699149
22448,17,1808800,1,10,28,19,166,37699166
22449,876,1808600,1,10,28,20,42,37700042
22450,112,1808600,1,10,28,20,154,37700154
22451,1941,1808600,1,10,28,22,95,37702095
22453,1,1808700,2,10,28,22,96,37702096
22454,84,1808600,1,10,28,22,180,37702180
22455,149,1808700,2,10,28,22,329,37702329
22456,1401,1808700,1,10,28,23,730,37703730
22457,2300,1808700,1,10,28,26,30,37706030
22458,970,1808700,1,10,28,27,0,37707000
22459,3635,1808800,4,10,28,30,635,37710635
22460,950,1808800,1,10,28,31,585,37711585
22461,534,1808800,1,10,28,32,119,37712119
22462,239,1808800,1,10,28,32,358,37712358
22463,398,1808800,1,10,28,32,756,37712756
22464,1245,1808800,1,10,28,34,1,37714001
22465,290,1808900,3,10,28,34,291,37714291
22466,0,1808900,1,10,28,34,291,37714291
22467,2,1809000,5,10,28,34,293,37714293
22468,256,1809000,1,10,28,34,549,37714549
22469,1034,1808900,1,10,28,35,583,37715583
22470,204,1808900,1,10,28,35,787,37715787
22471,331,1808900,1,10,28,36,118,37716118
22472,160,1808900,1,10,28,36,278,37716278
22473,26,1808900,2,10,28,36,304,37716304
22474,2689,1808900,1,10,28,38,993,37718993
22475,1250,1808900,1,10,28,40,243,37720243
22476,863,1809000,7,10,28,41,106,37721106
22477,17,1809000,1,10,28,41,123,37721123
22478,105,1809000,1,10,28,41,228,37721228
22479,282,1809000,1,10,28,41,510,37721510
22480,1,1809000,1,10,28,41,511,37721511
22481,4145,1808800,2,10,28,45,656,37725656
22482,653,1809000,1,10,28,46,309,37726309
22483,2094,1809000,2,10,28,48,403,37728403
22484,896,1808900,1,10,28,49,299,37729299
22485,128,1809000,1,10,28,49,427,37729427
22486,907,1809000,1,10,28,50,334,37730334
22487,525,1809000,3,10,28,50,859,37730859
22488,196,1809000,1,10,28,51,55,37731055
22489,1115,1809000,1,10,28,52,170,37732170
22490,1,1809000,1,10,28,52,171,37732171
22491,0,1809000,1,10,28,52,171,37732171
22492,0,1809000,1,10,28,52,171,37732171
22493,113,1809000,2,10,28,52,284,37732284
22494,203,1809000,1,10,28,52,487,37732487
22495,58,1809000,2,10,28,52,545,37732545
22496,49,1808900,1,10,28,52,594,37732594
22497,174,1809000,4,10,28,52,768,37732768
22498,360,1809000,1,10,28,53,128,37733128
22499,140,1809000,1,10,28,53,268,37733268
22500,56,1809000,1,10,28,53,324,37733324
22501,1603,1809000,1,10,28,54,927,37734927
22502,629,1809000,1,10,28,55,556,37735556
22503,168,1809100,2,10,28,55,724,37735724
22504,212,1809100,2,10,28,55,936,37735936
22505,25,1809100,1,10,28,55,961,37735961
22506,8,1809100,1,10,28,55,969,37735969
22507,9,1809100,2,10,28,55,978,37735978
22508,18,1809000,1,10,28,55,996,37735996
22509,104,1809100,15,10,28,56,100,37736100
22510,82,1809200,2,10,28,56,182,37736182
22511,44,1809200,9,10,28,56,226,37736226
22512,8,1809200,1,10,28,56,234,37736234
22513,63,1809200,1,10,28,56,297,37736297
22514,66,1809200,1,10,28,56,363,37736363
22515,46,1809200,4,10,28,56,409,37736409
22516,7,1809200,1,10,28,56,416,37736416
22517,30,1809200,3,10,28,56,446,37736446
22518,33,1809100,1,10,28,56,479,37736479
22519,53,1809200,2,10,28,56,532,37736532
22520,60,1809100,1,10,28,56,592,37736592
22521,124,1809200,1,10,28,56,716,37736716
22522,0,1809200,1,10,28,56,716,37736716
22523,32,1809200,1,10,28,56,748,37736748
22525,17,1809300,1,10,28,56,765,37736765
22526,30,1809300,1,10,28,56,795,37736795
22527,0,1809300,1,10,28,56,795,37736795
22528,18,1809300,1,10,28,56,813,37736813
22529,2,1809300,1,10,28,56,815,37736815
22530,3,1809300,1,10,28,56,818,37736818
22531,0,1809300,1,10,28,56,818,37736818
22532,4,1809300,1,10,28,56,822,37736822
22533,11,1809300,1,10,28,56,833,37736833
22534,25,1809300,2,10,28,56,858,37736858
22535,27,1809300,2,10,28,56,885,37736885
22536,23,1809300,1,10,28,56,908,37736908
22537,463,1809300,1,10,28,57,371,37737371
22538,393,1809100,2,10,28,57,764,37737764
22539,221,1809100,3,10,28,57,985,37737985
22541,828,1809200,2,10,28,58,813,37738813
22542,62,1809200,6,10,28,58,875,37738875
22543,13,1809200,2,10,28,58,888,37738888
22544,0,1809200,2,10,28,58,888,37738888
22545,122,1809100,2,10,28,59,10,37739010
22546,4,1809100,1,10,28,59,14,37739014
22547,4,1809100,7,10,28,59,18,37739018
22549,108,1809100,1,10,28,59,126,37739126
22550,1122,1809200,1,10,29,0,248,37740248
22551,143,1809100,5,10,29,0,391,37740391
22552,44,1809100,1,10,29,0,435,37740435
22553,105,1809200,1,10,29,0,540,37740540
22554,56,1809200,1,10,29,0,596,37740596
22555,223,1809200,1,10,29,0,819,37740819
22556,839,1809300,1,10,29,1,658,37741658
22557,219,1809300,1,10,29,1,877,37741877
22558,99,1809300,1,10,29,1,976,37741976
22559,97,1809300,5,10,29,2,73,37742073
22560,75,1809300,1,10,29,2,148,37742148
22561,151,1809300,1,10,29,2,299,37742299
22562,71,1809300,1,10,29,2,370,37742370
22563,45,1809300,1,10,29,2,415,37742415
22564,96,1809300,1,10,29,2,511,37742511
22565,6,1809200,4,10,29,2,517,37742517
22566,12,1809300,3,10,29,2,529,37742529
22567,118,1809300,1,10,29,2,647,37742647
22568,77,1809200,1,10,29,2,724,37742724
22569,2,1809200,1,10,29,2,726,37742726
22570,375,1809300,1,10,29,3,101,37743101
22571,190,1809300,1,10,29,3,291,37743291
22572,53,1809200,1,10,29,3,344,37743344
22573,13,1809300,1,10,29,3,357,37743357
22574,52,1809200,1,10,29,3,409,37743409
22575,217,1809200,1,10,29,3,626,37743626
22576,237,1809200,1,10,29,3,863,37743863
22577,9,1809200,1,10,29,3,872,37743872
22578,2,1809300,2,10,29,3,874,37743874
22579,24,1809200,1,10,29,3,898,37743898
22580,541,1809300,3,10,29,4,439,37744439
22581,469,1809200,1,10,29,4,908,37744908
22582,39,1809200,3,10,29,4,947,37744947
22583,719,1809100,6,10,29,5,666,37745666
22584,1,1809100,9,10,29,5,667,37745667
22585,622,1809000,1,10,29,6,289,37746289
22586,81,1809000,1,10,29,6,370,37746370
22587,894,1809100,1,10,29,7,264,37747264
22588,341,1809100,1,10,29,7,605,37747605
22589,133,1809000,1,10,29,7,738,37747738
22590,1093,1809100,4,10,29,8,831,37748831
22591,295,1809000,1,10,29,9,126,37749126
22592,122,1809000,1,10,29,9,248,37749248
22593,1566,1809000,1,10,29,10,814,37750814
22594,191,1809100,3,10,29,11,5,37751005
22595,1113,1809000,1,10,29,12,118,37752118
22596,412,1809000,1,10,29,12,530,37752530
22597,203,1809000,1,10,29,12,733,37752733
22598,1,1809000,26,10,29,12,734,37752734
22599,1355,1808900,9,10,29,14,89,37754089
22600,0,1808900,2,10,29,14,89,37754089
22601,0,1808900,1,10,29,14,89,37754089
22602,587,1808900,6,10,29,14,676,37754676
22604,396,1808900,1,10,29,15,72,37755072
22605,102,1808900,1,10,29,15,174,37755174
22606,749,1808900,1,10,29,15,923,37755923
22607,1325,1808900,3,10,29,17,248,37757248
22608,1367,1808900,1,10,29,18,615,37758615
22609,579,1808900,1,10,29,19,194,37759194
22610,54,1808900,1,10,29,19,248,37759248
22611,254,1809000,4,10,29,19,502,37759502
22612,3870,1808800,4,10,29,23,372,37763372
22613,122,1808800,1,10,29,23,494,37763494
22614,721,1808900,3,10,29,24,215,37764215
22615,0,1808900,1,10,29,24,215,37764215
22616,0,1808900,2,10,29,24,215,37764215
22617,42,1808900,1,10,29,24,257,37764257
22618,959,1808900,1,10,29,25,216,37765216
22619,570,1808900,10,10,29,25,786,37765786
22620,223,1809000,1,10,29,26,9,37766009
22621,242,1808900,1,10,29,26,251,37766251
22622,876,1808900,1,10,29,27,127,37767127
22623,1578,1808900,1,10,29,28,705,37768705
22624,175,1808800,1,10,29,28,880,37768880
22625,3280,1808900,1,10,29,32,160,37772160
22626,224,1808900,3,10,29,32,384,37772384
22627,95,1808900,1,10,29,32,479,37772479
22628,2180,1808800,2,10,29,34,659,37774659
22629,1,1808800,17,10,29,34,660,37774660
22630,91,1808800,3,10,29,34,751,37774751
22632,108,1808700,1,10,29,34,859,37774859
22633,284,1808700,2,10,29,35,143,37775143
22634,783,1808700,2,10,29,35,926,37775926
22635,150,1808700,1,10,29,36,76,37776076
22636,82,1808700,3,10,29,36,158,37776158
22638,35,1808700,1,10,29,36,193,37776193
22639,1013,1808600,12,10,29,37,206,37777206
22640,73,1808500,2,10,29,37,279,37777279
22641,81,1808600,1,10,29,37,360,37777360
22642,85,1808500,1,10,29,37,445,37777445
22643,1207,1808600,1,10,29,38,652,37778652
22644,2,1808600,2,10,29,38,654,37778654
22645,105,1808700,1,10,29,38,759,37778759
22646,259,1808700,1,10,29,39,18,37779018
22647,1043,1808600,1,10,29,40,61,37780061
22648,1197,1808500,3,10,29,41,258,37781258
22649,55,1808700,10,10,29,41,313,37781313
22650,152,1808600,2,10,29,41,465,37781465
22651,839,1808600,1,10,29,42,304,37782304
22652,1347,1808700,1,10,29,43,651,37783651
22653,1,1808700,2,10,29,43,652,37783652
22654,2576,1808700,5,10,29,46,228,37786228
22655,337,1808800,1,10,29,46,565,37786565
22656,458,1808700,1,10,29,47,23,37787023
22657,174,1808700,2,10,29,47,197,37787197
22658,1329,1808800,4,10,29,48,526,37788526
22659,306,1808700,1,10,29,48,832,37788832
22660,2674,1808700,1,10,29,51,506,37791506
22661,597,1808800,1,10,29,52,103,37792103
22662,120,1808800,1,10,29,52,223,37792223
22663,712,1808700,1,10,29,52,935,37792935
22664,533,1808700,1,10,29,53,468,37793468
22665,54,1808700,1,10,29,53,522,37793522
22666,1175,1808800,1,10,29,54,697,37794697
22667,143,1808700,1,10,29,54,840,37794840
22668,836,1808800,1,10,29,55,676,37795676
22669,670,1808700,1,10,29,56,346,37796346
22670,23,1808800,1,10,29,56,369,37796369
22671,229,1808700,1,10,29,56,598,37796598
22672,327,1808700,2,10,29,56,925,37796925
22673,260,1808800,1,10,29,57,185,37797185
22674,2841,1808700,1,10,30,0,26,37800026
22675,157,1808800,1,10,30,0,183,37800183
22676,13,1808800,1,10,30,0,196,37800196
22677,73,1808600,1,10,30,0,269,37800269
22678,73,1808600,2,10,30,0,342,37800342
22679,37,1808800,1,10,30,0,379,37800379
22680,138,1808600,1,10,30,0,517,37800517
22681,33,1808600,1,10,30,0,550,37800550
22682,64,1808800,2,10,30,0,614,37800614
22683,40,1808600,1,10,30,0,654,37800654
22684,35,1808800,1,10,30,0,689,37800689
22685,40,1808800,1,10,30,0,729,37800729
22686,275,1808700,1,10,30,1,4,37801004
22687,303,1808700,2,10,30,1,307,37801307
22688,41,1808600,2,10,30,1,348,37801348
22689,75,1808600,1,10,30,1,423,37801423
22690,2,1808600,1,10,30,1,425,37801425
22691,50,1808700,3,10,30,1,475,37801475
22692,35,1808700,2,10,30,1,510,37801510
22693,1,1808700,1,10,30,1,511,37801511
22694,49,1808700,1,10,30,1,560,37801560
22695,65,1808800,1,10,30,1,625,37801625
22696,50,1808600,1,10,30,1,675,37801675
22697,84,1808800,1,10,30,1,759,37801759
22698,2,1808800,1,10,30,1,761,37801761
22699,9,1808800,1,10,30,1,770,37801770
22700,45,1808600,2,10,30,1,815,37801815
22701,10,1808600,3,10,30,1,825,37801825
22702,20,1808500,2,10,30,1,845,37801845
22703,9,1808500,1,10,30,1,854,37801854
22704,24,1808500,4,10,30,1,878,37801878
22705,26,1808500,2,10,30,1,904,37801904
22706,23,1808500,2,10,30,1,927,37801927
22707,35,1808500,1,10,30,1,962,37801962
22708,1,1808500,6,10,30,1,963,37801963
22709,3,1808500,1,10,30,1,966,37801966
22710,8,1808500,1,10,30,1,974,37801974
22711,6,1808500,1,10,30,1,980,37801980
22712,13,1808500,2,10,30,1,993,37801993
22713,1,1808500,1,10,30,1,994,37801994
22714,233,1808400,1,10,30,2,227,37802227
22715,114,1808500,2,10,30,2,341,37802341
22716,400,1808400,1,10,30,2,741,37802741
22717,37,1808500,1,10,30,2,778,37802778
22718,35,1808400,1,10,30,2,813,37802813
22719,153,1808400,1,10,30,2,966,37802966
22720,4,1808500,2,10,30,2,970,37802970
22721,77,1808500,2,10,30,3,47,37803047
22722,15,1808600,1,10,30,3,62,37803062
22723,1461,1808700,1,10,30,4,523,37804523
22724,748,1808600,1,10,30,5,271,37805271
22725,36,1808400,2,10,30,5,307,37805307
22726,4,1808400,2,10,30,5,311,37805311
22727,1095,1808600,3,10,30,6,406,37806406
22728,206,1808700,2,10,30,6,612,37806612
22729,124,1808500,2,10,30,6,736,37806736
22730,6,1808500,1,10,30,6,742,37806742
22731,169,1808500,1,10,30,6,911,37806911
22732,4916,1808600,1,10,30,11,827,37811827
22733,3521,1808700,1,10,30,15,348,37815348
22734,277,1808700,3,10,30,15,625,37815625
22735,967,1808600,2,10,30,16,592,37816592
22736,262,1808600,1,10,30,16,854,37816854
22737,32,1808600,1,10,30,16,886,37816886
22738,16,1808600,1,10,30,16,902,37816902
22739,2247,1808600,1,10,30,19,149,37819149
22740,1911,1808700,5,10,30,21,60,37821060
22741,1017,1808800,3,10,30,22,77,37822077
22742,1,1808800,11,10,30,22,78,37822078
22743,133,1808800,1,10,30,22,211,37822211
22744,1405,1808700,1,10,30,23,616,37823616
22745,993,1808900,3,10,30,24,609,37824609
22746,0,1808900,4,10,30,24,609,37824609
22747,0,1808900,3,10,30,24,609,37824609
22748,0,1808900,1,10,30,24,609,37824609
22749,0,1808900,3,10,30,24,609,37824609
22750,0,1808900,1,10,30,24,609,37824609
22751,0,1808900,1,10,30,24,609,37824609
22752,1,1808900,1,10,30,24,610,37824610
22753,0,1808900,1,10,30,24,610,37824610
22754,0,1808900,1,10,30,24,610,37824610
22755,272,1808900,1,10,30,24,882,37824882
22756,126,1808900,10,10,30,25,8,37825008
22757,925,1808900,2,10,30,25,933,37825933
22758,363,1809000,1,10,30,26,296,37826296
22759,209,1808900,5,10,30,26,505,37826505
22760,114,1809000,6,10,30,26,619,37826619
22761,0,1809000,1,10,30,26,619,37826619
22762,0,1809000,7,10,30,26,619,37826619
22763,1,1809000,1,10,30,26,620,37826620
22764,0,1809000,8,10,30,26,620,37826620
22765,7,1809100,5,10,30,26,627,37826627
22766,11,1809000,1,10,30,26,638,37826638
22767,304,1809000,1,10,30,26,942,37826942
22768,43,1809000,1,10,30,26,985,37826985
22769,6,1809000,1,10,30,26,991,37826991
22770,25,1808800,1,10,30,27,16,37827016
22771,14,1809000,1,10,30,27,30,37827030
22772,2064,1809000,1,10,30,29,94,37829094
22773,1962,1809000,5,10,30,31,56,37831056
22774,369,1808900,1,10,30,31,425,37831425
22775,5166,1808900,1,10,30,36,591,37836591
22776,2121,1808800,4,10,30,38,712,37838712
22777,36,1808700,1,10,30,38,748,37838748
22778,699,1808800,1,10,30,39,447,37839447
22779,1135,1808700,1,10,30,40,582,37840582
22780,325,1808700,1,10,30,40,907,37840907
22781,427,1808800,3,10,30,41,334,37841334
22782,3779,1808700,2,10,30,45,113,37845113
22783,580,1808800,1,10,30,45,693,37845693
22784,2385,1808700,3,10,30,48,78,37848078
22785,250,1808800,1,10,30,48,328,37848328
22786,890,1808700,2,10,30,49,218,37849218
22787,492,1808700,1,10,30,49,710,37849710
22788,0,1808700,2,10,30,49,710,37849710
22789,0,1808700,3,10,30,49,710,37849710
22790,1,1808700,1,10,30,49,711,37849711
22791,0,1808700,12,10,30,49,711,37849711
22792,1273,1808600,7,10,30,50,984,37850984
22793,126,1808600,2,10,30,51,110,37851110
22794,3042,1808600,2,10,30,54,152,37854152
22795,3361,1808700,2,10,30,57,513,37857513
22796,1,1808700,2,10,30,57,514,37857514
22797,0,1808700,1,10,30,57,514,37857514
22798,741,1808600,1,10,30,58,255,37858255
22799,2379,1808700,1,10,31,0,634,37860634
22800,403,1808700,1,10,31,1,37,37861037
22801,33,1808700,3,10,31,1,70,37861070
22802,0,1808700,2,10,31,1,70,37861070
22803,523,1808600,1,10,31,1,593,37861593
22804,139,1808600,1,10,31,1,732,37861732
22805,339,1808700,1,10,31,2,71,37862071
22806,676,1808700,1,10,31,2,747,37862747
22807,1085,1808700,1,10,31,3,832,37863832
22808,1,1808700,1,10,31,3,833,37863833
22809,1074,1808600,1,10,31,4,907,37864907
22810,1210,1808700,1,10,31,6,117,37866117
22811,2916,1808800,1,10,31,9,33,37869033
22812,276,1808800,1,10,31,9,309,37869309
22813,1,1808800,1,10,31,9,310,37869310
22814,0,1808800,3,10,31,9,310,37869310
22815,0,1808800,2,10,31,9,310,37869310
22816,0,1808800,1,10,31,9,310,37869310
22817,0,1808800,1,10,31,9,310,37869310
22818,538,1808900,1,10,31,9,848,37869848
22819,392,1808800,4,10,31,10,240,37870240
22821,1027,1808900,17,10,31,11,267,37871267
22822,2187,1808800,1,10,31,13,454,37873454
22823,2791,1808800,1,10,31,16,245,37876245
22824,519,1808800,1,10,31,16,764,37876764
22825,5439,1808900,1,10,31,22,203,37882203
22826,735,1808900,17,10,31,22,938,37882938
22827,308,1808900,1,10,31,23,246,37883246
22828,380,1808900,3,10,31,23,626,37883626
22829,1216,1808900,1,10,31,24,842,37884842
22830,3626,1808900,1,10,31,28,468,37888468
22831,42,1809000,2,10,31,28,510,37888510
22832,400,1808800,1,10,31,28,910,37888910
22833,2053,1809000,1,10,31,30,963,37890963
22834,74,1809000,1,10,31,31,37,37891037
22835,23,1809000,1,10,31,31,60,37891060
22836,4598,1809000,1,10,31,35,658,37895658
22837,586,1808900,5,10,31,36,244,37896244
22838,114,1808900,1,10,31,36,358,37896358
22839,230,1808800,1,10,31,36,588,37896588
22840,1756,1808800,1,10,31,38,344,37898344
22841,5786,1808900,2,10,31,44,130,37904130
22842,507,1808900,1,10,31,44,637,37904637
22843,390,1808900,1,10,31,45,27,37905027
22844,1259,1808800,1,10,31,46,286,37906286
22845,1492,1808900,1,10,31,47,778,37907778
22846,661,1808800,2,10,31,48,439,37908439
22847,4460,1808800,1,10,31,52,899,37912899
22848,234,1808800,3,10,31,53,133,37913133
22849,74,1808800,1,10,31,53,207,37913207
22850,1063,1808800,1,10,31,54,270,37914270
22851,174,1808900,1,10,31,54,444,37914444
22852,1357,1808800,2,10,31,55,801,37915801
22853,2584,1808800,1,10,31,58,385,37918385
22854,582,1808800,1,10,31,58,967,37918967
22855,720,1808700,1,10,31,59,687,37919687
22856,1986,1808800,1,10,32,1,673,37921673
22857,0,1808800,1,10,32,1,673,37921673
22858,0,1808800,1,10,32,1,673,37921673
22859,752,1808800,4,10,32,2,425,37922425
22860,3625,1808800,1,10,32,6,50,37926050
22861,0,1808800,2,10,32,6,50,37926050
22862,1,1808800,2,10,32,6,51,37926051
22863,1293,1808700,1,10,32,7,344,37927344
22864,656,1808700,14,10,32,8,0,37928000
22865,3803,1808800,7,10,32,11,803,37931803
22866,325,1808700,1,10,32,12,128,37932128
22867,1226,1808600,1,10,32,13,354,37933354
22868,4149,1808600,17,10,32,17,503,37937503
22869,0,1808600,1,10,32,17,503,37937503
22870,0,1808600,4,10,32,17,503,37937503
22871,1,1808600,3,10,32,17,504,37937504
22872,665,1808600,1,10,32,18,169,37938169
22873,656,1808500,2,10,32,18,825,37938825
22874,465,1808600,1,10,32,19,290,37939290
22875,213,1808600,1,10,32,19,503,37939503
22876,1682,1808600,1,10,32,21,185,37941185
22877,192,1808600,1,10,32,21,377,37941377
22878,722,1808700,1,10,32,22,99,37942099
22879,2317,1808600,1,10,32,24,416,37944416
22880,749,1808600,8,10,32,25,165,37945165
22881,66,1808700,1,10,32,25,231,37945231
22882,3986,1808700,6,10,32,29,217,37949217
22883,423,1808800,1,10,32,29,640,37949640
22884,64,1808800,9,10,32,29,704,37949704
22885,1348,1808900,1,10,32,31,52,37951052
22886,3133,1808800,1,10,32,34,185,37954185
22887,565,1808900,1,10,32,34,750,37954750
22888,1164,1808900,1,10,32,35,914,37955914
22889,225,1808900,1,10,32,36,139,37956139
22890,1003,1808900,4,10,32,37,142,37957142
22891,919,1808900,1,10,32,38,61,37958061
22892,509,1808900,2,10,32,38,570,37958570
22893,116,1809000,3,10,32,38,686,37958686
22894,224,1809000,3,10,32,38,910,37958910
22895,1,1809000,3,10,32,38,911,37958911
22896,4,1809000,1,10,32,38,915,37958915
22897,17,1809000,1,10,32,38,932,37958932
22898,704,1809000,1,10,32,39,636,37959636
22899,46,1809000,1,10,32,39,682,37959682
22900,1242,1809000,1,10,32,40,924,37960924
22901,1481,1809000,1,10,32,42,405,37962405
22902,188,1809000,6,10,32,42,593,37962593
22903,2796,1808900,1,10,32,45,389,37965389
22904,1048,1808900,1,10,32,46,437,37966437
22905,27,1809000,1,10,32,46,464,37966464
22906,85,1809000,1,10,32,46,549,37966549
22907,123,1809000,10,10,32,46,672,37966672
22908,176,1808900,1,10,32,46,848,37966848
22909,1132,1809000,5,10,32,47,980,37967980
22910,186,1809000,1,10,32,48,166,37968166
22911,1676,1809100,27,10,32,49,842,37969842
22912,2,1809200,1,10,32,49,844,37969844
22913,0,1809200,1,10,32,49,844,37969844
22914,1393,1809200,1,10,32,51,237,37971237
22915,171,1809100,1,10,32,51,408,37971408
22916,561,1809100,1,10,32,51,969,37971969
22917,2099,1809100,1,10,32,54,68,37974068
22918,537,1809100,1,10,32,54,605,37974605
22919,76,1809100,1,10,32,54,681,37974681
22920,52,1809100,5,10,32,54,733,37974733
22921,1,1809100,1,10,32,54,734,37974734
22922,372,1809000,3,10,32,55,106,37975106
22923,1245,1809100,1,10,32,56,351,37976351
22924,485,1809100,1,10,32,56,836,37976836
22925,2687,1809000,2,10,32,59,523,37979523
22926,1,1809000,2,10,32,59,524,37979524
22927,0,1809000,1,10,32,59,524,37979524
22928,4,1809000,2,10,32,59,528,37979528
22929,0,1809000,1,10,32,59,528,37979528
22930,644,1809100,1,10,33,0,172,37980172
22931,243,1809000,3,10,33,0,415,37980415
22933,137,1808900,1,10,33,0,552,37980552
22934,3,1808900,1,10,33,0,555,37980555
22935,30,1808900,1,10,33,0,585,37980585
22936,7,1808900,2,10,33,0,592,37980592
22937,62,1808800,1,10,33,0,654,37980654
22938,0,1808800,1,10,33,0,654,37980654
22939,0,1808800,1,10,33,0,654,37980654
22940,1,1808800,1,10,33,0,655,37980655
22941,6,1808800,1,10,33,0,661,37980661
22942,1,1808800,1,10,33,0,662,37980662
22943,125,1808900,1,10,33,0,787,37980787
22944,48,1808800,1,10,33,0,835,37980835
22945,50,1808800,1,10,33,0,885,37980885
22946,49,1808800,2,10,33,0,934,37980934
22947,194,1808700,2,10,33,1,128,37981128
22948,356,1808900,1,10,33,1,484,37981484
22949,39,1808800,1,10,33,1,523,37981523
22951,6,1808700,4,10,33,1,529,37981529
22952,65,1808700,3,10,33,1,594,37981594
22954,5,1808800,1,10,33,1,599,37981599
22955,51,1808700,1,10,33,1,650,37981650
22956,133,1808900,6,10,33,1,783,37981783
22957,156,1808700,2,10,33,1,939,37981939
22958,53,1808900,1,10,33,1,992,37981992
22959,2,1808900,1,10,33,1,994,37981994
22960,72,1808900,1,10,33,2,66,37982066
22961,71,1808900,1,10,33,2,137,37982137
22962,472,1808700,2,10,33,2,609,37982609
22963,83,1808700,1,10,33,2,692,37982692
22964,64,1808600,1,10,33,2,756,37982756
22965,175,1808600,1,10,33,2,931,37982931
22966,270,1808800,3,10,33,3,201,37983201
22967,10,1808800,3,10,33,3,211,37983211
22968,3,1808800,1,10,33,3,214,37983214
22969,303,1808700,1,10,33,3,517,37983517
22970,97,1808700,2,10,33,3,614,37983614
22971,57,1808800,3,10,33,3,671,37983671
22972,2169,1808600,8,10,33,5,840,37985840
22973,43,1808600,1,10,33,5,883,37985883
22975,0,1808700,9,10,33,5,883,37985883
22977,1350,1808600,1,10,33,7,233,37987233
22978,398,1808600,1,10,33,7,631,37987631
22979,276,1808600,1,10,33,7,907,37987907
22980,2938,1808600,1,10,33,10,845,37990845
22981,701,1808700,6,10,33,11,546,37991546
22982,1,1808700,4,10,33,11,547,37991547
22983,34,1808600,1,10,33,11,581,37991581
22984,378,1808600,2,10,33,11,959,37991959
22985,998,1808600,1,10,33,12,957,37992957
22986,1148,1808600,2,10,33,14,105,37994105
22987,561,1808600,1,10,33,14,666,37994666
22988,173,1808600,1,10,33,14,839,37994839
22989,264,1808700,7,10,33,15,103,37995103
22990,1372,1808700,1,10,33,16,475,37996475
22991,156,1808700,2,10,33,16,631,37996631
22992,134,1808700,1,10,33,16,765,37996765
22993,1,1808700,2,10,33,16,766,37996766
22994,509,1808700,1,10,33,17,275,37997275
22995,36,1808600,2,10,33,17,311,37997311
22996,1625,1808600,2,10,33,18,936,37998936
22997,1639,1808700,1,10,33,20,575,38000575
22998,800,1808600,1,10,33,21,375,38001375
22999,403,1808600,1,10,33,21,778,38001778
23000,239,1808600,1,10,33,22,17,38002017
23001,428,1808600,1,10,33,22,445,38002445
23002,704,1808600,1,10,33,23,149,38003149
23003,785,1808700,1,10,33,23,934,38003934
23004,705,1808600,1,10,33,24,639,38004639
23005,5,1808600,1,10,33,24,644,38004644
23006,0,1808600,1,10,33,24,644,38004644
23007,831,1808600,1,10,33,25,475,38005475
23008,1218,1808600,1,10,33,26,693,38006693
23009,74,1808600,2,10,33,26,767,38006767
23010,44,1808500,2,10,33,26,811,38006811
23011,204,1808700,1,10,33,27,15,38007015
23012,1296,1808600,1,10,33,28,311,38008311
23013,1123,1808700,1,10,33,29,434,38009434
23014,208,1808600,1,10,33,29,642,38009642
23015,755,1808600,1,10,33,30,397,38010397
23016,999,1808500,1,10,33,31,396,38011396
23017,0,1808500,1,10,33,31,396,38011396
23018,0,1808500,1,10,33,31,396,38011396
23019,0,1808500,2,10,33,31,396,38011396
23020,0,1808500,1,10,33,31,396,38011396
23021,1,1808500,1,10,33,31,397,38011397
23022,1,1808500,4,10,33,31,398,38011398
23023,0,1808500,1,10,33,31,398,38011398
23024,0,1808500,1,10,33,31,398,38011398
23025,0,1808500,1,10,33,31,398,38011398
23026,12,1808500,9,10,33,31,410,38011410
23027,37,1808500,1,10,33,31,447,38011447
23028,994,1808400,1,10,33,32,441,38012441
23029,518,1808400,1,10,33,32,959,38012959
23030,443,1808500,1,10,33,33,402,38013402
23031,147,1808400,1,10,33,33,549,38013549
23032,57,1808500,1,10,33,33,606,38013606
23033,78,1808400,15,10,33,33,684,38013684
23034,1,1808400,9,10,33,33,685,38013685
23035,833,1808300,1,10,33,34,518,38014518
23036,177,1808300,4,10,33,34,695,38014695
23037,92,1808300,1,10,33,34,787,38014787
23038,42,1808300,1,10,33,34,829,38014829
23039,535,1808300,2,10,33,35,364,38015364
23040,22,1808300,11,10,33,35,386,38015386
23041,1,1808300,1,10,33,35,387,38015387
23042,0,1808300,1,10,33,35,387,38015387
23043,0,1808300,1,10,33,35,387,38015387
23044,501,1808200,1,10,33,35,888,38015888
23045,109,1808200,1,10,33,35,997,38015997
23046,25,1808200,1,10,33,36,22,38016022
23047,12,1808200,1,10,33,36,34,38016034
23048,16,1808200,1,10,33,36,50,38016050
23049,26,1808300,1,10,33,36,76,38016076
23050,2,1808200,1,10,33,36,78,38016078
23051,15,1808200,1,10,33,36,93,38016093
23052,3260,1808300,1,10,33,39,353,38019353
23053,670,1808300,1,10,33,40,23,38020023
23054,1461,1808200,2,10,33,41,484,38021484
23055,180,1808300,1,10,33,41,664,38021664
23056,652,1808300,1,10,33,42,316,38022316
23057,190,1808300,1,10,33,42,506,38022506
23058,914,1808200,1,10,33,43,420,38023420
23059,102,1808200,5,10,33,43,522,38023522
23060,1866,1808200,1,10,33,45,388,38025388
23061,621,1808300,1,10,33,46,9,38026009
23062,505,1808200,1,10,33,46,514,38026514
23063,1053,1808200,13,10,33,47,567,38027567
23064,24,1808100,1,10,33,47,591,38027591
23065,60,1808100,1,10,33,47,651,38027651
23066,35,1808100,2,10,33,47,686,38027686
23067,387,1808200,10,10,33,48,73,38028073
23068,1,1808100,1,10,33,48,74,38028074
23069,221,1808100,1,10,33,48,295,38028295
23070,475,1808100,1,10,33,48,770,38028770
23071,155,1808100,1,10,33,48,925,38028925
23072,103,1808200,9,10,33,49,28,38029028
23073,283,1808200,1,10,33,49,311,38029311
23074,885,1808100,1,10,33,50,196,38030196
23075,846,1808200,1,10,33,51,42,38031042
23076,314,1808200,1,10,33,51,356,38031356
23077,104,1808200,1,10,33,51,460,38031460
23078,298,1808200,1,10,33,51,758,38031758
23079,1143,1808200,1,10,33,52,901,38032901
23080,991,1808200,2,10,33,53,892,38033892
23081,1433,1808200,2,10,33,55,325,38035325
23082,31,1808200,6,10,33,55,356,38035356
23083,815,1808300,23,10,33,56,171,38036171
23085,79,1808400,1,10,33,56,250,38036250
23086,203,1808200,2,10,33,56,453,38036453
23087,4,1808200,1,10,33,56,457,38036457
23088,823,1808300,2,10,33,57,280,38037280
23089,6,1808300,1,10,33,57,286,38037286
23090,246,1808300,1,10,33,57,532,38037532
23091,1314,1808300,2,10,33,58,846,38038846
23092,0,1808300,2,10,33,58,846,38038846
23094,2,1808100,1,10,33,58,848,38038848
23095,0,1808200,3,10,33,58,848,38038848
23096,3,1808100,4,10,33,58,851,38038851
23097,57,1808100,3,10,33,58,908,38038908
23098,8,1808000,2,10,33,58,916,38038916
23099,132,1808100,2,10,33,59,48,38039048
23100,56,1808000,2,10,33,59,104,38039104
23101,726,1808000,10,10,33,59,830,38039830
23102,591,1808000,1,10,34,0,421,38040421
23104,76,1807900,1,10,34,0,497,38040497
23105,510,1808100,10,10,34,1,7,38041007
23106,143,1808000,1,10,34,1,150,38041150
23107,173,1807900,3,10,34,1,323,38041323
23108,547,1808000,2,10,34,1,870,38041870
23109,749,1808000,1,10,34,2,619,38042619
23110,275,1808100,1,10,34,2,894,38042894
23111,735,1808100,1,10,34,3,629,38043629
23112,497,1808100,1,10,34,4,126,38044126
23113,1089,1808000,1,10,34,5,215,38045215
23114,48,1808000,5,10,34,5,263,38045263
23115,989,1808100,6,10,34,6,252,38046252
23116,3270,1808100,2,10,34,9,522,38049522
23117,1020,1808000,1,10,34,10,542,38050542
23118,0,1808000,3,10,34,10,542,38050542
23119,55,1807900,4,10,34,10,597,38050597
23120,22,1808000,1,10,34,10,619,38050619
23121,1418,1808000,3,10,34,12,37,38052037
23122,33,1808000,1,10,34,12,70,38052070
23123,294,1808100,1,10,34,12,364,38052364
23124,727,1808100,1,10,34,13,91,38053091
23125,976,1808100,1,10,34,14,67,38054067
23126,1142,1808000,1,10,34,15,209,38055209
23127,541,1808000,1,10,34,15,750,38055750
23128,1060,1808000,1,10,34,16,810,38056810
23129,861,1807900,2,10,34,17,671,38057671
23130,549,1807900,4,10,34,18,220,38058220
23131,1124,1808000,1,10,34,19,344,38059344
23132,1241,1808000,3,10,34,20,585,38060585
23133,26,1807900,2,10,34,20,611,38060611
23134,838,1807900,1,10,34,21,449,38061449
23135,320,1807900,1,10,34,21,769,38061769
23136,2040,1807900,1,10,34,23,809,38063809
23137,84,1807800,1,10,34,23,893,38063893
23138,93,1807800,1,10,34,23,986,38063986
23139,18,1807800,2,10,34,24,4,38064004
23140,73,1807800,1,10,34,24,77,38064077
23141,543,1807800,2,10,34,24,620,38064620
23142,217,1807800,1,10,34,24,837,38064837
23143,286,1807800,3,10,34,25,123,38065123
23144,800,1807800,1,10,34,25,923,38065923
23145,928,1807800,1,10,34,26,851,38066851
23146,368,1807800,1,10,34,27,219,38067219
23147,740,1807900,1,10,34,27,959,38067959
23148,596,1807800,1,10,34,28,555,38068555
23149,104,1807800,1,10,34,28,659,38068659
23150,77,1807900,2,10,34,28,736,38068736
23152,2703,1807900,2,10,34,31,439,38071439
23153,243,1807800,1,10,34,31,682,38071682
23154,959,1807800,1,10,34,32,641,38072641
23155,96,1808000,1,10,34,32,737,38072737
23156,104,1807900,1,10,34,32,841,38072841
23157,977,1807900,1,10,34,33,818,38073818
23158,1874,1807900,1,10,34,35,692,38075692
23159,132,1808000,10,10,34,35,824,38075824
23160,28,1808000,2,10,34,35,852,38075852
23161,79,1808100,1,10,34,35,931,38075931
23162,45,1808100,18,10,34,35,976,38075976
23163,995,1808100,1,10,34,36,971,38076971
23164,77,1808200,2,10,34,37,48,38077048
23165,2060,1808200,2,10,34,39,108,38079108
23166,304,1808200,1,10,34,39,412,38079412
23167,291,1808100,1,10,34,39,703,38079703
23168,398,1808200,1,10,34,40,101,38080101
23169,1,1808200,1,10,34,40,102,38080102
23170,794,1808100,1,10,34,40,896,38080896
23171,3392,1808200,1,10,34,44,288,38084288
23172,1211,1808200,1,10,34,45,499,38085499
23173,1014,1808200,1,10,34,46,513,38086513
23174,217,1808200,1,10,34,46,730,38086730
23175,1519,1808200,3,10,34,48,249,38088249
23176,1035,1808300,5,10,34,49,284,38089284
23177,362,1808200,1,10,34,49,646,38089646
23178,114,1808300,1,10,34,49,760,38089760
23179,1557,1808300,1,10,34,51,317,38091317
23180,295,1808200,3,10,34,51,612,38091612
23181,1,1808100,4,10,34,51,613,38091613
23182,329,1808100,1,10,34,51,942,38091942
23184,636,1808100,1,10,34,52,578,38092578
23185,4289,1808100,1,10,34,56,867,38096867
23186,40,1808000,1,10,34,56,907,38096907
23187,838,1808100,1,10,34,57,745,38097745
23188,973,1808000,1,10,34,58,718,38098718
23189,347,1808000,2,10,34,59,65,38099065
23190,1856,1808000,1,10,35,0,921,38100921
23191,57,1808000,2,10,35,0,978,38100978
23192,0,1808000,1,10,35,0,978,38100978
23193,0,1808000,1,10,35,0,978,38100978
23194,0,1808000,1,10,35,0,978,38100978
23195,1,1808000,1,10,35,0,979,38100979
23196,33,1808000,1,10,35,1,12,38101012
23197,73,1808100,1,10,35,1,85,38101085
23198,16,1808100,2,10,35,1,101,38101101
23199,229,1808100,3,10,35,1,330,38101330
23201,101,1808000,1,10,35,1,431,38101431
23202,98,1808200,1,10,35,1,529,38101529
23203,10,1808200,5,10,35,1,539,38101539
23204,166,1808100,1,10,35,1,705,38101705
23206,324,1808000,1,10,35,2,29,38102029
23207,84,1808100,1,10,35,2,113,38102113
23208,2785,1808100,1,10,35,4,898,38104898
23209,526,1808000,1,10,35,5,424,38105424
23210,512,1808000,1,10,35,5,936,38105936
23211,1184,1808100,1,10,35,7,120,38107120
23212,602,1808100,1,10,35,7,722,38107722
23213,349,1808100,1,10,35,8,71,38108071
23214,30,1808000,1,10,35,8,101,38108101
23215,0,1808000,1,10,35,8,101,38108101
23216,0,1808000,1,10,35,8,101,38108101
23217,0,1808000,1,10,35,8,101,38108101
23218,1,1808000,1,10,35,8,102,38108102
23219,0,1808000,1,10,35,8,102,38108102
23220,530,1807900,1,10,35,8,632,38108632
23221,65,1807900,1,10,35,8,697,38108697
23222,1023,1807900,1,10,35,9,720,38109720
23223,1480,1807900,1,10,35,11,200,38111200
23224,221,1807900,4,10,35,11,421,38111421
23225,29,1807900,1,10,35,11,450,38111450
23226,216,1807900,1,10,35,11,666,38111666
23227,119,1807900,1,10,35,11,785,38111785
23228,99,1807900,1,10,35,11,884,38111884
23229,99,1808000,4,10,35,11,983,38111983
23230,1576,1807900,1,10,35,13,559,38113559
23231,1055,1807800,1,10,35,14,614,38114614
23232,214,1807800,1,10,35,14,828,38114828
23233,494,1807800,1,10,35,15,322,38115322
23234,2309,1807800,2,10,35,17,631,38117631
23235,1,1807800,2,10,35,17,632,38117632
23236,271,1807800,2,10,35,17,903,38117903
23237,627,1807800,1,10,35,18,530,38118530
23238,71,1807800,1,10,35,18,601,38118601
23239,0,1807700,1,10,35,18,601,38118601
23240,164,1807700,1,10,35,18,765,38118765
23241,1308,1807700,2,10,35,20,73,38120073
23242,24,1807700,1,10,35,20,97,38120097
23243,182,1807800,1,10,35,20,279,38120279
23244,777,1807800,5,10,35,21,56,38121056
23245,588,1807900,9,10,35,21,644,38121644
23246,1,1807900,1,10,35,21,645,38121645
23247,19,1807700,1,10,35,21,664,38121664
23248,787,1807800,1,10,35,22,451,38122451
23249,895,1807800,1,10,35,23,346,38123346
23250,1241,1807700,10,10,35,24,587,38124587
23251,1068,1807600,16,10,35,25,655,38125655
23252,142,1807500,1,10,35,25,797,38125797
23253,110,1807500,7,10,35,25,907,38125907
23254,95,1807500,1,10,35,26,2,38126002
23255,824,1807500,1,10,35,26,826,38126826
23256,106,1807500,1,10,35,26,932,38126932
23257,4,1807500,1,10,35,26,936,38126936
23258,0,1807500,1,10,35,26,936,38126936
23259,4,1807500,1,10,35,26,940,38126940
23260,5,1807500,1,10,35,26,945,38126945
23261,10,1807500,1,10,35,26,955,38126955
23262,54,1807500,1,10,35,27,9,38127009
23263,92,1807500,1,10,35,27,101,38127101
23264,7,1807600,1,10,35,27,108,38127108
23265,30,1807500,2,10,35,27,138,38127138
23266,110,1807500,4,10,35,27,248,38127248
23268,17,1807500,1,10,35,27,265,38127265
23269,642,1807500,5,10,35,27,907,38127907
23270,62,1807500,1,10,35,27,969,38127969
23271,279,1807500,5,10,35,28,248,38128248
23272,172,1807400,1,10,35,28,420,38128420
23273,127,1807400,2,10,35,28,547,38128547
23274,45,1807600,1,10,35,28,592,38128592
23275,161,1807400,5,10,35,28,753,38128753
23276,114,1807600,1,10,35,28,867,38128867
23277,173,1807500,1,10,35,29,40,38129040
23278,72,1807500,4,10,35,29,112,38129112
23279,1,1807600,7,10,35,29,113,38129113
23280,112,1807700,1,10,35,29,225,38129225
23281,0,1807700,4,10,35,29,225,38129225
23282,9,1807600,2,10,35,29,234,38129234
23283,1739,1807600,1,10,35,30,973,38130973
23284,56,1807600,6,10,35,31,29,38131029
23285,26,1807700,1,10,35,31,55,38131055
23286,325,1807500,1,10,35,31,380,38131380
23287,93,1807600,3,10,35,31,473,38131473
23288,1624,1807600,3,10,35,33,97,38133097
23289,193,1807500,3,10,35,33,290,38133290
23290,1160,1807500,1,10,35,34,450,38134450
23291,431,1807500,1,10,35,34,881,38134881
23292,464,1807600,2,10,35,35,345,38135345
23293,1631,1807500,5,10,35,36,976,38136976
23294,0,1807500,1,10,35,36,976,38136976
23295,1,1807500,5,10,35,36,977,38136977
23296,0,1807500,1,10,35,36,977,38136977
23297,0,1807500,1,10,35,36,977,38136977
23298,0,1807500,1,10,35,36,977,38136977
23299,0,1807500,1,10,35,36,977,38136977
23300,1202,1807600,1,10,35,38,179,38138179
23301,47,1807500,1,10,35,38,226,38138226
23302,430,1807500,1,10,35,38,656,38138656
23303,54,1807500,1,10,35,38,710,38138710
23304,288,1807600,9,10,35,38,998,38138998
23305,19,1807500,2,10,35,39,17,38139017
23306,1584,1807500,1,10,35,40,601,38140601
23307,2001,1807500,2,10,35,42,602,38142602
23308,773,1807600,1,10,35,43,375,38143375
23309,1294,1807600,1,10,35,44,669,38144669
23310,1546,1807600,4,10,35,46,215,38146215
23311,905,1807600,1,10,35,47,120,38147120
23312,106,1807600,1,10,35,47,226,38147226
23313,54,1807600,2,10,35,47,280,38147280
23314,1,1807600,1,10,35,47,281,38147281
23315,2381,1807600,4,10,35,49,662,38149662
23316,1699,1807600,3,10,35,51,361,38151361
23317,1572,1807600,1,10,35,52,933,38152933
23318,4862,1807500,1,10,35,57,795,38157795
23319,256,1807600,1,10,35,58,51,38158051
23321,8,1807600,5,10,35,58,59,38158059
23322,157,1807600,1,10,35,58,216,38158216
23323,278,1807500,2,10,35,58,494,38158494
23324,3628,1807500,3,10,36,2,122,38162122
23325,237,1807600,1,10,36,2,359,38162359
23326,34,1807600,1,10,36,2,393,38162393
23327,767,1807600,1,10,36,3,160,38163160
23328,65,1807500,1,10,36,3,225,38163225
23329,149,1807600,2,10,36,3,374,38163374
23330,0,1807600,1,10,36,3,374,38163374
23331,390,1807600,9,10,36,3,764,38163764
23333,270,1807500,1,10,36,4,34,38164034
23334,499,1807700,2,10,36,4,533,38164533
23335,1293,1807600,1,10,36,5,826,38165826
23336,730,1807600,1,10,36,6,556,38166556
23337,1451,1807600,1,10,36,8,7,38168007
23338,397,1807600,2,10,36,8,404,38168404
23339,582,1807600,1,10,36,8,986,38168986
23340,1680,1807700,1,10,36,10,666,38170666
23341,1512,1807600,2,10,36,12,178,38172178
23342,253,1807600,1,10,36,12,431,38172431
23343,1716,1807600,1,10,36,14,147,38174147
23344,365,1807600,2,10,36,14,512,38174512
23345,0,1807600,9,10,36,14,512,38174512
23346,21,1807500,1,10,36,14,533,38174533
23347,902,1807600,1,10,36,15,435,38175435
23348,906,1807500,1,10,36,16,341,38176341
23349,567,1807500,1,10,36,16,908,38176908
23350,1668,1807500,5,10,36,18,576,38178576
23351,0,1807500,1,10,36,18,576,38178576
23352,0,1807500,8,10,36,18,576,38178576
23353,1,1807500,1,10,36,18,577,38178577
23354,0,1807500,5,10,36,18,577,38178577
23355,0,1807500,1,10,36,18,577,38178577
23356,2632,1807400,1,10,36,21,209,38181209
23357,1,1807400,1,10,36,21,210,38181210
23358,0,1807400,1,10,36,21,210,38181210
23359,0,1807400,8,10,36,21,210,38181210
23360,0,1807400,5,10,36,21,210,38181210
23361,517,1807500,1,10,36,21,727,38181727
23362,42,1807300,1,10,36,21,769,38181769
23363,2,1807300,2,10,36,21,771,38181771
23364,109,1807300,1,10,36,21,880,38181880
23365,12,1807300,1,10,36,21,892,38181892
23366,23,1807400,1,10,36,21,915,38181915
23367,8,1807300,2,10,36,21,923,38181923
23368,1456,1807300,1,10,36,23,379,38183379
23369,756,1807300,1,10,36,24,135,38184135
23370,19,1807300,4,10,36,24,154,38184154
23371,30,1807400,1,10,36,24,184,38184184
23373,453,1807300,1,10,36,24,637,38184637
23374,1331,1807300,1,10,36,25,968,38185968
23375,2,1807300,3,10,36,25,970,38185970
23376,176,1807300,1,10,36,26,146,38186146
23377,1370,1807400,1,10,36,27,516,38187516
23378,69,1807400,1,10,36,27,585,38187585
23379,790,1807500,2,10,36,28,375,38188375
23380,153,1807500,1,10,36,28,528,38188528
23381,0,1807500,7,10,36,28,528,38188528
23382,0,1807500,2,10,36,28,528,38188528
23383,0,1807500,3,10,36,28,528,38188528
23384,0,1807500,5,10,36,28,528,38188528
23385,0,1807500,2,10,36,28,528,38188528
23386,0,1807500,3,10,36,28,528,38188528
23387,0,1807500,1,10,36,28,528,38188528
23388,0,1807500,1,10,36,28,528,38188528
23389,0,1807500,2,10,36,28,528,38188528
23390,0,1807500,2,10,36,28,528,38188528
23391,0,1807500,1,10,36,28,528,38188528
23392,156,1807500,3,10,36,28,684,38188684
23393,173,1807500,12,10,36,28,857,38188857
23394,116,1807500,1,10,36,28,973,38188973
23395,730,1807500,1,10,36,29,703,38189703
23396,684,1807600,1,10,36,30,387,38190387
23397,144,1807500,1,10,36,30,531,38190531
23398,956,1807500,1,10,36,31,487,38191487
23400,551,1807500,2,10,36,32,38,38192038
23401,464,1807500,1,10,36,32,502,38192502
23402,1786,1807500,1,10,36,34,288,38194288
23403,25,1807500,1,10,36,34,313,38194313
23404,67,1807500,1,10,36,34,380,38194380
23405,83,1807500,1,10,36,34,463,38194463
23406,3,1807500,1,10,36,34,466,38194466
23407,159,1807500,1,10,36,34,625,38194625
23408,208,1807600,1,10,36,34,833,38194833
23409,679,1807700,1,10,36,35,512,38195512
23410,14,1807600,1,10,36,35,526,38195526
23411,1385,1807600,1,10,36,36,911,38196911
23412,40,1807500,1,10,36,36,951,38196951
23413,42,1807500,1,10,36,36,993,38196993
23414,2341,1807700,1,10,36,39,334,38199334
23415,225,1807700,1,10,36,39,559,38199559
23416,716,1807600,1,10,36,40,275,38200275
23417,118,1807700,1,10,36,40,393,38200393
23418,89,1807500,5,10,36,40,482,38200482
23419,556,1807500,1,10,36,41,38,38201038
23420,216,1807500,3,10,36,41,254,38201254
23421,1,1807500,1,10,36,41,255,38201255
23422,175,1807600,1,10,36,41,430,38201430
23423,495,1807700,1,10,36,41,925,38201925
23424,492,1807700,1,10,36,42,417,38202417
23425,313,1807500,1,10,36,42,730,38202730
23426,1183,1807500,6,10,36,43,913,38203913
23427,517,1807500,1,10,36,44,430,38204430
23428,1961,1807400,1,10,36,46,391,38206391
23429,102,1807500,1,10,36,46,493,38206493
23430,13,1807400,1,10,36,46,506,38206506
23431,274,1807500,1,10,36,46,780,38206780
23432,1561,1807400,5,10,36,48,341,38208341
23433,23,1807400,1,10,36,48,364,38208364
23434,57,1807500,1,10,36,48,421,38208421
23435,173,1807400,4,10,36,48,594,38208594
23436,707,1807400,1,10,36,49,301,38209301
23437,0,1807400,2,10,36,49,301,38209301
23438,1,1807300,3,10,36,49,302,38209302
23439,2,1807300,8,10,36,49,304,38209304
23440,0,1807300,1,10,36,49,304,38209304
23441,0,1807300,1,10,36,49,304,38209304
23442,0,1807300,4,10,36,49,304,38209304
23443,0,1807300,1,10,36,49,304,38209304
23444,1,1807300,1,10,36,49,305,38209305
23445,0,1807300,19,10,36,49,305,38209305
23446,49,1807300,1,10,36,49,354,38209354
23447,120,1807200,1,10,36,49,474,38209474
23448,27,1807200,1,10,36,49,501,38209501
23449,1,1807200,2,10,36,49,502,38209502
23450,0,1807200,1,10,36,49,502,38209502
23451,0,1807200,1,10,36,49,502,38209502
23452,0,1807200,1,10,36,49,502,38209502
23453,0,1807200,1,10,36,49,502,38209502
23454,0,1807200,12,10,36,49,502,38209502
23455,1,1807200,1,10,36,49,503,38209503
23456,91,1807100,1,10,36,49,594,38209594
23457,38,1807100,2,10,36,49,632,38209632
23458,1,1807100,2,10,36,49,633,38209633
23459,13,1807100,1,10,36,49,646,38209646
23460,10,1807100,1,10,36,49,656,38209656
23461,35,1807100,5,10,36,49,691,38209691
23462,0,1807100,2,10,36,49,691,38209691
23463,0,1807100,9,10,36,49,691,38209691
23464,121,1807200,1,10,36,49,812,38209812
23465,333,1807000,2,10,36,50,145,38210145
23466,84,1807000,8,10,36,50,229,38210229
23467,169,1807000,1,10,36,50,398,38210398
23468,58,1807200,1,10,36,50,456,38210456
23469,86,1807000,1,10,36,50,542,38210542
23470,258,1807100,1,10,36,50,800,38210800
23471,53,1807000,1,10,36,50,853,38210853
23472,18,1807200,1,10,36,50,871,38210871
23473,205,1807200,1,10,36,51,76,38211076
23474,249,1807000,1,10,36,51,325,38211325
23475,170,1807000,1,10,36,51,495,38211495
23476,272,1807000,1,10,36,51,767,38211767
23477,230,1807000,1,10,36,51,997,38211997
23478,102,1807000,1,10,36,52,99,38212099
23479,24,1807000,2,10,36,52,123,38212123
23480,122,1807000,1,10,36,52,245,38212245
23481,200,1807000,1,10,36,52,445,38212445
23482,122,1807000,2,10,36,52,567,38212567
23483,68,1807000,1,10,36,52,635,38212635
23484,223,1807000,2,10,36,52,858,38212858
23485,285,1807000,3,10,36,53,143,38213143
23486,420,1807000,3,10,36,53,563,38213563
23487,511,1807000,1,10,36,54,74,38214074
23488,181,1807100,4,10,36,54,255,38214255
23489,466,1807000,1,10,36,54,721,38214721
23490,175,1807100,2,10,36,54,896,38214896
23491,810,1807000,1,10,36,55,706,38215706
23492,62,1807100,1,10,36,55,768,38215768
23493,722,1807000,2,10,36,56,490,38216490
23494,100,1807100,1,10,36,56,590,38216590
23495,483,1807100,1,10,36,57,73,38217073
23496,184,1807000,1,10,36,57,257,38217257
23497,85,1807000,5,10,36,57,342,38217342
23498,246,1807100,2,10,36,57,588,38217588
23499,51,1807100,1,10,36,57,639,38217639
23500,45,1807000,1,10,36,57,684,38217684
23501,4,1807000,3,10,36,57,688,38217688
23502,0,1807000,1,10,36,57,688,38217688
23503,461,1806900,2,10,36,58,149,38218149
23504,80,1806900,6,10,36,58,229,38218229
23505,220,1806900,1,10,36,58,449,38218449
23506,52,1807000,1,10,36,58,501,38218501
23507,283,1807000,1,10,36,58,784,38218784
23508,199,1806900,4,10,36,58,983,38218983
23509,271,1806900,1,10,36,59,254,38219254
23510,47,1807000,1,10,36,59,301,38219301
23511,214,1807000,3,10,36,59,515,38219515
23512,85,1806900,3,10,36,59,600,38219600
23514,244,1806800,3,10,36,59,844,38219844
23515,234,1806900,1,10,37,0,78,38220078
23516,79,1807000,4,10,37,0,157,38220157
23517,195,1807100,4,10,37,0,352,38220352
23518,92,1806900,1,10,37,0,444,38220444
23519,44,1806900,1,10,37,0,488,38220488
23520,55,1806900,4,10,37,0,543,38220543
23522,117,1807000,1,10,37,0,660,38220660
23523,441,1807000,1,10,37,1,101,38221101
23524,14,1807000,1,10,37,1,115,38221115
23525,171,1807100,3,10,37,1,286,38221286
23526,531,1807000,1,10,37,1,817,38221817
23527,179,1807100,1,10,37,1,996,38221996
23528,13,1807000,1,10,37,2,9,38222009
23529,32,1807000,2,10,37,2,41,38222041
23530,12,1807000,1,10,37,2,53,38222053
23531,112,1807000,1,10,37,2,165,38222165
23532,17,1807000,2,10,37,2,182,38222182
23533,133,1807000,4,10,37,2,315,38222315
23534,0,1807000,2,10,37,2,315,38222315
23535,1,1807000,1,10,37,2,316,38222316
23536,0,1807000,1,10,37,2,316,38222316
23537,111,1807100,1,10,37,2,427,38222427
23539,176,1807000,1,10,37,2,603,38222603
23540,291,1807000,1,10,37,2,894,38222894
23541,199,1807100,1,10,37,3,93,38223093
23542,431,1807100,1,10,37,3,524,38223524
23543,297,1807100,1,10,37,3,821,38223821
23544,194,1807000,1,10,37,4,15,38224015
23545,121,1807000,1,10,37,4,136,38224136
23546,44,1807000,1,10,37,4,180,38224180
23547,45,1807000,1,10,37,4,225,38224225
23548,21,1807000,2,10,37,4,246,38224246
23549,112,1807100,1,10,37,4,358,38224358
23550,127,1806900,3,10,37,4,485,38224485
23551,833,1807000,1,10,37,5,318,38225318
23552,74,1807000,1,10,37,5,392,38225392
23553,119,1807000,2,10,37,5,511,38225511
23554,351,1807000,1,10,37,5,862,38225862
23555,613,1807000,1,10,37,6,475,38226475
23556,663,1807000,1,10,37,7,138,38227138
23557,0,1807000,4,10,37,7,138,38227138
23558,470,1807000,1,10,37,7,608,38227608
23559,611,1807000,7,10,37,8,219,38228219
23561,1036,1807000,1,10,37,9,255,38229255
23562,952,1807000,1,10,37,10,207,38230207
23563,232,1807000,1,10,37,10,439,38230439
23564,1335,1806900,5,10,37,11,774,38231774
23565,16,1807000,1,10,37,11,790,38231790
23566,1184,1806900,7,10,37,12,974,38232974
23567,0,1806900,1,10,37,12,974,38232974
23568,0,1806900,1,10,37,12,974,38232974
23569,0,1806900,4,10,37,12,974,38232974
23570,0,1806900,1,10,37,12,974,38232974
23571,0,1806900,1,10,37,12,974,38232974
23572,0,1806900,1,10,37,12,974,38232974
23573,43,1806900,4,10,37,13,17,38233017
23574,919,1806800,1,10,37,13,936,38233936
23575,0,1806800,3,10,37,13,936,38233936
23576,0,1806800,1,10,37,13,936,38233936
23577,1,1806800,1,10,37,13,937,38233937
23578,0,1806800,1,10,37,13,937,38233937
23579,41,1806800,1,10,37,13,978,38233978
23580,1,1806800,1,10,37,13,979,38233979
23581,0,1806800,1,10,37,13,979,38233979
23582,0,1806800,3,10,37,13,979,38233979
23583,0,1806800,7,10,37,13,979,38233979
23584,1,1806800,1,10,37,13,980,38233980
23585,0,1806800,3,10,37,13,980,38233980
23586,57,1806700,1,10,37,14,37,38234037
23587,0,1806700,2,10,37,14,37,38234037
23588,0,1806700,1,10,37,14,37,38234037
23589,0,1806700,2,10,37,14,37,38234037
23590,21,1806700,1,10,37,14,58,38234058
23591,22,1806700,5,10,37,14,80,38234080
23592,0,1806700,1,10,37,14,80,38234080
23593,52,1806600,1,10,37,14,132,38234132
23594,17,1806600,2,10,37,14,149,38234149
23595,40,1806700,2,10,37,14,189,38234189
23596,212,1806700,1,10,37,14,401,38234401
23597,438,1806700,1,10,37,14,839,38234839
23598,1643,1806700,1,10,37,16,482,38236482
23599,158,1806800,1,10,37,16,640,38236640
23600,35,1806800,1,10,37,16,675,38236675
23601,134,1806900,1,10,37,16,809,38236809
23602,88,1806700,1,10,37,16,897,38236897
23603,143,1806700,1,10,37,17,40,38237040
23604,61,1806700,1,10,37,17,101,38237101
23605,263,1806800,1,10,37,17,364,38237364
23606,31,1806800,1,10,37,17,395,38237395
23608,92,1806700,1,10,37,17,487,38237487
23609,235,1806800,1,10,37,17,722,38237722
23611,32,1806700,1,10,37,17,754,38237754
23612,45,1806800,1,10,37,17,799,38237799
23614,124,1806700,1,10,37,17,923,38237923
23615,307,1806800,1,10,37,18,230,38238230
23617,598,1806700,1,10,37,18,828,38238828
23618,398,1806700,1,10,37,19,226,38239226
23619,643,1806800,1,10,37,19,869,38239869
23620,594,1806800,1,10,37,20,463,38240463
23621,78,1806900,2,10,37,20,541,38240541
23622,111,1807000,2,10,37,20,652,38240652
23623,459,1807000,1,10,37,21,111,38241111
23624,204,1807000,1,10,37,21,315,38241315
23625,555,1806900,1,10,37,21,870,38241870
23626,39,1806900,1,10,37,21,909,38241909
23627,68,1807000,5,10,37,21,977,38241977
23628,487,1806900,1,10,37,22,464,38242464
23629,838,1806900,1,10,37,23,302,38243302
23631,540,1807000,1,10,37,23,842,38243842
23632,124,1807000,1,10,37,23,966,38243966
23633,209,1807100,1,10,37,24,175,38244175
23634,360,1806900,2,10,37,24,535,38244535
23635,367,1807000,1,10,37,24,902,38244902
23636,49,1807000,2,10,37,24,951,38244951
23637,79,1807000,1,10,37,25,30,38245030
23638,223,1807000,1,10,37,25,253,38245253
23639,137,1807000,1,10,37,25,390,38245390
23640,140,1807000,1,10,37,25,530,38245530
23642,283,1807000,1,10,37,25,813,38245813
23643,417,1807000,1,10,37,26,230,38246230
23644,572,1807100,3,10,37,26,802,38246802
23645,253,1807000,2,10,37,27,55,38247055
23646,1031,1807000,1,10,37,28,86,38248086
23647,457,1807100,1,10,37,28,543,38248543
23648,185,1807100,1,10,37,28,728,38248728
23649,215,1807000,1,10,37,28,943,38248943
23650,427,1807100,1,10,37,29,370,38249370
23651,497,1807000,1,10,37,29,867,38249867
23652,29,1807000,1,10,37,29,896,38249896
23653,375,1807100,1,10,37,30,271,38250271
23654,428,1807000,1,10,37,30,699,38250699
23655,104,1807100,1,10,37,30,803,38250803
23656,228,1807100,1,10,37,31,31,38251031
23657,150,1807100,1,10,37,31,181,38251181
23658,107,1807000,1,10,37,31,288,38251288
23659,35,1807000,3,10,37,31,323,38251323
23661,1706,1807100,1,10,37,33,29,38253029
23662,76,1807100,2,10,37,33,105,38253105
23663,295,1807100,2,10,37,33,400,38253400
23664,1,1807100,1,10,37,33,401,38253401
23665,556,1807100,4,10,37,33,957,38253957
23666,107,1807100,1,10,37,34,64,38254064
23667,906,1807200,1,10,37,34,970,38254970
23668,84,1807100,9,10,37,35,54,38255054
23670,967,1807200,6,10,37,36,21,38256021
23671,17,1807100,2,10,37,36,38,38256038
23672,86,1807100,1,10,37,36,124,38256124
23673,98,1807100,1,10,37,36,222,38256222
23674,305,1807200,1,10,37,36,527,38256527
23675,64,1807100,1,10,37,36,591,38256591
23676,344,1807100,1,10,37,36,935,38256935
23677,133,1807100,2,10,37,37,68,38257068
23678,78,1807100,2,10,37,37,146,38257146
23679,260,1807300,1,10,37,37,406,38257406
23680,151,1807100,1,10,37,37,557,38257557
23681,132,1807100,1,10,37,37,689,38257689
23682,97,1807200,1,10,37,37,786,38257786
23684,91,1807200,1,10,37,37,877,38257877
23685,71,1807100,2,10,37,37,948,38257948
23686,1478,1807200,1,10,37,39,426,38259426
23687,139,1807300,1,10,37,39,565,38259565
23688,74,1807200,1,10,37,39,639,38259639
23689,279,1807200,1,10,37,39,918,38259918
23690,271,1807200,1,10,37,40,189,38260189
23692,224,1807200,1,10,37,40,413,38260413
23694,719,1807300,1,10,37,41,132,38261132
23695,870,1807200,1,10,37,42,2,38262002
23696,765,1807300,15,10,37,42,767,38262767
23697,525,1807200,2,10,37,43,292,38263292
23698,326,1807200,1,10,37,43,618,38263618
23699,128,1807200,1,10,37,43,746,38263746
23700,602,1807200,1,10,37,44,348,38264348
23701,153,1807200,1,10,37,44,501,38264501
23702,144,1807300,1,10,37,44,645,38264645
23703,1989,1807300,15,10,37,46,634,38266634
23704,889,1807200,1,10,37,47,523,38267523
23705,1829,1807200,1,10,37,49,352,38269352
23706,1256,1807200,1,10,37,50,608,38270608
23707,1276,1807200,1,10,37,51,884,38271884
23708,486,1807100,1,10,37,52,370,38272370
23709,134,1807100,5,10,37,52,504,38272504
23710,92,1807200,1,10,37,52,596,38272596
23711,309,1807100,1,10,37,52,905,38272905
23712,1569,1807100,1,10,37,54,474,38274474
23713,3090,1807100,2,10,37,57,564,38277564
23714,596,1807000,1,10,37,58,160,38278160
23715,84,1807100,1,10,37,58,244,38278244
23716,2097,1807000,1,10,38,0,341,38280341
23717,609,1807100,1,10,38,0,950,38280950
23718,1602,1807000,1,10,38,2,552,38282552
23719,1963,1807200,1,10,38,4,515,38284515
23720,434,1807100,1,10,38,4,949,38284949
23721,1449,1807000,1,10,38,6,398,38286398
23722,440,1807100,1,10,38,6,838,38286838
23723,59,1807100,1,10,38,6,897,38286897
23724,98,1807100,1,10,38,6,995,38286995
23725,11,1807100,1,10,38,7,6,38287006
23726,364,1807100,1,10,38,7,370,38287370
23727,288,1807200,1,10,38,7,658,38287658
23728,359,1807200,1,10,38,8,17,38288017
23729,200,1807200,38,10,38,8,217,38288217
23730,0,1807200,2,10,38,8,217,38288217
23731,0,1807200,4,10,38,8,217,38288217
23732,1,1807300,2,10,38,8,218,38288218
23733,0,1807200,1,10,38,8,218,38288218
23734,209,1807200,1,10,38,8,427,38288427
23735,451,1807200,4,10,38,8,878,38288878
23736,678,1807300,3,10,38,9,556,38289556
23737,180,1807200,1,10,38,9,736,38289736
23738,559,1807100,1,10,38,10,295,38290295
23739,298,1807200,1,10,38,10,593,38290593
23740,1,1807200,1,10,38,10,594,38290594
23741,346,1807200,1,10,38,10,940,38290940
23743,49,1807200,1,10,38,10,989,38290989
23744,368,1807200,1,10,38,11,357,38291357
23745,810,1807200,1,10,38,12,167,38292167
23746,328,1807200,1,10,38,12,495,38292495
23747,87,1807300,1,10,38,12,582,38292582
23748,63,1807300,1,10,38,12,645,38292645
23749,1440,1807300,1,10,38,14,85,38294085
23750,1094,1807300,3,10,38,15,179,38295179
23751,997,1807200,1,10,38,16,176,38296176
23752,261,1807400,1,10,38,16,437,38296437
23753,469,1807200,1,10,38,16,906,38296906
23754,405,1807200,1,10,38,17,311,38297311
23755,139,1807200,1,10,38,17,450,38297450
23756,832,1807200,1,10,38,18,282,38298282
23757,941,1807300,4,10,38,19,223,38299223
23758,496,1807300,1,10,38,19,719,38299719
23759,312,1807400,1,10,38,20,31,38300031
23760,544,1807300,1,10,38,20,575,38300575
23761,13,1807300,1,10,38,20,588,38300588
23762,341,1807400,1,10,38,20,929,38300929
23763,3073,1807300,2,10,38,24,2,38304002
23764,382,1807400,1,10,38,24,384,38304384
23765,1811,1807300,1,10,38,26,195,38306195
23766,16,1807300,4,10,38,26,211,38306211
23768,560,1807300,2,10,38,26,771,38306771
23769,385,1807300,1,10,38,27,156,38307156
23770,1089,1807200,2,10,38,28,245,38308245
23771,299,1807200,1,10,38,28,544,38308544
23772,941,1807200,1,10,38,29,485,38309485
23773,320,1807200,3,10,38,29,805,38309805
23774,0,1807200,1,10,38,29,805,38309805
23775,1,1807200,1,10,38,29,806,38309806
23776,285,1807200,1,10,38,30,91,38310091
23777,67,1807300,1,10,38,30,158,38310158
23778,743,1807200,1,10,38,30,901,38310901
23779,461,1807300,1,10,38,31,362,38311362
23780,195,1807200,2,10,38,31,557,38311557
23781,116,1807200,1,10,38,31,673,38311673
23782,125,1807200,1,10,38,31,798,38311798
23783,244,1807200,1,10,38,32,42,38312042
23784,128,1807200,1,10,38,32,170,38312170
23785,109,1807200,1,10,38,32,279,38312279
23786,1,1807200,1,10,38,32,280,38312280
23787,1838,1807300,3,10,38,34,118,38314118
23788,73,1807300,5,10,38,34,191,38314191
23789,521,1807300,2,10,38,34,712,38314712
23790,501,1807300,1,10,38,35,213,38315213
23791,2723,1807200,1,10,38,37,936,38317936
23792,47,1807200,27,10,38,37,983,38317983
23793,0,1807200,2,10,38,37,983,38317983
23794,0,1807200,3,10,38,37,983,38317983
23795,681,1807200,1,10,38,38,664,38318664
23796,2671,1807200,1,10,38,41,335,38321335
23797,1211,1807200,2,10,38,42,546,38322546
23798,0,1807200,1,10,38,42,546,38322546
23799,1907,1807100,1,10,38,44,453,38324453
23800,323,1807200,1,10,38,44,776,38324776
23801,1371,1807200,1,10,38,46,147,38326147
23802,672,1807200,1,10,38,46,819,38326819
23803,74,1807200,1,10,38,46,893,38326893
23804,578,1807100,3,10,38,47,471,38327471
23805,2746,1807200,1,10,38,50,217,38330217
23806,533,1807100,1,10,38,50,750,38330750
23807,656,1807200,1,10,38,51,406,38331406
23808,960,1807300,8,10,38,52,366,38332366
23809,1693,1807300,1,10,38,54,59,38334059
23810,1,1807300,1,10,38,54,60,38334060
23811,487,1807300,1,10,38,54,547,38334547
23812,2371,1807300,1,10,38,56,918,38336918
23813,145,1807300,1,10,38,57,63,38337063
23814,757,1807200,1,10,38,57,820,38337820
23815,460,1807200,1,10,38,58,280,38338280
23816,1515,1807300,1,10,38,59,795,38339795
23817,463,1807300,1,10,39,0,258,38340258
23818,93,1807300,2,10,39,0,351,38340351
23820,0,1807400,1,10,39,0,351,38340351
23821,1,1807400,1,10,39,0,352,38340352
23822,0,1807400,2,10,39,0,352,38340352
23823,0,1807400,6,10,39,0,352,38340352
23824,0,1807400,3,10,39,0,352,38340352
23825,1,1807400,3,10,39,0,353,38340353
23826,0,1807400,2,10,39,0,353,38340353
23827,0,1807400,4,10,39,0,353,38340353
23828,475,1807400,3,10,39,0,828,38340828
23829,1,1807400,1,10,39,0,829,38340829
23830,0,1807400,1,10,39,0,829,38340829
23831,0,1807400,1,10,39,0,829,38340829
23832,0,1807400,1,10,39,0,829,38340829
23833,1,1807400,2,10,39,0,830,38340830
23834,497,1807400,1,10,39,1,327,38341327
23835,23,1807500,1,10,39,1,350,38341350
23836,87,1807400,1,10,39,1,437,38341437
23837,838,1807400,1,10,39,2,275,38342275
23838,169,1807300,1,10,39,2,444,38342444
23839,461,1807200,1,10,39,2,905,38342905
23840,1009,1807400,1,10,39,3,914,38343914
23841,422,1807400,1,10,39,4,336,38344336
23842,1260,1807400,1,10,39,5,596,38345596
23843,506,1807300,1,10,39,6,102,38346102
23844,2634,1807300,3,10,39,8,736,38348736
23845,1,1807300,1,10,39,8,737,38348737
23846,113,1807400,1,10,39,8,850,38348850
23847,0,1807400,1,10,39,8,850,38348850
23848,0,1807400,1,10,39,8,850,38348850
23849,1,1807400,1,10,39,8,851,38348851
23850,0,1807400,1,10,39,8,851,38348851
23851,3657,1807200,1,10,39,12,508,38352508
23852,2422,1807200,1,10,39,14,930,38354930
23853,409,1807300,1,10,39,15,339,38355339
23854,702,1807200,1,10,39,16,41,38356041
23855,146,1807300,2,10,39,16,187,38356187
23856,0,1807400,1,10,39,16,187,38356187
23857,0,1807400,1,10,39,16,187,38356187
23858,2088,1807400,1,10,39,18,275,38358275
23859,76,1807500,1,10,39,18,351,38358351
23860,0,1807500,1,10,39,18,351,38358351
23861,0,1807500,1,10,39,18,351,38358351
23862,1,1807500,1,10,39,18,352,38358352
23863,0,1807500,1,10,39,18,352,38358352
23864,0,1807500,17,10,39,18,352,38358352
23865,1,1807500,1,10,39,18,353,38358353
23866,151,1807600,5,10,39,18,504,38358504
23867,109,1807600,2,10,39,18,613,38358613
23868,28,1807400,1,10,39,18,641,38358641
23869,17,1807600,1,10,39,18,658,38358658
23870,44,1807600,4,10,39,18,702,38358702
23871,110,1807600,1,10,39,18,812,38358812
23872,1237,1807600,1,10,39,20,49,38360049
23873,0,1807600,2,10,39,20,49,38360049
23874,0,1807600,3,10,39,20,49,38360049
23875,1099,1807600,1,10,39,21,148,38361148
23876,2,1807700,1,10,39,21,150,38361150
23877,524,1807700,1,10,39,21,674,38361674
23878,1132,1807700,10,10,39,22,806,38362806
23879,142,1807600,1,10,39,22,948,38362948
23880,561,1807500,3,10,39,23,509,38363509
23881,1685,1807500,1,10,39,25,194,38365194
23882,708,1807500,1,10,39,25,902,38365902
23883,121,1807400,1,10,39,26,23,38366023
23884,2418,1807400,1,10,39,28,441,38368441
23885,34,1807500,1,10,39,28,475,38368475
23886,0,1807500,1,10,39,28,475,38368475
23887,1,1807500,1,10,39,28,476,38368476
23888,0,1807500,1,10,39,28,476,38368476
23889,424,1807400,1,10,39,28,900,38368900
23890,200,1807400,1,10,39,29,100,38369100
23891,2862,1807500,5,10,39,31,962,38371962
23892,1068,1807400,1,10,39,33,30,38373030
23893,127,1807500,1,10,39,33,157,38373157
23894,1948,1807400,1,10,39,35,105,38375105
23895,131,1807400,1,10,39,35,236,38375236
23896,842,1807400,2,10,39,36,78,38376078
23897,929,1807400,4,10,39,37,7,38377007
23898,0,1807400,4,10,39,37,7,38377007
23900,93,1807600,1,10,39,37,100,38377100
23901,1279,1807600,1,10,39,38,379,38378379
23902,1050,1807500,1,10,39,39,429,38379429
23903,539,1807400,1,10,39,39,968,38379968
23904,640,1807600,1,10,39,40,608,38380608
23905,366,1807500,1,10,39,40,974,38380974
23906,429,1807500,1,10,39,41,403,38381403
23907,1718,1807600,1,10,39,43,121,38383121
23908,3398,1807500,1,10,39,46,519,38386519
23909,32,1807600,1,10,39,46,551,38386551
23910,57,1807500,1,10,39,46,608,38386608
23911,1191,1807600,1,10,39,47,799,38387799
23912,1508,1807500,2,10,39,49,307,38389307
23913,1407,1807600,5,10,39,50,714,38390714
23914,1737,1807600,6,10,39,52,451,38392451
23915,382,1807600,1,10,39,52,833,38392833
23916,103,1807500,1,10,39,52,936,38392936
23917,2826,1807600,3,10,39,55,762,38395762
23918,358,1807600,1,10,39,56,120,38396120
23920,1888,1807600,1,10,39,58,8,38398008
23921,686,1807600,1,10,39,58,694,38398694
23922,736,1807600,1,10,39,59,430,38399430
23923,526,1807500,1,10,39,59,956,38399956
23924,1995,1807500,1,10,40,1,951,38401951
23925,25,1807500,5,10,40,1,976,38401976
23927,0,1807400,2,10,40,1,976,38401976
23928,0,1807400,1,10,40,1,976,38401976
23929,0,1807400,1,10,40,1,976,38401976
23930,1,1807400,4,10,40,1,977,38401977
23931,0,1807400,2,10,40,1,977,38401977
23932,0,1807400,1,10,40,1,977,38401977
23933,0,1807400,2,10,40,1,977,38401977
23934,1,1807400,1,10,40,1,978,38401978
23935,1,1807500,1,10,40,1,979,38401979
23936,131,1807500,1,10,40,2,110,38402110
23937,83,1807400,1,10,40,2,193,38402193
23938,95,1807600,2,10,40,2,288,38402288
23939,33,1807400,1,10,40,2,321,38402321
23940,69,1807400,1,10,40,2,390,38402390
23941,375,1807400,3,10,40,2,765,38402765
23942,1,1807500,1,10,40,2,766,38402766
23943,66,1807400,1,10,40,2,832,38402832
23944,92,1807400,1,10,40,2,924,38402924
23945,29,1807500,2,10,40,2,953,38402953
23946,39,1807400,2,10,40,2,992,38402992
23947,23,1807400,1,10,40,3,15,38403015
23948,100,1807300,2,10,40,3,115,38403115
23949,12,1807300,1,10,40,3,127,38403127
23950,13,1807300,1,10,40,3,140,38403140
23951,33,1807300,1,10,40,3,173,38403173
23952,49,1807300,1,10,40,3,222,38403222
23953,10,1807300,2,10,40,3,232,38403232
23954,13,1807300,2,10,40,3,245,38403245
23955,2,1807400,1,10,40,3,247,38403247
23956,24,1807300,1,10,40,3,271,38403271
23957,84,1807300,1,10,40,3,355,38403355
23958,470,1807400,3,10,40,3,825,38403825
23959,130,1807300,1,10,40,3,955,38403955
23960,761,1807300,1,10,40,4,716,38404716
23961,232,1807300,1,10,40,4,948,38404948
23962,138,1807300,1,10,40,5,86,38405086
23963,330,1807400,2,10,40,5,416,38405416
23964,184,1807300,1,10,40,5,600,38405600
23966,237,1807300,1,10,40,5,837,38405837
23967,48,1807200,1,10,40,5,885,38405885
23968,1,1807400,2,10,40,5,886,38405886
23969,120,1807300,2,10,40,6,6,38406006
23970,0,1807400,1,10,40,6,6,38406006
23971,103,1807300,3,10,40,6,109,38406109
23973,363,1807300,1,10,40,6,472,38406472
23974,3543,1807300,1,10,40,10,15,38410015
23975,85,1807300,1,10,40,10,100,38410100
23976,1,1807300,1,10,40,10,101,38410101
23977,1567,1807300,1,10,40,11,668,38411668
23978,146,1807400,3,10,40,11,814,38411814
23980,167,1807400,1,10,40,11,981,38411981
23981,603,1807300,8,10,40,12,584,38412584
23982,643,1807300,4,10,40,13,227,38413227
23983,662,1807400,2,10,40,13,889,38413889
23984,292,1807300,3,10,40,14,181,38414181
23985,1,1807300,1,10,40,14,182,38414182
23986,0,1807300,6,10,40,14,182,38414182
23987,1976,1807300,1,10,40,16,158,38416158
23988,960,1807300,1,10,40,17,118,38417118
23989,107,1807200,1,10,40,17,225,38417225
23990,0,1807200,1,10,40,17,225,38417225
23991,0,1807300,1,10,40,17,225,38417225
23992,318,1807300,1,10,40,17,543,38417543
23993,1948,1807200,3,10,40,19,491,38419491
23994,761,1807200,1,10,40,20,252,38420252
23995,853,1807200,3,10,40,21,105,38421105
23996,0,1807200,1,10,40,21,105,38421105
23997,0,1807200,1,10,40,21,105,38421105
23998,7,1807200,70,10,40,21,112,38421112
23999,1,1807200,2,10,40,21,113,38421113
24000,0,1807200,1,10,40,21,113,38421113
24001,0,1807200,1,10,40,21,113,38421113
24002,0,1807200,1,10,40,21,113,38421113
24003,0,1807200,1,10,40,21,113,38421113
24004,0,1807200,1,10,40,21,113,38421113
24005,0,1807200,31,10,40,21,113,38421113
24006,0,1807200,4,10,40,21,113,38421113
24007,0,1807200,15,10,40,21,113,38421113
24008,1,1807200,1,10,40,21,114,38421114
24009,0,1807200,2,10,40,21,114,38421114
24010,0,1807200,1,10,40,21,114,38421114
24011,31,1807200,1,10,40,21,145,38421145
24012,0,1807200,1,10,40,21,145,38421145
24013,18,1807300,1,10,40,21,163,38421163
24014,33,1807200,1,10,40,21,196,38421196
24015,8,1807200,33,10,40,21,204,38421204
24016,171,1807100,2,10,40,21,375,38421375
24017,395,1807100,2,10,40,21,770,38421770
24018,206,1807200,1,10,40,21,976,38421976
24019,972,1807200,1,10,40,22,948,38422948
24020,605,1807200,1,10,40,23,553,38423553
24021,246,1807200,1,10,40,23,799,38423799
24022,375,1807100,3,10,40,24,174,38424174
24023,136,1807100,3,10,40,24,310,38424310
24024,517,1807100,1,10,40,24,827,38424827
24025,248,1807100,5,10,40,25,75,38425075
24026,1,1807100,1,10,40,25,76,38425076
24027,8,1807000,2,10,40,25,84,38425084
24028,142,1807100,1,10,40,25,226,38425226
24029,1143,1807000,2,10,40,26,369,38426369
24030,171,1807100,1,10,40,26,540,38426540
24031,310,1807000,1,10,40,26,850,38426850
24032,857,1807000,7,10,40,27,707,38427707
24033,18,1807000,1,10,40,27,725,38427725
24034,1,1807000,1,10,40,27,726,38427726
24035,0,1807000,1,10,40,27,726,38427726
24036,0,1807000,1,10,40,27,726,38427726
24037,1,1807000,1,10,40,27,727,38427727
24038,0,1807000,1,10,40,27,727,38427727
24039,252,1807000,1,10,40,27,979,38427979
24040,51,1807000,1,10,40,28,30,38428030
24041,361,1807000,22,10,40,28,391,38428391
24042,600,1807000,1,10,40,28,991,38428991
24043,2,1806900,2,10,40,28,993,38428993
24044,111,1806900,3,10,40,29,104,38429104
24045,24,1807000,5,10,40,29,128,38429128
24046,0,1807000,5,10,40,29,128,38429128
24048,2,1807200,1,10,40,29,130,38429130
24049,0,1807200,1,10,40,29,130,38429130
24050,0,1807200,1,10,40,29,130,38429130
24051,0,1807200,9,10,40,29,130,38429130
24052,0,1807300,15,10,40,29,130,38429130
24053,2,1807200,1,10,40,29,132,38429132
24054,0,1807200,1,10,40,29,132,38429132
24055,0,1807200,1,10,40,29,132,38429132
24056,0,1807200,1,10,40,29,132,38429132
24057,0,1807200,2,10,40,29,132,38429132
24058,0,1807200,1,10,40,29,132,38429132
24059,1,1807200,1,10,40,29,133,38429133
24060,80,1807100,1,10,40,29,213,38429213
24061,282,1807100,3,10,40,29,495,38429495
24062,1213,1807100,1,10,40,30,708,38430708
24063,2661,1807200,1,10,40,33,369,38433369
24064,878,1807300,2,10,40,34,247,38434247
24065,127,1807300,3,10,40,34,374,38434374
24066,160,1807300,1,10,40,34,534,38434534
24067,434,1807300,1,10,40,34,968,38434968
24068,1022,1807400,7,10,40,35,990,38435990
24069,282,1807400,7,10,40,36,272,38436272
24070,0,1807400,1,10,40,36,272,38436272
24071,0,1807400,5,10,40,36,272,38436272
24072,0,1807400,1,10,40,36,272,38436272
24073,1,1807400,11,10,40,36,273,38436273
24074,63,1807400,1,10,40,36,336,38436336
24075,1074,1807400,5,10,40,37,410,38437410
24076,65,1807300,1,10,40,37,475,38437475
24077,1,1807300,1,10,40,37,476,38437476
24078,1754,1807400,1,10,40,39,230,38439230
24079,812,1807400,1,10,40,40,42,38440042
24080,827,1807500,22,10,40,40,869,38440869
24081,18,1807500,1,10,40,40,887,38440887
24082,242,1807500,1,10,40,41,129,38441129
24083,204,1807400,1,10,40,41,333,38441333
24084,91,1807400,5,10,40,41,424,38441424
24085,1084,1807400,1,10,40,42,508,38442508
24086,209,1807500,3,10,40,42,717,38442717
24087,290,1807600,1,10,40,43,7,38443007
24088,27,1807500,1,10,40,43,34,38443034
24089,158,1807500,1,10,40,43,192,38443192
24090,698,1807500,1,10,40,43,890,38443890
24091,2208,1807600,13,10,40,46,98,38446098
24092,468,1807700,1,10,40,46,566,38446566
24093,55,1807500,1,10,40,46,621,38446621
24094,1220,1807600,2,10,40,47,841,38447841
24095,1134,1807600,1,10,40,48,975,38448975
24096,1020,1807700,9,10,40,49,995,38449995
24097,773,1807800,1,10,40,50,768,38450768
24098,74,1807600,1,10,40,50,842,38450842
24099,206,1807800,1,10,40,51,48,38451048
24100,220,1807700,2,10,40,51,268,38451268
24101,698,1807800,1,10,40,51,966,38451966
24102,437,1807700,1,10,40,52,403,38452403
24103,27,1807600,1,10,40,52,430,38452430
24104,2720,1807700,1,10,40,55,150,38455150
24105,1258,1807700,1,10,40,56,408,38456408
24106,457,1807700,1,10,40,56,865,38456865
24107,208,1807800,1,10,40,57,73,38457073
24108,159,1807800,2,10,40,57,232,38457232
24109,275,1807800,1,10,40,57,507,38457507
24110,907,1807600,10,10,40,58,414,38458414
24112,3,1807500,2,10,40,58,417,38458417
24113,0,1807500,34,10,40,58,417,38458417
24114,107,1807600,2,10,40,58,524,38458524
24115,70,1807600,1,10,40,58,594,38458594
24116,313,1807600,1,10,40,58,907,38458907
24117,1208,1807600,5,10,41,0,115,38460115
24118,870,1807500,1,10,41,0,985,38460985
24119,335,1807600,1,10,41,1,320,38461320
24120,1668,1807600,1,10,41,2,988,38462988
24121,1786,1807600,1,10,41,4,774,38464774
24122,393,1807500,1,10,41,5,167,38465167
24123,378,1807500,1,10,41,5,545,38465545
24124,609,1807600,3,10,41,6,154,38466154
24125,567,1807600,1,10,41,6,721,38466721
24126,959,1807500,8,10,41,7,680,38467680
24127,740,1807600,1,10,41,8,420,38468420
24128,180,1807500,1,10,41,8,600,38468600
24129,190,1807600,1,10,41,8,790,38468790
24130,4433,1807500,1,10,41,13,223,38473223
24131,0,1807500,1,10,41,13,223,38473223
24132,2111,1807500,2,10,41,15,334,38475334
24133,592,1807600,5,10,41,15,926,38475926
24134,1,1807700,2,10,41,15,927,38475927
24135,1,1807700,2,10,41,15,928,38475928
24136,18,1807700,1,10,41,15,946,38475946
24137,91,1807700,1,10,41,16,37,38476037
24139,287,1807600,1,10,41,16,324,38476324
24140,483,1807600,1,10,41,16,807,38476807
24141,402,1807800,1,10,41,17,209,38477209
24142,2498,1807600,1,10,41,19,707,38479707
24143,1967,1807600,1,10,41,21,674,38481674
24144,180,1807600,1,10,41,21,854,38481854
24145,880,1807600,1,10,41,22,734,38482734
24146,376,1807600,1,10,41,23,110,38483110
24147,99,1807600,9,10,41,23,209,38483209
24149,3,1807500,34,10,41,23,212,38483212
24150,72,1807500,2,10,41,23,284,38483284
24151,689,1807600,1,10,41,23,973,38483973
24152,2964,1807500,1,10,41,26,937,38486937
24153,1323,1807400,1,10,41,28,260,38488260
24154,587,1807600,1,10,41,28,847,38488847
24155,179,1807600,2,10,41,29,26,38489026
24156,1169,1807400,1,10,41,30,195,38490195
24157,653,1807400,1,10,41,30,848,38490848
24158,1034,1807600,2,10,41,31,882,38491882
24159,285,1807500,1,10,41,32,167,38492167
24160,646,1807600,1,10,41,32,813,38492813
24161,0,1807600,1,10,41,32,813,38492813
24162,0,1807600,4,10,41,32,813,38492813
24163,1,1807600,1,10,41,32,814,38492814
24164,0,1807600,1,10,41,32,814,38492814
24165,30,1807600,2,10,41,32,844,38492844
24166,1694,1807600,2,10,41,34,538,38494538
24167,1018,1807600,1,10,41,35,556,38495556
24168,1101,1807600,2,10,41,36,657,38496657
24169,2347,1807500,1,10,41,39,4,38499004
24170,995,1807500,2,10,41,39,999,38499999
24171,4291,1807500,1,10,41,44,290,38504290
24172,4133,1807600,1,10,41,48,423,38508423
24173,1337,1807600,2,10,41,49,760,38509760
24174,349,1807600,22,10,41,50,109,38510109
24175,1087,1807700,4,10,41,51,196,38511196
24176,1725,1807600,1,10,41,52,921,38512921
24177,1798,1807800,1,10,41,54,719,38514719
24178,269,1807700,1,10,41,54,988,38514988
24179,4598,1807700,2,10,41,59,586,38519586
24180,550,1807800,1,10,42,0,136,38520136
24181,181,1807800,1,10,42,0,317,38520317
24182,21,1807700,1,10,42,0,338,38520338
24183,120,1807800,1,10,42,0,458,38520458
24184,24,1807800,15,10,42,0,482,38520482
24185,490,1807900,5,10,42,0,972,38520972
24186,0,1807900,1,10,42,0,972,38520972
24187,0,1807900,7,10,42,0,972,38520972
24188,228,1808000,1,10,42,1,200,38521200
24189,44,1808000,2,10,42,1,244,38521244
24190,109,1808000,4,10,42,1,353,38521353
24191,31,1808000,1,10,42,1,384,38521384
24192,257,1808000,1,10,42,1,641,38521641
24193,119,1808000,2,10,42,1,760,38521760
24194,93,1808000,5,10,42,1,853,38521853
24195,114,1808000,1,10,42,1,967,38521967
24196,0,1808000,1,10,42,1,967,38521967
24197,0,1808000,4,10,42,1,967,38521967
24198,139,1808000,1,10,42,2,106,38522106
24199,51,1808000,1,10,42,2,157,38522157
24200,134,1808000,1,10,42,2,291,38522291
24201,57,1808000,1,10,42,2,348,38522348
24202,132,1807900,2,10,42,2,480,38522480
24203,0,1807900,2,10,42,2,480,38522480
24204,0,1807900,2,10,42,2,480,38522480
24205,0,1807900,2,10,42,2,480,38522480
24207,10,1807600,2,10,42,2,490,38522490
24208,16,1807700,7,10,42,2,506,38522506
24209,16,1807700,1,10,42,2,522,38522522
24210,1,1807600,3,10,42,2,523,38522523
24211,0,1807600,2,10,42,2,523,38522523
24212,68,1807700,1,10,42,2,591,38522591
24213,224,1807600,3,10,42,2,815,38522815
24214,756,1807700,2,10,42,3,571,38523571
24215,379,1807700,1,10,42,3,950,38523950
24216,549,1807500,3,10,42,4,499,38524499
24217,328,1807600,1,10,42,4,827,38524827
24218,24,1807500,1,10,42,4,851,38524851
24219,1070,1807600,1,10,42,5,921,38525921
24220,674,1807600,1,10,42,6,595,38526595
24221,562,1807600,2,10,42,7,157,38527157
24222,1,1807600,2,10,42,7,158,38527158
24223,762,1807700,1,10,42,7,920,38527920
24224,1261,1807500,1,10,42,9,181,38529181
24225,385,1807500,1,10,42,9,566,38529566
24226,193,1807500,1,10,42,9,759,38529759
24227,524,1807500,1,10,42,10,283,38530283
24229,225,1807600,2,10,42,10,508,38530508
24230,496,1807400,1,10,42,11,4,38531004
24231,130,1807500,1,10,42,11,134,38531134
24232,277,1807400,1,10,42,11,411,38531411
24233,1863,1807500,1,10,42,13,274,38533274
24234,2775,1807600,1,10,42,16,49,38536049
24235,8099,1807600,3,10,42,24,148,38544148
24236,991,1807600,2,10,42,25,139,38545139
24237,191,1807600,1,10,42,25,330,38545330
24238,355,1807500,1,10,42,25,685,38545685
24239,1348,1807600,3,10,42,27,33,38547033
24240,413,1807700,1,10,42,27,446,38547446
24241,1231,1807700,1,10,42,28,677,38548677
24242,421,1807500,3,10,42,29,98,38549098
24243,415,1807700,1,10,42,29,513,38549513
24244,5187,1807600,1,10,42,34,700,38554700
24245,11,1807600,2,10,42,34,711,38554711
24246,1198,1807600,1,10,42,35,909,38555909
24247,837,1807500,1,10,42,36,746,38556746
24248,968,1807500,1,10,42,37,714,38557714
24249,2,1807500,2,10,42,37,716,38557716
24250,2620,1807600,3,10,42,40,336,38560336
24251,212,1807500,1,10,42,40,548,38560548
24252,968,1807600,2,10,42,41,516,38561516
24253,19,1807600,1,10,42,41,535,38561535
24254,379,1807700,3,10,42,41,914,38561914
24255,834,1807500,1,10,42,42,748,38562748
24256,6533,1807600,1,10,42,49,281,38569281
24258,2748,1807600,1,10,42,52,29,38572029
24259,106,1807500,1,10,42,52,135,38572135
24260,13352,1807600,1,10,43,5,487,38585487
24261,1,1807600,1,10,43,5,488,38585488
24262,74,1807600,1,10,43,5,562,38585562
24263,232,1807700,2,10,43,5,794,38585794
24264,56,1807700,1,10,43,5,850,38585850
24265,33,1807700,1,10,43,5,883,38585883
24266,339,1807600,1,10,43,6,222,38586222
24267,0,1807600,1,10,43,6,222,38586222
24269,1,1807400,23,10,43,6,223,38586223
24270,1,1807400,1,10,43,6,224,38586224
24271,1334,1807300,1,10,43,7,558,38587558
24272,1,1807300,2,10,43,7,559,38587559
24273,0,1807300,5,10,43,7,559,38587559
24274,3,1807300,1,10,43,7,562,38587562
24275,1059,1807200,2,10,43,8,621,38588621
24276,222,1807200,4,10,43,8,843,38588843
24277,46,1807300,1,10,43,8,889,38588889
24278,2757,1807300,1,10,43,11,646,38591646
24279,262,1807200,1,10,43,11,908,38591908
24280,1700,1807200,1,10,43,13,608,38593608
24281,1086,1807300,2,10,43,14,694,38594694
24282,603,1807300,1,10,43,15,297,38595297
24283,814,1807300,1,10,43,16,111,38596111
24284,14,1807300,1,10,43,16,125,38596125
24285,1090,1807400,1,10,43,17,215,38597215
24286,222,1807300,1,10,43,17,437,38597437
24287,3363,1807300,1,10,43,20,800,38600800
24288,696,1807300,2,10,43,21,496,38601496
24289,282,1807300,1,10,43,21,778,38601778
24290,889,1807300,3,10,43,22,667,38602667
24291,501,1807300,1,10,43,23,168,38603168
24292,116,1807300,1,10,43,23,284,38603284
24293,495,1807200,6,10,43,23,779,38603779
24294,1700,1807300,1,10,43,25,479,38605479
24295,612,1807200,2,10,43,26,91,38606091
24296,1614,1807300,1,10,43,27,705,38607705
24298,880,1807300,1,10,43,28,585,38608585
24299,309,1807200,1,10,43,28,894,38608894
24300,174,1807400,2,10,43,29,68,38609068
24301,1020,1807400,1,10,43,30,88,38610088
24302,1731,1807300,1,10,43,31,819,38611819
24303,191,1807300,1,10,43,32,10,38612010
24304,194,1807200,1,10,43,32,204,38612204
24305,181,1807200,1,10,43,32,385,38612385
24306,234,1807200,1,10,43,32,619,38612619
24307,63,1807200,5,10,43,32,682,38612682
24308,78,1807200,1,10,43,32,760,38612760
24309,199,1807100,1,10,43,32,959,38612959
24310,175,1807200,1,10,43,33,134,38613134
24311,571,1807200,1,10,43,33,705,38613705
24312,179,1807200,1,10,43,33,884,38613884
24313,829,1807200,1,10,43,34,713,38614713
24314,185,1807200,1,10,43,34,898,38614898
24315,2707,1807200,1,10,43,37,605,38617605
24316,4717,1807300,1,10,43,42,322,38622322
24317,547,1807200,1,10,43,42,869,38622869
24318,2780,1807200,1,10,43,45,649,38625649
24319,332,1807300,1,10,43,45,981,38625981
24320,387,1807200,1,10,43,46,368,38626368
24321,572,1807200,2,10,43,46,940,38626940
24322,186,1807300,1,10,43,47,126,38627126
24323,1246,1807200,1,10,43,48,372,38628372
24324,3800,1807200,2,10,43,52,172,38632172
24325,729,1807200,1,10,43,52,901,38632901
24326,654,1807200,1,10,43,53,555,38633555
24327,3346,1807200,1,10,43,56,901,38636901
24328,1520,1807200,1,10,43,58,421,38638421
24329,3447,1807200,2,10,44,1,868,38641868
24330,424,1807200,1,10,44,2,292,38642292
24331,331,1807200,1,10,44,2,623,38642623
24332,1727,1807200,2,10,44,4,350,38644350
24333,740,1807100,1,10,44,5,90,38645090
24334,3935,1807100,1,10,44,9,25,38649025
24335,2343,1807100,2,10,44,11,368,38651368
24336,3010,1807100,1,10,44,14,378,38654378
24337,132,1807100,1,10,44,14,510,38654510
24338,582,1807100,1,10,44,15,92,38655092
24339,2902,1807100,1,10,44,17,994,38657994
24340,0,1807100,4,10,44,17,994,38657994
24341,1,1807100,1,10,44,17,995,38657995
24342,0,1807100,1,10,44,17,995,38657995
24343,2678,1807200,1,10,44,20,673,38660673
24344,3721,1807100,1,10,44,24,394,38664394
24345,243,1807200,1,10,44,24,637,38664637
24346,1758,1807200,1,10,44,26,395,38666395
24347,128,1807200,5,10,44,26,523,38666523
24348,0,1807200,1,10,44,26,523,38666523
24349,0,1807200,1,10,44,26,523,38666523
24350,0,1807200,1,10,44,26,523,38666523
24351,1720,1807200,1,10,44,28,243,38668243
24352,0,1807200,1,10,44,28,243,38668243
24353,7,1807200,3,10,44,28,250,38668250
24354,3848,1807300,3,10,44,32,98,38672098
24355,1051,1807300,1,10,44,33,149,38673149
24356,397,1807400,3,10,44,33,546,38673546
24357,912,1807300,1,10,44,34,458,38674458
24358,1,1807300,2,10,44,34,459,38674459
24359,2108,1807400,4,10,44,36,567,38676567
24360,216,1807200,1,10,44,36,783,38676783
24361,51,1807300,1,10,44,36,834,38676834
24362,781,1807200,1,10,44,37,615,38677615
24363,762,1807200,1,10,44,38,377,38678377
24364,133,1807200,1,10,44,38,510,38678510
24365,605,1807200,1,10,44,39,115,38679115
24366,261,1807300,1,10,44,39,376,38679376
24367,285,1807200,1,10,44,39,661,38679661
24368,223,1807200,1,10,44,39,884,38679884
24369,1012,1807300,1,10,44,40,896,38680896
24370,500,1807300,1,10,44,41,396,38681396
24371,1409,1807200,3,10,44,42,805,38682805
24373,1688,1807300,1,10,44,44,493,38684493
24374,2704,1807200,1,10,44,47,197,38687197
24375,2549,1807100,2,10,44,49,746,38689746
24376,826,1807300,2,10,44,50,572,38690572
24377,2848,1807400,3,10,44,53,420,38693420
24378,1479,1807400,3,10,44,54,899,38694899
24379,644,1807200,2,10,44,55,543,38695543
24380,2855,1807400,2,10,44,58,398,38698398
24381,636,1807300,2,10,44,59,34,38699034
24382,0,1807300,2,10,44,59,34,38699034
24383,494,1807300,1,10,44,59,528,38699528
24384,620,1807400,3,10,45,0,148,38700148
24385,1,1807400,2,10,45,0,149,38700149
24387,0,1807500,3,10,45,0,149,38700149
24388,0,1807500,3,10,45,0,149,38700149
24389,16,1807500,4,10,45,0,165,38700165
24390,11,1807500,2,10,45,0,176,38700176
24392,301,1807500,1,10,45,0,477,38700477
24393,33,1807500,1,10,45,0,510,38700510
24394,17,1807500,1,10,45,0,527,38700527
24395,18,1807400,1,10,45,0,545,38700545
24396,15,1807500,1,10,45,0,560,38700560
24397,84,1807500,3,10,45,0,644,38700644
24398,4,1807500,1,10,45,0,648,38700648
24399,128,1807600,1,10,45,0,776,38700776
24400,27,1807600,1,10,45,0,803,38700803
24401,49,1807400,3,10,45,0,852,38700852
24402,1,1807400,1,10,45,0,853,38700853
24403,62,1807600,1,10,45,0,915,38700915
24404,33,1807600,3,10,45,0,948,38700948
24405,52,1807400,4,10,45,1,0,38701000
24406,39,1807500,1,10,45,1,39,38701039
24407,10,1807600,1,10,45,1,49,38701049
24408,2,1807600,1,10,45,1,51,38701051
24409,16,1807600,1,10,45,1,67,38701067
24410,48,1807600,1,10,45,1,115,38701115
24411,23,1807600,1,10,45,1,138,38701138
24412,0,1807600,1,10,45,1,138,38701138
24413,3,1807600,1,10,45,1,141,38701141
24414,45,1807600,1,10,45,1,186,38701186
24415,36,1807500,1,10,45,1,222,38701222
24416,11,1807600,1,10,45,1,233,38701233
24417,1,1807600,1,10,45,1,234,38701234
24418,33,1807600,1,10,45,1,267,38701267
24419,22,1807600,1,10,45,1,289,38701289
24420,5,1807600,1,10,45,1,294,38701294
24421,13,1807400,1,10,45,1,307,38701307
24422,35,1807600,1,10,45,1,342,38701342
24423,31,1807600,3,10,45,1,373,38701373
24424,29,1807600,4,10,45,1,402,38701402
24425,27,1807600,2,10,45,1,429,38701429
24427,9,1807600,1,10,45,1,438,38701438
24428,68,1807600,1,10,45,1,506,38701506
24429,18,1807600,1,10,45,1,524,38701524
24430,44,1807600,2,10,45,1,568,38701568
24432,23,1807600,1,10,45,1,591,38701591
24433,12,1807600,1,10,45,1,603,38701603
24434,16,1807500,1,10,45,1,619,38701619
24435,62,1807400,4,10,45,1,681,38701681
24436,91,1807500,1,10,45,1,772,38701772
24437,36,1807500,1,10,45,1,808,38701808
24438,353,1807500,1,10,45,2,161,38702161
24439,6,1807500,1,10,45,2,167,38702167
24440,14,1807500,1,10,45,2,181,38702181
24441,1,1807600,1,10,45,2,182,38702182
24442,22,1807600,1,10,45,2,204,38702204
24443,21,1807600,1,10,45,2,225,38702225
24444,1,1807400,1,10,45,2,226,38702226
24445,45,1807400,1,10,45,2,271,38702271
24446,264,1807400,1,10,45,2,535,38702535
24447,192,1807500,1,10,45,2,727,38702727
24448,1080,1807400,1,10,45,3,807,38703807
24449,795,1807400,1,10,45,4,602,38704602
24450,318,1807400,1,10,45,4,920,38704920
24451,516,1807500,3,10,45,5,436,38705436
24452,1193,1807500,1,10,45,6,629,38706629
24454,145,1807600,1,10,45,6,774,38706774
24455,1852,1807500,1,10,45,8,626,38708626
24456,2044,1807500,1,10,45,10,670,38710670
24457,1153,1807600,1,10,45,11,823,38711823
24458,2384,1807500,1,10,45,14,207,38714207
24459,5162,1807500,2,10,45,19,369,38719369
24460,686,1807500,4,10,45,20,55,38720055
24461,623,1807600,2,10,45,20,678,38720678
24462,2908,1807500,1,10,45,23,586,38723586
24463,20,1807400,1,10,45,23,606,38723606
24464,509,1807600,1,10,45,24,115,38724115
24465,39,1807600,2,10,45,24,154,38724154
24466,1229,1807500,2,10,45,25,383,38725383
24467,2829,1807500,2,10,45,28,212,38728212
24468,100,1807500,3,10,45,28,312,38728312
24469,1604,1807600,10,10,45,29,916,38729916
24470,1058,1807400,2,10,45,30,974,38730974
24471,92,1807600,6,10,45,31,66,38731066
24473,559,1807500,1,10,45,31,625,38731625
24474,395,1807500,1,10,45,32,20,38732020
24475,547,1807700,10,10,45,32,567,38732567
24476,5129,1807700,1,10,45,37,696,38737696
24477,476,1807700,1,10,45,38,172,38738172
24478,463,1807600,1,10,45,38,635,38738635
24479,1436,1807700,1,10,45,40,71,38740071
24480,695,1807700,1,10,45,40,766,38740766
24481,879,1807700,1,10,45,41,645,38741645
24482,130,1807700,1,10,45,41,775,38741775
24483,19,1807700,1,10,45,41,794,38741794
24484,1129,1807700,1,10,45,42,923,38742923
24485,2497,1807700,1,10,45,45,420,38745420
24486,1011,1807700,1,10,45,46,431,38746431
24487,6466,1807600,1,10,45,52,897,38752897
24488,214,1807700,1,10,45,53,111,38753111
24489,9663,1807600,1,10,46,2,774,38762774
24490,279,1807700,1,10,46,3,53,38763053
24491,176,1807700,1,10,46,3,229,38763229
24492,1858,1807700,1,10,46,5,87,38765087
24493,1106,1807700,9,10,46,6,193,38766193
24494,2,1807800,7,10,46,6,195,38766195
24495,0,1807800,1,10,46,6,195,38766195
24496,0,1807800,1,10,46,6,195,38766195
24497,1,1807800,2,10,46,6,196,38766196
24498,0,1807800,2,10,46,6,196,38766196
24499,114,1807800,1,10,46,6,310,38766310
24500,57,1807700,3,10,46,6,367,38766367
24501,270,1807700,1,10,46,6,637,38766637
24502,83,1807800,1,10,46,6,720,38766720
24503,76,1807800,2,10,46,6,796,38766796
24504,0,1807800,3,10,46,6,796,38766796
24505,0,1807800,1,10,46,6,796,38766796
24506,39,1807800,1,10,46,6,835,38766835
24507,837,1807800,1,10,46,7,672,38767672
24508,1492,1807900,3,10,46,9,164,38769164
24509,304,1807800,1,10,46,9,468,38769468
24510,178,1807800,1,10,46,9,646,38769646
24511,1345,1807900,1,10,46,10,991,38770991
24512,0,1807900,1,10,46,10,991,38770991
24513,0,1807900,4,10,46,10,991,38770991
24514,0,1807900,1,10,46,10,991,38770991
24515,1,1807900,1,10,46,10,992,38770992
24516,441,1807900,1,10,46,11,433,38771433
24517,254,1807900,1,10,46,11,687,38771687
24518,795,1807900,2,10,46,12,482,38772482
24519,894,1808000,1,10,46,13,376,38773376
24520,131,1808000,2,10,46,13,507,38773507
24521,2,1808000,2,10,46,13,509,38773509
24522,0,1808000,2,10,46,13,509,38773509
24523,93,1807900,1,10,46,13,602,38773602
24524,1848,1807900,1,10,46,15,450,38775450
24525,5,1807900,1,10,46,15,455,38775455
24526,661,1807900,1,10,46,16,116,38776116
24527,784,1807800,1,10,46,16,900,38776900
24528,256,1807900,1,10,46,17,156,38777156
24529,580,1807900,1,10,46,17,736,38777736
24530,242,1807900,1,10,46,17,978,38777978
24531,8295,1807800,5,10,46,26,273,38786273
24532,2299,1807800,1,10,46,28,572,38788572
24533,180,1807800,4,10,46,28,752,38788752
24535,19,1807700,1,10,46,28,771,38788771
24536,1723,1807900,2,10,46,30,494,38790494
24537,742,1807900,1,10,46,31,236,38791236
24538,2576,1807900,14,10,46,33,812,38793812
24539,796,1808000,43,10,46,34,608,38794608
24540,2,1808100,1,10,46,34,610,38794610
24541,0,1808100,1,10,46,34,610,38794610
24542,1,1808000,3,10,46,34,611,38794611
24543,353,1808100,1,10,46,34,964,38794964
24544,31,1808100,1,10,46,34,995,38794995
24545,33,1808100,1,10,46,35,28,38795028
24546,366,1808000,1,10,46,35,394,38795394
24547,297,1808100,1,10,46,35,691,38795691
24548,85,1808000,1,10,46,35,776,38795776
24549,223,1808000,1,10,46,35,999,38795999
24550,183,1808100,1,10,46,36,182,38796182
24551,265,1808000,1,10,46,36,447,38796447
24552,107,1808100,3,10,46,36,554,38796554
24553,98,1808000,1,10,46,36,652,38796652
24554,125,1808100,1,10,46,36,777,38796777
24555,874,1808000,1,10,46,37,651,38797651
24556,1535,1808000,1,10,46,39,186,38799186
24557,136,1808000,1,10,46,39,322,38799322
24558,1327,1808100,1,10,46,40,649,38800649
24559,0,1808100,2,10,46,40,649,38800649
24560,0,1808100,1,10,46,40,649,38800649
24561,0,1808100,1,10,46,40,649,38800649
24562,1,1808100,18,10,46,40,650,38800650
24563,34,1808100,2,10,46,40,684,38800684
24565,159,1808100,1,10,46,40,843,38800843
24566,176,1808100,1,10,46,41,19,38801019
24567,122,1807900,1,10,46,41,141,38801141
24568,192,1808000,1,10,46,41,333,38801333
24569,417,1808000,1,10,46,41,750,38801750
24570,249,1808000,1,10,46,41,999,38801999
24571,3141,1808000,1,10,46,45,140,38805140
24572,39,1808000,1,10,46,45,179,38805179
24573,2684,1808100,1,10,46,47,863,38807863
24574,3573,1808100,5,10,46,51,436,38811436
24576,43,1808200,1,10,46,51,479,38811479
24577,18,1808200,1,10,46,51,497,38811497
24578,226,1808200,2,10,46,51,723,38811723
24579,71,1808200,1,10,46,51,794,38811794
24580,363,1808100,1,10,46,52,157,38812157
24581,203,1808100,1,10,46,52,360,38812360
24582,1033,1808100,3,10,46,53,393,38813393
24583,386,1808100,6,10,46,53,779,38813779
24584,409,1808200,1,10,46,54,188,38814188
24585,282,1808200,1,10,46,54,470,38814470
24586,39,1808200,2,10,46,54,509,38814509
24587,379,1808200,2,10,46,54,888,38814888
24588,647,1808100,5,10,46,55,535,38815535
24589,85,1808200,1,10,46,55,620,38815620
24590,258,1808200,1,10,46,55,878,38815878
24591,1220,1808100,2,10,46,57,98,38817098
24592,694,1808200,1,10,46,57,792,38817792
24593,550,1808200,1,10,46,58,342,38818342
24594,1910,1808100,1,10,47,0,252,38820252
24595,120,1808200,1,10,47,0,372,38820372
24596,9,1808000,1,10,47,0,381,38820381
24597,185,1808100,1,10,47,0,566,38820566
24598,1321,1808100,1,10,47,1,887,38821887
24599,3020,1808000,1,10,47,4,907,38824907
24600,1645,1808000,1,10,47,6,552,38826552
24601,44,1808000,1,10,47,6,596,38826596
24602,0,1808000,13,10,47,6,596,38826596
24603,303,1808000,1,10,47,6,899,38826899
24604,109,1808100,1,10,47,7,8,38827008
24605,552,1808000,1,10,47,7,560,38827560
24606,215,1808100,2,10,47,7,775,38827775
24607,281,1807900,10,10,47,8,56,38828056
24609,2,1807800,1,10,47,8,58,38828058
24610,81,1807700,1,10,47,8,139,38828139
24611,72,1807800,1,10,47,8,211,38828211
24612,16,1807800,1,10,47,8,227,38828227
24613,17,1807700,1,10,47,8,244,38828244
24614,81,1807800,1,10,47,8,325,38828325
24615,1077,1807700,1,10,47,9,402,38829402
24616,591,1807800,2,10,47,9,993,38829993
24617,1917,1807800,5,10,47,11,910,38831910
24618,1,1807800,16,10,47,11,911,38831911
24619,269,1807800,1,10,47,12,180,38832180
24620,1251,1808000,1,10,47,13,431,38833431
24621,1073,1808000,2,10,47,14,504,38834504
24622,753,1807900,1,10,47,15,257,38835257
24623,1837,1808000,1,10,47,17,94,38837094
24624,2343,1808000,1,10,47,19,437,38839437
24625,585,1808000,2,10,47,20,22,38840022
24626,1233,1808000,1,10,47,21,255,38841255
24628,72,1807900,2,10,47,21,327,38841327
24629,272,1808100,1,10,47,21,599,38841599
24630,1676,1808100,1,10,47,23,275,38843275
24631,338,1808100,1,10,47,23,613,38843613
24632,3248,1808100,1,10,47,26,861,38846861
24633,349,1808000,1,10,47,27,210,38847210
24634,557,1807900,1,10,47,27,767,38847767
24635,1144,1807900,1,10,47,28,911,38848911
24636,1422,1807900,1,10,47,30,333,38850333
24637,250,1807900,1,10,47,30,583,38850583
24638,175,1807900,1,10,47,30,758,38850758
24639,1968,1807900,1,10,47,32,726,38852726
24640,2160,1807900,1,10,47,34,886,38854886
24641,4943,1807900,1,10,47,39,829,38859829
24642,8580,1807800,3,10,47,48,409,38868409
24643,0,1807800,6,10,47,48,409,38868409
24644,1635,1807900,1,10,47,50,44,38870044
24645,636,1807800,1,10,47,50,680,38870680
24646,4819,1807900,1,10,47,55,499,38875499
24647,4847,1807900,21,10,48,0,346,38880346
24648,0,1807900,21,10,48,0,346,38880346
24649,0,1807900,21,10,48,0,346,38880346
24651,11,1808000,1,10,48,0,357,38880357
24652,20,1808200,1,10,48,0,377,38880377
24653,175,1808000,1,10,48,0,552,38880552
24654,75,1808100,3,10,48,0,627,38880627
24655,2072,1808100,3,10,48,2,699,38882699
24656,33,1808100,1,10,48,2,732,38882732
24657,61,1808100,1,10,48,2,793,38882793
24658,175,1808200,8,10,48,2,968,38882968
24659,0,1808200,8,10,48,2,968,38882968
24660,0,1808200,8,10,48,2,968,38882968
24662,3,1808400,1,10,48,2,971,38882971
24663,1,1808400,1,10,48,2,972,38882972
24664,2,1808400,3,10,48,2,974,38882974
24665,36,1808500,1,10,48,3,10,38883010
24666,1,1808500,2,10,48,3,11,38883011
24667,0,1808500,1,10,48,3,11,38883011
24668,0,1808500,2,10,48,3,11,38883011
24669,3,1808400,3,10,48,3,14,38883014
24670,5,1808400,1,10,48,3,19,38883019
24671,5,1808300,1,10,48,3,24,38883024
24672,31,1808500,2,10,48,3,55,38883055
24673,45,1808500,5,10,48,3,100,38883100
24674,65,1808500,5,10,48,3,165,38883165
24675,0,1808400,1,10,48,3,165,38883165
24676,5,1808400,1,10,48,3,170,38883170
24677,51,1808400,1,10,48,3,221,38883221
24678,32,1808400,1,10,48,3,253,38883253
24680,367,1808500,1,10,48,3,620,38883620
24681,78,1808400,1,10,48,3,698,38883698
24682,5,1808500,1,10,48,3,703,38883703
24683,552,1808400,1,10,48,4,255,38884255
24684,1752,1808300,1,10,48,6,7,38886007
24685,695,1808400,1,10,48,6,702,38886702
24686,62,1808300,1,10,48,6,764,38886764
24687,2051,1808200,1,10,48,8,815,38888815
24688,310,1808100,1,10,48,9,125,38889125
24689,557,1808300,1,10,48,9,682,38889682
24690,680,1808300,1,10,48,10,362,38890362
24691,499,1808400,1,10,48,10,861,38890861
24692,106,1808300,1,10,48,10,967,38890967
24693,1064,1808300,1,10,48,12,31,38892031
24694,1026,1808300,1,10,48,13,57,38893057
24695,363,1808400,2,10,48,13,420,38893420
24696,379,1808300,1,10,48,13,799,38893799
24697,1014,1808400,1,10,48,14,813,38894813
24698,74,1808400,1,10,48,14,887,38894887
24699,563,1808400,1,10,48,15,450,38895450
24700,2,1808500,3,10,48,15,452,38895452
24701,744,1808400,1,10,48,16,196,38896196
24702,938,1808500,1,10,48,17,134,38897134
24703,756,1808400,1,10,48,17,890,38897890
24704,321,1808300,1,10,48,18,211,38898211
24705,229,1808400,1,10,48,18,440,38898440
24706,1305,1808300,1,10,48,19,745,38899745
24707,41,1808400,1,10,48,19,786,38899786
24708,902,1808300,1,10,48,20,688,38900688
24709,278,1808400,4,10,48,20,966,38900966
24710,390,1808500,1,10,48,21,356,38901356
24711,70,1808500,1,10,48,21,426,38901426
24712,39,1808400,1,10,48,21,465,38901465
24713,1696,1808400,1,10,48,23,161,38903161
24714,729,1808400,1,10,48,23,890,38903890
24715,177,1808400,1,10,48,24,67,38904067
24716,628,1808400,1,10,48,24,695,38904695
24717,1522,1808400,2,10,48,26,217,38906217
24718,1131,1808500,1,10,48,27,348,38907348
24719,265,1808400,1,10,48,27,613,38907613
24720,1985,1808500,10,10,48,29,598,38909598
24721,1,1808500,1,10,48,29,599,38909599
24722,72,1808400,1,10,48,29,671,38909671
24723,1633,1808600,1,10,48,31,304,38911304
24724,65,1808600,2,10,48,31,369,38911369
24725,12,1808600,1,10,48,31,381,38911381
24726,22,1808600,1,10,48,31,403,38911403
24727,14,1808500,1,10,48,31,417,38911417
24728,124,1808600,1,10,48,31,541,38911541
24729,785,1808600,1,10,48,32,326,38912326
24730,1,1808600,1,10,48,32,327,38912327
24731,0,1808700,2,10,48,32,327,38912327
24732,1,1808700,1,10,48,32,328,38912328
24733,0,1808700,2,10,48,32,328,38912328
24734,104,1808700,1,10,48,32,432,38912432
24735,59,1808700,1,10,48,32,491,38912491
24736,17,1808800,1,10,48,32,508,38912508
24737,115,1808700,1,10,48,32,623,38912623
24738,432,1808600,1,10,48,33,55,38913055
24739,23,1808700,1,10,48,33,78,38913078
24740,331,1808700,2,10,48,33,409,38913409
24741,35,1808600,1,10,48,33,444,38913444
24742,0,1808600,2,10,48,33,444,38913444
24743,1,1808600,1,10,48,33,445,38913445
24744,0,1808600,1,10,48,33,445,38913445
24745,0,1808600,2,10,48,33,445,38913445
24746,45,1808600,1,10,48,33,490,38913490
24747,50,1808600,1,10,48,33,540,38913540
24748,204,1808600,1,10,48,33,744,38913744
24749,129,1808600,1,10,48,33,873,38913873
24750,1429,1808600,2,10,48,35,302,38915302
24751,102,1808600,1,10,48,35,404,38915404
24752,1068,1808600,1,10,48,36,472,38916472
24753,223,1808500,1,10,48,36,695,38916695
24754,143,1808600,1,10,48,36,838,38916838
24755,582,1808500,1,10,48,37,420,38917420
24756,1,1808500,1,10,48,37,421,38917421
24757,14,1808500,1,10,48,37,435,38917435
24758,132,1808500,1,10,48,37,567,38917567
24759,363,1808500,2,10,48,37,930,38917930
24760,494,1808500,1,10,48,38,424,38918424
24761,74,1808500,1,10,48,38,498,38918498
24762,1218,1808500,1,10,48,39,716,38919716
24763,1153,1808500,3,10,48,40,869,38920869
24764,499,1808500,1,10,48,41,368,38921368
24765,1262,1808400,1,10,48,42,630,38922630
24766,46,1808500,1,10,48,42,676,38922676
24767,772,1808500,1,10,48,43,448,38923448
24768,1187,1808400,1,10,48,44,635,38924635
24769,415,1808500,1,10,48,45,50,38925050
24770,640,1808500,5,10,48,45,690,38925690
24771,2274,1808500,3,10,48,47,964,38927964
24772,1719,1808500,1,10,48,49,683,38929683
24773,543,1808400,1,10,48,50,226,38930226
24774,654,1808500,2,10,48,50,880,38930880
24775,0,1808500,1,10,48,50,880,38930880
24776,2460,1808500,4,10,48,53,340,38933340
24777,4466,1808600,1,10,48,57,806,38937806
24778,137,1808600,2,10,48,57,943,38937943
24779,0,1808600,1,10,48,57,943,38937943
24780,1,1808600,2,10,48,57,944,38937944
24781,0,1808600,1,10,48,57,944,38937944
24782,356,1808600,1,10,48,58,300,38938300
24783,0,1808600,1,10,48,58,300,38938300
24784,152,1808600,1,10,48,58,452,38938452
24785,875,1808700,1,10,48,59,327,38939327
24786,157,1808600,2,10,48,59,484,38939484
24787,355,1808600,1,10,48,59,839,38939839
24788,43,1808600,1,10,48,59,882,38939882
24789,823,1808500,1,10,49,0,705,38940705
24790,6,1808500,1,10,49,0,711,38940711
24791,137,1808600,9,10,49,0,848,38940848
24792,194,1808700,1,10,49,1,42,38941042
24793,45,1808600,1,10,49,1,87,38941087
24794,3854,1808600,5,10,49,4,941,38944941
24795,233,1808600,1,10,49,5,174,38945174
24796,535,1808600,1,10,49,5,709,38945709
24797,98,1808600,1,10,49,5,807,38945807
24798,596,1808700,1,10,49,6,403,38946403
24799,1486,1808600,2,10,49,7,889,38947889
24800,89,1808600,3,10,49,7,978,38947978
24801,1,1808600,7,10,49,7,979,38947979
24802,456,1808600,1,10,49,8,435,38948435
24803,323,1808500,1,10,49,8,758,38948758
24804,497,1808500,1,10,49,9,255,38949255
24805,2,1808500,6,10,49,9,257,38949257
24806,41,1808400,1,10,49,9,298,38949298
24807,37,1808400,3,10,49,9,335,38949335
24808,1,1808400,1,10,49,9,336,38949336
24809,0,1808400,1,10,49,9,336,38949336
24810,0,1808400,1,10,49,9,336,38949336
24811,0,1808400,4,10,49,9,336,38949336
24812,156,1808300,3,10,49,9,492,38949492
24813,5267,1808300,3,10,49,14,759,38954759
24814,439,1808300,1,10,49,15,198,38955198
24815,1184,1808400,2,10,49,16,382,38956382
24817,692,1808300,1,10,49,17,74,38957074
24818,288,1808400,6,10,49,17,362,38957362
24820,579,1808300,1,10,49,17,941,38957941
24821,1,1808300,1,10,49,17,942,38957942
24822,2541,1808300,1,10,49,20,483,38960483
24823,3939,1808300,1,10,49,24,422,38964422
24824,2072,1808300,1,10,49,26,494,38966494
24825,87,1808300,1,10,49,26,581,38966581
24826,3013,1808200,1,10,49,29,594,38969594
24827,32,1808200,1,10,49,29,626,38969626
24828,3012,1808200,1,10,49,32,638,38972638
24829,59,1808200,1,10,49,32,697,38972697
24830,506,1808200,1,10,49,33,203,38973203
24831,1094,1808200,1,10,49,34,297,38974297
24832,38,1808200,1,10,49,34,335,38974335
24833,3851,1808200,2,10,49,38,186,38978186
24834,8,1808200,1,10,49,38,194,38978194
24835,820,1808200,1,10,49,39,14,38979014
24836,76,1808200,1,10,49,39,90,38979090
24837,1297,1808200,2,10,49,40,387,38980387
24838,5848,1808100,16,10,49,46,235,38986235
24839,127,1808100,2,10,49,46,362,38986362
24840,80,1808100,1,10,49,46,442,38986442
24841,2290,1808100,2,10,49,48,732,38988732
24842,112,1808000,1,10,49,48,844,38988844
24843,249,1808100,3,10,49,49,93,38989093
24844,74,1808100,1,10,49,49,167,38989167
24845,91,1808000,1,10,49,49,258,38989258
24846,716,1808200,3,10,49,49,974,38989974
24847,5098,1808100,1,10,49,55,72,38995072
24848,3130,1808200,9,10,49,58,202,38998202
24850,157,1808200,1,10,49,58,359,38998359
24851,291,1808100,1,10,49,58,650,38998650
24852,2279,1808200,2,10,50,0,929,39000929
24853,73,1808200,1,10,50,1,2,39001002
24854,67,1808300,2,10,50,1,69,39001069
24855,6,1808200,1,10,50,1,75,39001075
24856,23,1808200,1,10,50,1,98,39001098
24857,12,1808100,1,10,50,1,110,39001110
24858,10,1808100,1,10,50,1,120,39001120
24859,27,1808100,1,10,50,1,147,39001147
24860,96,1808100,1,10,50,1,243,39001243
24861,51,1808300,1,10,50,1,294,39001294
24862,215,1808300,1,10,50,1,509,39001509
24863,238,1808200,1,10,50,1,747,39001747
24864,703,1808100,1,10,50,2,450,39002450
24865,2622,1808100,1,10,50,5,72,39005072
24866,108,1808100,4,10,50,5,180,39005180
24867,0,1808100,1,10,50,5,180,39005180
24868,1867,1808100,2,10,50,7,47,39007047
24869,229,1808000,19,10,50,7,276,39007276
24870,751,1807900,1,10,50,8,27,39008027
24871,524,1807900,1,10,50,8,551,39008551
24872,821,1807800,15,10,50,9,372,39009372
24873,168,1807700,1,10,50,9,540,39009540
24874,50,1807700,1,10,50,9,590,39009590
24875,944,1807700,1,10,50,10,534,39010534
24876,42,1807700,1,10,50,10,576,39010576
24877,798,1807700,1,10,50,11,374,39011374
24878,238,1807700,5,10,50,11,612,39011612
24879,365,1807700,1,10,50,11,977,39011977
24880,490,1807800,1,10,50,12,467,39012467
24881,1283,1807800,1,10,50,13,750,39013750
24882,156,1807700,1,10,50,13,906,39013906
24883,169,1807700,5,10,50,14,75,39014075
24884,116,1807800,1,10,50,14,191,39014191
24885,163,1807800,1,10,50,14,354,39014354
24886,58,1807700,1,10,50,14,412,39014412
24887,706,1807700,1,10,50,15,118,39015118
24888,1131,1807700,2,10,50,16,249,39016249
24889,663,1807700,2,10,50,16,912,39016912
24890,231,1807600,10,10,50,17,143,39017143
24891,767,1807700,2,10,50,17,910,39017910
24892,350,1807700,1,10,50,18,260,39018260
24894,117,1807500,1,10,50,18,377,39018377
24895,118,1807500,1,10,50,18,495,39018495
24896,185,1807500,4,10,50,18,680,39018680
24897,653,1807600,1,10,50,19,333,39019333
24898,1,1807700,1,10,50,19,334,39019334
24899,1,1807700,1,10,50,19,335,39019335
24900,2007,1807800,2,10,50,21,342,39021342
24901,1,1807800,1,10,50,21,343,39021343
24902,805,1807800,1,10,50,22,148,39022148
24903,125,1807800,1,10,50,22,273,39022273
24904,2068,1807800,1,10,50,24,341,39024341
24905,1143,1807800,1,10,50,25,484,39025484
24906,530,1807900,3,10,50,26,14,39026014
24907,468,1807800,1,10,50,26,482,39026482
24908,421,1807900,2,10,50,26,903,39026903
24909,1289,1808000,7,10,50,28,192,39028192
24910,5477,1808100,1,10,50,33,669,39033669
24911,36,1808100,3,10,50,33,705,39033705
24912,347,1808000,1,10,50,34,52,39034052
24913,4147,1808000,1,10,50,38,199,39038199
24914,1786,1808000,2,10,50,39,985,39039985
24915,2558,1808000,2,10,50,42,543,39042543
24916,1118,1808100,1,10,50,43,661,39043661
24917,1,1808100,1,10,50,43,662,39043662
24918,0,1808100,3,10,50,43,662,39043662
24919,1452,1808200,2,10,50,45,114,39045114
24920,1512,1808100,1,10,50,46,626,39046626
24921,20,1808200,1,10,50,46,646,39046646
24922,1946,1808100,1,10,50,48,592,39048592
24923,4451,1808300,2,10,50,53,43,39053043
24924,953,1808300,1,10,50,53,996,39053996
24925,539,1808300,2,10,50,54,535,39054535
24926,580,1808200,1,10,50,55,115,39055115
24927,4809,1808200,1,10,50,59,924,39059924
24928,2090,1808300,1,10,51,2,14,39062014
24929,355,1808300,1,10,51,2,369,39062369
24930,10,1808200,1,10,51,2,379,39062379
24931,43,1808300,1,10,51,2,422,39062422
24932,59,1808300,1,10,51,2,481,39062481
24933,41,1808300,1,10,51,2,522,39062522
24934,559,1808300,1,10,51,3,81,39063081
24935,922,1808300,1,10,51,4,3,39064003
24936,2219,1808200,1,10,51,6,222,39066222
24937,1047,1808300,5,10,51,7,269,39067269
24938,386,1808400,1,10,51,7,655,39067655
24939,0,1808400,2,10,51,7,655,39067655
24940,329,1808300,5,10,51,7,984,39067984
24941,94,1808300,1,10,51,8,78,39068078
24942,2662,1808300,1,10,51,10,740,39070740
24943,930,1808400,1,10,51,11,670,39071670
24944,471,1808300,5,10,51,12,141,39072141
24945,354,1808400,1,10,51,12,495,39072495
24946,658,1808400,1,10,51,13,153,39073153
24947,720,1808400,2,10,51,13,873,39073873
24948,1032,1808300,1,10,51,14,905,39074905
24949,2980,1808300,3,10,51,17,885,39077885
24950,2145,1808300,1,10,51,20,30,39080030
24951,75,1808300,1,10,51,20,105,39080105
24952,1656,1808300,1,10,51,21,761,39081761
24953,96,1808300,1,10,51,21,857,39081857
24954,744,1808400,1,10,51,22,601,39082601
24955,1338,1808300,1,10,51,23,939,39083939
24956,138,1808400,1,10,51,24,77,39084077
24957,3234,1808400,1,10,51,27,311,39087311
24958,424,1808400,2,10,51,27,735,39087735
24959,1447,1808400,14,10,51,29,182,39089182
24960,120,1808500,2,10,51,29,302,39089302
24961,59,1808500,1,10,51,29,361,39089361
24962,1284,1808500,1,10,51,30,645,39090645
24963,4,1808500,1,10,51,30,649,39090649
24964,29,1808500,1,10,51,30,678,39090678
24965,5,1808400,1,10,51,30,683,39090683
24966,71,1808500,1,10,51,30,754,39090754
24967,74,1808500,1,10,51,30,828,39090828
24968,30,1808500,1,10,51,30,858,39090858
24969,2051,1808500,1,10,51,32,909,39092909
24970,1645,1808400,3,10,51,34,554,39094554
24971,143,1808500,2,10,51,34,697,39094697
24972,1638,1808400,2,10,51,36,335,39096335
24973,961,1808400,2,10,51,37,296,39097296
24974,847,1808400,2,10,51,38,143,39098143
24975,0,1808400,1,10,51,38,143,39098143
24976,0,1808400,1,10,51,38,143,39098143
24977,2434,1808300,1,10,51,40,577,39100577
24978,3266,1808300,1,10,51,43,843,39103843
24979,0,1808300,5,10,51,43,843,39103843
24980,95,1808300,1,10,51,43,938,39103938
24981,7232,1808100,1,10,51,51,170,39111170
24982,1615,1808100,1,10,51,52,785,39112785
24983,5410,1808200,1,10,51,58,195,39118195
24984,3182,1808000,2,10,52,1,377,39121377
24985,7948,1808000,1,10,52,9,325,39129325
24986,4843,1807900,1,10,52,14,168,39134168
24987,5668,1807900,1,10,52,19,836,39139836
24988,907,1807900,6,10,52,20,743,39140743
24989,977,1807800,2,10,52,21,720,39141720
24990,1812,1807800,2,10,52,23,532,39143532
24991,350,1807800,2,10,52,23,882,39143882
24992,1805,1807800,1,10,52,25,687,39145687
24993,85,1807800,1,10,52,25,772,39145772
24994,24,1808000,1,10,52,25,796,39145796
24995,8198,1807800,1,10,52,33,994,39153994
24996,1389,1807800,6,10,52,35,383,39155383
24997,1,1807800,2,10,52,35,384,39155384
24998,1578,1807700,1,10,52,36,962,39156962
24999,1080,1807700,1,10,52,38,42,39158042
25000,149,1807700,2,10,52,38,191,39158191
25001,0,1807700,3,10,52,38,191,39158191
25002,2968,1807600,3,10,52,41,159,39161159
25003,2783,1807600,1,10,52,43,942,39163942
25004,1296,1807600,1,10,52,45,238,39165238
25005,2086,1807600,1,10,52,47,324,39167324
25006,360,1807600,6,10,52,47,684,39167684
25007,176,1807600,1,10,52,47,860,39167860
25008,2731,1807600,2,10,52,50,591,39170591
25009,1393,1807500,1,10,52,51,984,39171984
25010,165,1807500,1,10,52,52,149,39172149
25011,118,1807500,1,10,52,52,267,39172267
25012,388,1807500,1,10,52,52,655,39172655
25013,118,1807500,1,10,52,52,773,39172773
25014,517,1807500,1,10,52,53,290,39173290
25015,232,1807500,1,10,52,53,522,39173522
25016,566,1807500,1,10,52,54,88,39174088
25017,180,1807500,1,10,52,54,268,39174268
25018,6,1807500,1,10,52,54,274,39174274
25019,282,1807500,1,10,52,54,556,39174556
25020,848,1807500,1,10,52,55,404,39175404
25021,2185,1807500,1,10,52,57,589,39177589
25022,952,1807600,1,10,52,58,541,39178541
25023,688,1807500,1,10,52,59,229,39179229
25024,179,1807500,1,10,52,59,408,39179408
25025,61,1807600,1,10,52,59,469,39179469
25026,1206,1807500,3,10,53,0,675,39180675
25027,187,1807600,1,10,53,0,862,39180862
25028,0,1807500,37,10,53,0,862,39180862
25029,2,1807400,1,10,53,0,864,39180864
25030,0,1807400,4,10,53,0,864,39180864
25031,0,1807400,5,10,53,0,864,39180864
25032,1,1807400,1,10,53,0,865,39180865
25033,128,1807400,1,10,53,0,993,39180993
25034,679,1807500,1,10,53,1,672,39181672
25035,2392,1807400,5,10,53,4,64,39184064
25036,0,1807400,2,10,53,4,64,39184064
25037,940,1807500,1,10,53,5,4,39185004
25038,255,1807500,1,10,53,5,259,39185259
25039,94,1807500,2,10,53,5,353,39185353
25040,120,1807400,1,10,53,5,473,39185473
25041,395,1807500,1,10,53,5,868,39185868
25042,1086,1807500,1,10,53,6,954,39186954
25043,633,1807600,2,10,53,7,587,39187587
25044,0,1807600,1,10,53,7,587,39187587
25045,3670,1807500,2,10,53,11,257,39191257
25046,3481,1807500,1,10,53,14,738,39194738
25047,73,1807500,1,10,53,14,811,39194811
25048,1063,1807500,1,10,53,15,874,39195874
25049,6497,1807500,2,10,53,22,371,39202371
25050,422,1807500,1,10,53,22,793,39202793
25051,1800,1807500,1,10,53,24,593,39204593
25052,2333,1807500,1,10,53,26,926,39206926
25053,10262,1807500,1,10,53,37,188,39217188
25054,178,1807500,2,10,53,37,366,39217366
25055,0,1807500,1,10,53,37,366,39217366
25056,1,1807400,3,10,53,37,367,39217367
25057,1462,1807500,4,10,53,38,829,39218829
25058,500,1807400,1,10,53,39,329,39219329
25059,575,1807400,1,10,53,39,904,39219904
25060,273,1807400,5,10,53,40,177,39220177
25061,1,1807400,6,10,53,40,178,39220178
25062,969,1807300,1,10,53,41,147,39221147
25063,1192,1807300,1,10,53,42,339,39222339
25064,524,1807300,3,10,53,42,863,39222863
25065,819,1807300,1,10,53,43,682,39223682
25066,3132,1807300,1,10,53,46,814,39226814
25067,1917,1807300,7,10,53,48,731,39228731
25068,215,1807200,1,10,53,48,946,39228946
25069,60,1807200,2,10,53,49,6,39229006
25070,573,1807200,1,10,53,49,579,39229579
25071,217,1807200,1,10,53,49,796,39229796
25072,508,1807200,1,10,53,50,304,39230304
25073,0,1807200,3,10,53,50,304,39230304
25074,0,1807200,1,10,53,50,304,39230304
25075,0,1807200,3,10,53,50,304,39230304
25076,0,1807200,1,10,53,50,304,39230304
25077,0,1807200,1,10,53,50,304,39230304
25078,968,1807200,1,10,53,51,272,39231272
25080,386,1807300,1,10,53,51,658,39231658
25081,3010,1807100,5,10,53,54,668,39234668
25082,231,1807100,1,10,53,54,899,39234899
25083,2217,1807100,1,10,53,57,116,39237116
25084,919,1807100,1,10,53,58,35,39238035
25085,1179,1807200,2,10,53,59,214,39239214
25086,808,1807100,1,10,54,0,22,39240022
25087,1977,1807100,3,10,54,1,999,39241999
25088,674,1807100,1,10,54,2,673,39242673
25089,654,1807200,1,10,54,3,327,39243327
25090,711,1807200,1,10,54,4,38,39244038
25091,2686,1807200,1,10,54,6,724,39246724
25092,1459,1807100,2,10,54,8,183,39248183
25093,111,1807100,1,10,54,8,294,39248294
25094,561,1807200,1,10,54,8,855,39248855
25095,848,1807100,1,10,54,9,703,39249703
25096,3012,1807100,1,10,54,12,715,39252715
25097,56,1807100,1,10,54,12,771,39252771
25098,1929,1807100,1,10,54,14,700,39254700
25099,1943,1807100,5,10,54,16,643,39256643
25100,494,1807200,1,10,54,17,137,39257137
25101,2092,1807100,1,10,54,19,229,39259229
25102,4138,1807100,3,10,54,23,367,39263367
25103,150,1807100,1,10,54,23,517,39263517
25104,1531,1807100,1,10,54,25,48,39265048
25105,1486,1807200,1,10,54,26,534,39266534
25106,0,1807200,1,10,54,26,534,39266534
25107,0,1807200,1,10,54,26,534,39266534
25108,1,1807200,1,10,54,26,535,39266535
25109,0,1807200,8,10,54,26,535,39266535
25110,0,1807200,1,10,54,26,535,39266535
25111,0,1807200,8,10,54,26,535,39266535
25112,0,1807200,1,10,54,26,535,39266535
25113,193,1807200,1,10,54,26,728,39266728
25114,1451,1807300,6,10,54,28,179,39268179
25115,122,1807300,1,10,54,28,301,39268301
25116,4035,1807300,7,10,54,32,336,39272336
25117,75,1807300,1,10,54,32,411,39272411
25118,22,1807300,1,10,54,32,433,39272433
25119,123,1807300,1,10,54,32,556,39272556
25120,1268,1807300,1,10,54,33,824,39273824
25121,234,1807300,2,10,54,34,58,39274058
25122,108,1807400,10,10,54,34,166,39274166
25123,80,1807400,1,10,54,34,246,39274246
25124,1921,1807300,1,10,54,36,167,39276167
25125,63,1807200,1,10,54,36,230,39276230
25126,137,1807400,5,10,54,36,367,39276367
25127,40,1807300,1,10,54,36,407,39276407
25128,1950,1807300,3,10,54,38,357,39278357
25129,654,1807200,1,10,54,39,11,39279011
25130,199,1807200,1,10,54,39,210,39279210
25131,91,1807200,1,10,54,39,301,39279301
25132,13,1807200,1,10,54,39,314,39279314
25133,1016,1807300,1,10,54,40,330,39280330
25134,561,1807300,1,10,54,40,891,39280891
25135,76,1807300,1,10,54,40,967,39280967
25136,3050,1807300,1,10,54,44,17,39284017
25137,146,1807300,1,10,54,44,163,39284163
25138,3414,1807400,1,10,54,47,577,39287577
25139,142,1807400,8,10,54,47,719,39287719
25140,3597,1807400,1,10,54,51,316,39291316
25141,1083,1807400,1,10,54,52,399,39292399
25142,257,1807500,1,10,54,52,656,39292656
25143,682,1807400,1,10,54,53,338,39293338
25144,36,1807400,1,10,54,53,374,39293374
25145,223,1807500,1,10,54,53,597,39293597
25146,2013,1807500,1,10,54,55,610,39295610
25147,1635,1807500,1,10,54,57,245,39297245
25148,3258,1807500,1,10,55,0,503,39300503
25149,1786,1807500,3,10,55,2,289,39302289
25150,523,1807500,4,10,55,2,812,39302812
25151,290,1807600,1,10,55,3,102,39303102
25152,15,1807600,1,10,55,3,117,39303117
25153,3,1807600,1,10,55,3,120,39303120
25154,209,1807500,1,10,55,3,329,39303329
25155,1848,1807500,1,10,55,5,177,39305177
25156,1141,1807600,1,10,55,6,318,39306318
25157,2963,1807500,2,10,55,9,281,39309281
25158,404,1807400,1,10,55,9,685,39309685
25159,1340,1807400,1,10,55,11,25,39311025
25160,535,1807400,1,10,55,11,560,39311560
25161,2986,1807400,1,10,55,14,546,39314546
25162,228,1807500,1,10,55,14,774,39314774
25163,1307,1807400,1,10,55,16,81,39316081
25164,405,1807500,2,10,55,16,486,39316486
25165,1489,1807500,1,10,55,17,975,39317975
25166,413,1807400,1,10,55,18,388,39318388
25167,415,1807400,4,10,55,18,803,39318803
25168,143,1807500,1,10,55,18,946,39318946
25169,389,1807500,1,10,55,19,335,39319335
25170,1511,1807600,1,10,55,20,846,39320846
25171,1846,1807500,2,10,55,22,692,39322692
25172,285,1807500,4,10,55,22,977,39322977
25173,1,1807500,4,10,55,22,978,39322978
25174,958,1807500,1,10,55,23,936,39323936
25175,179,1807500,1,10,55,24,115,39324115
25176,470,1807400,1,10,55,24,585,39324585
25177,2871,1807500,1,10,55,27,456,39327456
25178,2604,1807500,1,10,55,30,60,39330060
25179,581,1807400,1,10,55,30,641,39330641
25180,1066,1807500,1,10,55,31,707,39331707
25181,887,1807500,1,10,55,32,594,39332594
25182,2461,1807500,1,10,55,35,55,39335055
25183,5,1807500,1,10,55,35,60,39335060
25184,579,1807500,1,10,55,35,639,39335639
25185,5424,1807500,1,10,55,41,63,39341063
25187,825,1807400,1,10,55,41,888,39341888
25188,3819,1807600,1,10,55,45,707,39345707
25189,3745,1807400,1,10,55,49,452,39349452
25190,4871,1807400,1,10,55,54,323,39354323
25191,751,1807400,3,10,55,55,74,39355074
25192,1574,1807500,2,10,55,56,648,39356648
25194,89,1807400,1,10,55,56,737,39356737
25195,48,1807400,1,10,55,56,785,39356785
25196,4168,1807400,1,10,56,0,953,39360953
25197,0,1807400,1,10,56,0,953,39360953
25198,0,1807400,1,10,56,0,953,39360953
25199,1,1807400,1,10,56,0,954,39360954
25200,0,1807400,1,10,56,0,954,39360954
25201,102,1807300,12,10,56,1,56,39361056
25203,36,1807300,3,10,56,1,92,39361092
25205,45,1807300,1,10,56,1,137,39361137
25206,6613,1807400,6,10,56,7,750,39367750
25207,1016,1807400,1,10,56,8,766,39368766
25208,1605,1807400,6,10,56,10,371,39370371
25209,238,1807500,2,10,56,10,609,39370609
25210,1097,1807400,1,10,56,11,706,39371706
25211,476,1807400,6,10,56,12,182,39372182
25212,0,1807400,6,10,56,12,182,39372182
25214,3119,1807300,2,10,56,15,301,39375301
25215,1540,1807400,3,10,56,16,841,39376841
25216,1273,1807300,1,10,56,18,114,39378114
25217,93,1807400,3,10,56,18,207,39378207
25218,1100,1807400,1,10,56,19,307,39379307
25219,549,1807300,6,10,56,19,856,39379856
25221,300,1807400,3,10,56,20,156,39380156
25222,4403,1807300,1,10,56,24,559,39384559
25223,1669,1807200,8,10,56,26,228,39386228
25224,2231,1807200,1,10,56,28,459,39388459
25225,643,1807300,2,10,56,29,102,39389102
25226,987,1807200,2,10,56,30,89,39390089
25227,63,1807200,1,10,56,30,152,39390152
25228,638,1807200,3,10,56,30,790,39390790
25229,594,1807100,2,10,56,31,384,39391384
25230,2706,1807200,1,10,56,34,90,39394090
25231,1232,1807100,2,10,56,35,322,39395322
25232,452,1807100,5,10,56,35,774,39395774
25233,2627,1807200,5,10,56,38,401,39398401
25234,74,1807200,1,10,56,38,475,39398475
25235,2541,1807200,1,10,56,41,16,39401016
25236,207,1807200,1,10,56,41,223,39401223
25237,1261,1807200,1,10,56,42,484,39402484
25238,480,1807300,1,10,56,42,964,39402964
25239,240,1807200,1,10,56,43,204,39403204
25240,1020,1807200,15,10,56,44,224,39404224
25241,1,1807200,1,10,56,44,225,39404225
25242,3693,1807200,5,10,56,47,918,39407918
25243,48,1807100,23,10,56,47,966,39407966
25244,1,1807000,27,10,56,47,967,39407967
25245,10,1806900,3,10,56,47,977,39407977
25246,38,1806900,2,10,56,48,15,39408015
25247,22,1806900,1,10,56,48,37,39408037
25248,66,1807000,2,10,56,48,103,39408103
25250,135,1807100,5,10,56,48,238,39408238
25251,135,1807100,5,10,56,48,373,39408373
25252,136,1807100,1,10,56,48,509,39408509
25253,339,1807200,1,10,56,48,848,39408848
25254,537,1807200,1,10,56,49,385,39409385
25255,5809,1807200,1,10,56,55,194,39415194
25256,251,1807100,7,10,56,55,445,39415445
25257,974,1807100,1,10,56,56,419,39416419
25258,994,1807100,1,10,56,57,413,39417413
25259,1108,1807100,3,10,56,58,521,39418521
25260,989,1807100,4,10,56,59,510,39419510
25261,186,1807100,1,10,56,59,696,39419696
25262,1701,1807100,2,10,57,1,397,39421397
25263,388,1807200,1,10,57,1,785,39421785
25264,0,1807200,13,10,57,1,785,39421785
25265,96,1807200,2,10,57,1,881,39421881
25266,83,1807300,1,10,57,1,964,39421964
25267,3,1807300,1,10,57,1,967,39421967
25268,0,1807300,1,10,57,1,967,39421967
25269,9,1807300,1,10,57,1,976,39421976
25270,2,1807400,1,10,57,1,978,39421978
25271,6,1807400,1,10,57,1,984,39421984
25272,1,1807400,1,10,57,1,985,39421985
25273,5,1807400,1,10,57,1,990,39421990
25274,253,1807300,1,10,57,2,243,39422243
25275,2122,1807300,1,10,57,4,365,39424365
25276,79,1807400,2,10,57,4,444,39424444
25277,1353,1807300,2,10,57,5,797,39425797
25278,3039,1807300,1,10,57,8,836,39428836
25279,1051,1807400,1,10,57,9,887,39429887
25280,3692,1807400,2,10,57,13,579,39433579
25281,1110,1807400,1,10,57,14,689,39434689
25282,0,1807400,2,10,57,14,689,39434689
25283,1276,1807400,1,10,57,15,965,39435965
25284,2922,1807400,1,10,57,18,887,39438887
25285,74,1807400,1,10,57,18,961,39438961
25286,13087,1807500,3,10,57,32,48,39452048
25287,2,1807500,18,10,57,32,50,39452050
25288,118,1807500,1,10,57,32,168,39452168
25289,1196,1807500,1,10,57,33,364,39453364
25290,2436,1807500,2,10,57,35,800,39455800
25291,1,1807500,7,10,57,35,801,39455801
25292,131,1807500,1,10,57,35,932,39455932
25293,1947,1807400,3,10,57,37,879,39457879
25294,1029,1807400,3,10,57,38,908,39458908
25295,1,1807300,2,10,57,38,909,39458909
25296,41,1807200,1,10,57,38,950,39458950
25297,0,1807200,1,10,57,38,950,39458950
25298,263,1807400,2,10,57,39,213,39459213
25299,922,1807500,1,10,57,40,135,39460135
25300,1069,1807300,1,10,57,41,204,39461204
25301,2730,1807300,2,10,57,43,934,39463934
25302,0,1807300,2,10,57,43,934,39463934
25304,809,1807300,1,10,57,44,743,39464743
25305,8395,1807400,1,10,57,53,138,39473138
25306,563,1807400,3,10,57,53,701,39473701
25307,212,1807300,1,10,57,53,913,39473913
25308,6119,1807300,1,10,58,0,32,39480032
25309,976,1807400,1,10,58,1,8,39481008
25310,247,1807300,1,10,58,1,255,39481255
25311,7071,1807400,1,10,58,8,326,39488326
25312,601,1807400,1,10,58,8,927,39488927
25313,1388,1807400,1,10,58,10,315,39490315
25314,657,1807300,1,10,58,10,972,39490972
25315,1938,1807300,1,10,58,12,910,39492910
25316,1374,1807300,1,10,58,14,284,39494284
25317,3411,1807300,4,10,58,17,695,39497695
25318,2702,1807300,1,10,58,20,397,39500397
25319,4426,1807200,1,10,58,24,823,39504823
25320,6247,1807300,3,10,58,31,70,39511070
25321,0,1807300,9,10,58,31,70,39511070
25322,0,1807300,3,10,58,31,70,39511070
25323,1,1807400,2,10,58,31,71,39511071
25324,1,1807400,1,10,58,31,72,39511072
25325,0,1807400,1,10,58,31,72,39511072
25326,0,1807400,1,10,58,31,72,39511072
25327,0,1807400,3,10,58,31,72,39511072
25328,0,1807400,1,10,58,31,72,39511072
25329,205,1807400,9,10,58,31,277,39511277
25330,19,1807300,3,10,58,31,296,39511296
25331,976,1807300,2,10,58,32,272,39512272
25332,6,1807300,1,10,58,32,278,39512278
25333,1210,1807400,2,10,58,33,488,39513488
25334,2704,1807400,2,10,58,36,192,39516192
25335,1672,1807500,1,10,58,37,864,39517864
25336,342,1807400,1,10,58,38,206,39518206
25337,619,1807400,1,10,58,38,825,39518825
25338,450,1807500,1,10,58,39,275,39519275
25339,932,1807500,2,10,58,40,207,39520207
25340,2240,1807500,5,10,58,42,447,39522447
25341,1262,1807600,1,10,58,43,709,39523709
25342,952,1807600,7,10,58,44,661,39524661
25343,3678,1807700,1,10,58,48,339,39528339
25344,65,1807700,3,10,58,48,404,39528404
25345,38,1807700,1,10,58,48,442,39528442
25346,19,1807600,1,10,58,48,461,39528461
25347,93,1807600,1,10,58,48,554,39528554
25348,2267,1807800,1,10,58,50,821,39530821
25349,137,1807700,1,10,58,50,958,39530958
25350,63,1807800,1,10,58,51,21,39531021
25351,182,1807800,1,10,58,51,203,39531203
25352,2128,1807900,2,10,58,53,331,39533331
25353,597,1807800,1,10,58,53,928,39533928
25354,1740,1807800,1,10,58,55,668,39535668
25355,276,1807800,1,10,58,55,944,39535944
25356,1915,1807800,1,10,58,57,859,39537859
25357,1568,1807800,2,10,58,59,427,39539427
25358,1454,1807700,5,10,59,0,881,39540881
25359,2,1807600,3,10,59,0,883,39540883
25360,2326,1807500,3,10,59,3,209,39543209
25361,1,1807500,1,10,59,3,210,39543210
25362,2575,1807500,1,10,59,5,785,39545785
25363,11630,1807500,2,10,59,17,415,39557415
25364,6029,1807500,1,10,59,23,444,39563444
25365,1933,1807500,1,10,59,25,377,39565377
25366,935,1807500,2,10,59,26,312,39566312
25367,0,1807500,7,10,59,26,312,39566312
25368,16,1807400,1,10,59,26,328,39566328
25370,3453,1807500,2,10,59,29,781,39569781
25371,1254,1807400,2,10,59,31,35,39571035
25372,7419,1807300,1,10,59,38,454,39578454
25373,1464,1807300,4,10,59,39,918,39579918
25374,1,1807300,3,10,59,39,919,39579919
25375,1557,1807300,1,10,59,41,476,39581476
25376,1135,1807200,4,10,59,42,611,39582611
25377,60,1807200,2,10,59,42,671,39582671
25378,6590,1807200,2,10,59,49,261,39589261
25379,4724,1807200,1,10,59,53,985,39593985
25380,1080,1807300,1,10,59,55,65,39595065
25381,1543,1807300,1,10,59,56,608,39596608
25382,1677,1807300,1,10,59,58,285,39598285
25383,1,1807400,1,10,59,58,286,39598286
25384,0,1807400,2,10,59,58,286,39598286
25385,1,1807400,1,10,59,58,287,39598287
25386,0,1807400,1,10,59,58,287,39598287
25387,0,1807400,1,10,59,58,287,39598287
25388,0,1807500,1,10,59,58,287,39598287
25389,269,1807500,1,10,59,58,556,39598556
25390,1179,1807500,2,10,59,59,735,39599735
25391,0,1807500,1,10,59,59,735,39599735
25392,0,1807500,1,10,59,59,735,39599735
25393,1,1807500,4,10,59,59,736,39599736
25394,1347,1807400,10,11,0,1,83,39601083
25395,21,1807500,1,11,0,1,104,39601104
25397,68,1807600,1,11,0,1,172,39601172
25398,518,1807500,4,11,0,1,690,39601690
25399,102,1807500,1,11,0,1,792,39601792
25400,93,1807700,5,11,0,1,885,39601885
25401,251,1807500,2,11,0,2,136,39602136
25402,121,1807500,2,11,0,2,257,39602257
25403,216,1807500,1,11,0,2,473,39602473
25404,427,1807500,2,11,0,2,900,39602900
25405,294,1807400,1,11,0,3,194,39603194
25406,1018,1807400,2,11,0,4,212,39604212
25407,539,1807500,1,11,0,4,751,39604751
25408,855,1807500,1,11,0,5,606,39605606
25409,2920,1807500,1,11,0,8,526,39608526
25410,318,1807500,3,11,0,8,844,39608844
25411,27,1807400,3,11,0,8,871,39608871
25412,5239,1807400,1,11,0,14,110,39614110
25413,555,1807500,2,11,0,14,665,39614665
25414,1526,1807500,1,11,0,16,191,39616191
25415,33,1807400,1,11,0,16,224,39616224
25416,3624,1807500,1,11,0,19,848,39619848
25417,1970,1807500,1,11,0,21,818,39621818
25418,1537,1807500,3,11,0,23,355,39623355
25419,954,1807500,1,11,0,24,309,39624309
25420,4604,1807400,2,11,0,28,913,39628913
25421,497,1807500,3,11,0,29,410,39629410
25422,1444,1807400,1,11,0,30,854,39630854
25423,181,1807400,1,11,0,31,35,39631035
25424,546,1807400,1,11,0,31,581,39631581
25425,204,1807400,1,11,0,31,785,39631785
25426,1,1807400,1,11,0,31,786,39631786
25427,0,1807400,2,11,0,31,786,39631786
25428,2101,1807500,3,11,0,33,887,39633887
25429,2816,1807400,1,11,0,36,703,39636703
25430,6862,1807500,1,11,0,43,565,39643565
25431,7767,1807400,2,11,0,51,332,39651332
25432,2643,1807300,2,11,0,53,975,39653975
25433,62,1807400,1,11,0,54,37,39654037
25434,563,1807300,2,11,0,54,600,39654600
25435,1350,1807500,1,11,0,55,950,39655950
25436,1631,1807400,1,11,0,57,581,39657581
25437,2547,1807300,1,11,1,0,128,39660128
25438,3052,1807400,1,11,1,3,180,39663180
25439,2029,1807400,1,11,1,5,209,39665209
25440,2960,1807400,1,11,1,8,169,39668169
25441,3314,1807400,1,11,1,11,483,39671483
25442,1406,1807400,3,11,1,12,889,39672889
25443,1039,1807400,1,11,1,13,928,39673928
25444,105,1807400,1,11,1,14,33,39674033
25445,250,1807400,9,11,1,14,283,39674283
25446,1713,1807500,1,11,1,15,996,39675996
25447,2133,1807400,1,11,1,18,129,39678129
25448,11238,1807400,1,11,1,29,367,39689367
25449,4129,1807300,3,11,1,33,496,39693496
25450,1406,1807400,1,11,1,34,902,39694902
25451,279,1807400,1,11,1,35,181,39695181
25452,4193,1807400,1,11,1,39,374,39699374
25453,2562,1807400,1,11,1,41,936,39701936
25454,225,1807400,1,11,1,42,161,39702161
25455,8940,1807400,3,11,1,51,101,39711101
25456,1483,1807400,1,11,1,52,584,39712584
25457,2214,1807400,1,11,1,54,798,39714798
25458,4049,1807400,2,11,1,58,847,39718847
25459,260,1807400,2,11,1,59,107,39719107
25460,3650,1807500,3,11,2,2,757,39722757
25461,2,1807500,10,11,2,2,759,39722759
25462,0,1807500,1,11,2,2,759,39722759
25463,0,1807500,8,11,2,2,759,39722759
25464,1,1807500,1,11,2,2,760,39722760
25465,92,1807600,1,11,2,2,852,39722852
25466,0,1807600,2,11,2,2,852,39722852
25467,0,1807600,1,11,2,2,852,39722852
25468,0,1807600,1,11,2,2,852,39722852
25469,0,1807600,1,11,2,2,852,39722852
25470,1,1807600,1,11,2,2,853,39722853
25471,0,1807600,1,11,2,2,853,39722853
25472,1016,1807400,1,11,2,3,869,39723869
25473,106,1807600,1,11,2,3,975,39723975
25474,1,1807700,1,11,2,3,976,39723976
25475,3121,1807400,1,11,2,7,97,39727097
25476,204,1807400,1,11,2,7,301,39727301
25477,514,1807400,1,11,2,7,815,39727815
25478,112,1807400,1,11,2,7,927,39727927
25479,2588,1807600,1,11,2,10,515,39730515
25480,86,1807600,1,11,2,10,601,39730601
25481,0,1807600,1,11,2,10,601,39730601
25482,132,1807500,2,11,2,10,733,39730733
25483,7483,1807500,1,11,2,18,216,39738216
25484,5287,1807600,2,11,2,23,503,39743503
25485,98,1807600,1,11,2,23,601,39743601
25486,0,1807600,1,11,2,23,601,39743601
25487,0,1807600,1,11,2,23,601,39743601
25488,1,1807700,1,11,2,23,602,39743602
25489,1328,1807500,1,11,2,24,930,39744930
25490,1856,1807500,1,11,2,26,786,39746786
25491,2262,1807500,1,11,2,29,48,39749048
25492,200,1807500,1,11,2,29,248,39749248
25493,232,1807500,1,11,2,29,480,39749480
25494,192,1807500,1,11,2,29,672,39749672
25495,208,1807500,1,11,2,29,880,39749880
25496,343,1807500,1,11,2,30,223,39750223
25497,1025,1807500,1,11,2,31,248,39751248
25498,3398,1807500,1,11,2,34,646,39754646
25499,4507,1807500,1,11,2,39,153,39759153
25501,1044,1807500,1,11,2,40,197,39760197
25502,0,1807500,1,11,2,40,197,39760197
25503,10687,1807400,2,11,2,50,884,39770884
25504,7757,1807500,1,11,2,58,641,39778641
25505,2301,1807600,5,11,3,0,942,39780942
25506,1,1807600,1,11,3,0,943,39780943
25507,0,1807600,2,11,3,0,943,39780943
25508,0,1807600,1,11,3,0,943,39780943
25510,264,1807700,1,11,3,1,207,39781207
25511,210,1807600,4,11,3,1,417,39781417
25512,1772,1807700,1,11,3,3,189,39783189
25513,662,1807600,1,11,3,3,851,39783851
25514,306,1807700,1,11,3,4,157,39784157
25515,1,1807800,9,11,3,4,158,39784158
25516,6090,1807900,2,11,3,10,248,39790248
25517,110,1807800,1,11,3,10,358,39790358
25518,192,1807800,1,11,3,10,550,39790550
25519,452,1807800,1,11,3,11,2,39791002
25520,174,1807800,1,11,3,11,176,39791176
25521,550,1807800,1,11,3,11,726,39791726
25522,274,1807800,1,11,3,12,0,39792000
25523,0,1807900,13,11,3,12,0,39792000
25524,176,1807800,1,11,3,12,176,39792176
25525,62,1807800,1,11,3,12,238,39792238
25526,1607,1807700,1,11,3,13,845,39793845
25527,447,1807800,1,11,3,14,292,39794292
25528,0,1807900,10,11,3,14,292,39794292
25529,624,1807800,4,11,3,14,916,39794916
25530,1662,1807900,1,11,3,16,578,39796578
25531,528,1807900,1,11,3,17,106,39797106
25532,754,1807800,1,11,3,17,860,39797860
25533,40,1807900,1,11,3,17,900,39797900
25534,180,1807900,1,11,3,18,80,39798080
25535,331,1807900,1,11,3,18,411,39798411
25536,1,1808000,11,11,3,18,412,39798412
25537,128,1808000,1,11,3,18,540,39798540
25538,1151,1808000,2,11,3,19,691,39799691
25539,151,1807800,4,11,3,19,842,39799842
25540,39,1807900,1,11,3,19,881,39799881
25541,384,1808000,1,11,3,20,265,39800265
25542,122,1808000,2,11,3,20,387,39800387
25543,1060,1807900,1,11,3,21,447,39801447
25544,366,1807800,1,11,3,21,813,39801813
25545,1099,1807800,1,11,3,22,912,39802912
25546,320,1807700,1,11,3,23,232,39803232
25547,433,1807900,6,11,3,23,665,39803665
25548,1839,1807900,4,11,3,25,504,39805504
25549,1397,1807900,1,11,3,26,901,39806901
25550,56,1807900,1,11,3,26,957,39806957
25551,2409,1807900,4,11,3,29,366,39809366
25552,302,1807800,1,11,3,29,668,39809668
25553,57,1807800,1,11,3,29,725,39809725
25554,1760,1807900,4,11,3,31,485,39811485
25555,589,1807700,2,11,3,32,74,39812074
25556,737,1807900,2,11,3,32,811,39812811
25557,606,1807900,3,11,3,33,417,39813417
25558,3976,1807800,2,11,3,37,393,39817393
25559,1933,1807800,1,11,3,39,326,39819326
25560,548,1807800,1,11,3,39,874,39819874
25561,1434,1807800,1,11,3,41,308,39821308
25562,548,1807800,1,11,3,41,856,39821856
25563,1271,1807800,1,11,3,43,127,39823127
25564,3164,1807800,1,11,3,46,291,39826291
25565,267,1807800,1,11,3,46,558,39826558
25566,375,1807800,1,11,3,46,933,39826933
25567,74,1807800,1,11,3,47,7,39827007
25568,3726,1807800,1,11,3,50,733,39830733
25569,125,1807800,1,11,3,50,858,39830858
25570,1287,1807900,1,11,3,52,145,39832145
25571,2693,1807800,1,11,3,54,838,39834838
25572,10581,1807800,1,11,4,5,419,39845419
25573,747,1807900,1,11,4,6,166,39846166
25574,2597,1807700,2,11,4,8,763,39848763
25575,243,1807900,4,11,4,9,6,39849006
25576,208,1807900,1,11,4,9,214,39849214
25577,1901,1807900,1,11,4,11,115,39851115
25578,1048,1808000,2,11,4,12,163,39852163
25579,656,1808000,1,11,4,12,819,39852819
25580,937,1807800,1,11,4,13,756,39853756
25581,2001,1807900,1,11,4,15,757,39855757
25582,2491,1807900,1,11,4,18,248,39858248
25583,228,1807900,5,11,4,18,476,39858476
25584,75,1807900,1,11,4,18,551,39858551
25585,353,1807900,1,11,4,18,904,39858904
25586,520,1807900,1,11,4,19,424,39859424
25587,1647,1807800,16,11,4,21,71,39861071
25588,3,1807700,1,11,4,21,74,39861074
25589,0,1807700,1,11,4,21,74,39861074
25590,0,1807700,4,11,4,21,74,39861074
25591,0,1807700,10,11,4,21,74,39861074
25592,0,1807700,2,11,4,21,74,39861074
25593,34,1807600,5,11,4,21,108,39861108
25594,2,1807600,3,11,4,21,110,39861110
25595,40,1807500,5,11,4,21,150,39861150
25596,74,1807600,1,11,4,21,224,39861224
25597,486,1807600,1,11,4,21,710,39861710
25598,2275,1807500,19,11,4,23,985,39863985
25599,1,1807500,1,11,4,23,986,39863986
25600,199,1807500,1,11,4,24,185,39864185
25601,2202,1807400,1,11,4,26,387,39866387
25602,93,1807600,2,11,4,26,480,39866480
25603,143,1807600,1,11,4,26,623,39866623
25604,907,1807500,1,11,4,27,530,39867530
25605,339,1807600,1,11,4,27,869,39867869
25606,2927,1807500,2,11,4,30,796,39870796
25607,1816,1807600,1,11,4,32,612,39872612
25608,3030,1807600,1,11,4,35,642,39875642
25609,0,1807600,1,11,4,35,642,39875642
25610,5923,1807500,2,11,4,41,565,39881565
25611,3349,1807500,1,11,4,44,914,39884914
25612,1377,1807500,2,11,4,46,291,39886291
25613,6193,1807400,1,11,4,52,484,39892484
25614,2088,1807500,5,11,4,54,572,39894572
25615,0,1807500,1,11,4,54,572,39894572
25616,2,1807600,3,11,4,54,574,39894574
25617,0,1807600,1,11,4,54,574,39894574
25618,0,1807600,4,11,4,54,574,39894574
25619,306,1807700,1,11,4,54,880,39894880
25620,710,1807600,1,11,4,55,590,39895590
25621,356,1807600,1,11,4,55,946,39895946
25622,394,1807700,1,11,4,56,340,39896340
25623,8395,1807600,1,11,5,4,735,39904735
25624,434,1807700,1,11,5,5,169,39905169
25625,103,1807700,1,11,5,5,272,39905272
25626,639,1807600,1,11,5,5,911,39905911
25627,403,1807700,4,11,5,6,314,39906314
25628,860,1807800,5,11,5,7,174,39907174
25629,363,1807600,1,11,5,7,537,39907537
25630,145,1807600,1,11,5,7,682,39907682
25631,223,1807800,1,11,5,7,905,39907905
25632,212,1807700,1,11,5,8,117,39908117
25633,161,1807800,2,11,5,8,278,39908278
25634,2,1807800,1,11,5,8,280,39908280
25635,5517,1807600,1,11,5,13,797,39913797
25636,2015,1807600,1,11,5,15,812,39915812
25637,9845,1807500,1,11,5,25,657,39925657
25638,7,1807500,1,11,5,25,664,39925664
25639,21,1807500,2,11,5,25,685,39925685
25640,1586,1807500,1,11,5,27,271,39927271
25641,1974,1807600,1,11,5,29,245,39929245
25642,0,1807600,1,11,5,29,245,39929245
25643,369,1807600,1,11,5,29,614,39929614
25644,1266,1807700,1,11,5,30,880,39930880
25645,75,1807700,1,11,5,30,955,39930955
25646,7995,1807700,1,11,5,38,950,39938950
25647,1658,1807800,2,11,5,40,608,39940608
25648,4249,1807800,2,11,5,44,857,39944857
25649,64,1807800,1,11,5,44,921,39944921
25650,1056,1807700,2,11,5,45,977,39945977
25651,2319,1807700,1,11,5,48,296,39948296
25652,5784,1807700,1,11,5,54,80,39954080
25653,937,1807700,1,11,5,55,17,39955017
25654,2189,1807800,1,11,5,57,206,39957206
25655,1116,1807700,1,11,5,58,322,39958322
25656,2460,1807700,1,11,6,0,782,39960782
25657,169,1807700,1,11,6,0,951,39960951
25658,183,1807700,1,11,6,1,134,39961134
25659,5543,1807800,2,11,6,6,677,39966677
25661,2222,1807800,1,11,6,8,899,39968899
25663,484,1807900,1,11,6,9,383,39969383
25664,4200,1807700,1,11,6,13,583,39973583
25665,7653,1807700,1,11,6,21,236,39981236
25666,211,1807800,1,11,6,21,447,39981447
25667,1171,1807800,2,11,6,22,618,39982618
25668,1666,1807800,1,11,6,24,284,39984284
25669,1791,1807700,1,11,6,26,75,39986075
25670,3525,1807700,1,11,6,29,600,39989600
25671,6049,1807700,2,11,6,35,649,39995649
25672,1641,1807700,1,11,6,37,290,39997290
25673,0,1807700,2,11,6,37,290,39997290
25674,7985,1807700,2,11,6,45,275,40005275
25675,2280,1807700,1,11,6,47,555,40007555
25676,1,1807700,1,11,6,47,556,40007556
25677,0,1807700,3,11,6,47,556,40007556
25678,208,1807700,1,11,6,47,764,40007764
25679,0,1807800,9,11,6,47,764,40007764
25680,1217,1807800,1,11,6,48,981,40008981
25681,3238,1807800,1,11,6,52,219,40012219
25682,216,1807800,1,11,6,52,435,40012435
25683,2,1807800,1,11,6,52,437,40012437
25684,4284,1807800,1,11,6,56,721,40016721
25685,565,1807800,1,11,6,57,286,40017286
25686,2765,1807700,1,11,7,0,51,40020051
25687,3157,1807800,1,11,7,3,208,40023208
25688,3074,1807800,2,11,7,6,282,40026282
25689,2,1807800,5,11,7,6,284,40026284
25690,213,1807800,1,11,7,6,497,40026497
25691,3344,1807800,1,11,7,9,841,40029841
25692,1,1807800,1,11,7,9,842,40029842
25693,0,1807800,1,11,7,9,842,40029842
25694,679,1807800,1,11,7,10,521,40030521
25695,2980,1807800,1,11,7,13,501,40033501
25696,3213,1807700,2,11,7,16,714,40036714
25697,6393,1807700,1,11,7,23,107,40043107
25698,7894,1807700,1,11,7,31,1,40051001
25699,2499,1807700,1,11,7,33,500,40053500
25700,1761,1807700,1,11,7,35,261,40055261
25701,1822,1807700,2,11,7,37,83,40057083
25702,2458,1807700,1,11,7,39,541,40059541
25703,657,1807700,1,11,7,40,198,40060198
25704,1477,1807600,9,11,7,41,675,40061675
25705,9351,1807600,3,11,7,51,26,40071026
25707,1342,1807700,1,11,7,52,368,40072368
25708,2896,1807600,2,11,7,55,264,40075264
25709,2326,1807600,1,11,7,57,590,40077590
25710,74,1807600,1,11,7,57,664,40077664
25711,1760,1807700,2,11,7,59,424,40079424
25712,1688,1807600,6,11,8,1,112,40081112
25713,1387,1807700,5,11,8,2,499,40082499
25714,399,1807600,1,11,8,2,898,40082898
25715,427,1807600,3,11,8,3,325,40083325
25716,2,1807600,1,11,8,3,327,40083327
25717,3499,1807700,1,11,8,6,826,40086826
25718,4523,1807700,1,11,8,11,349,40091349
25719,2061,1807600,1,11,8,13,410,40093410
25720,3505,1807700,1,11,8,16,915,40096915
25721,3506,1807600,1,11,8,20,421,40100421
25722,2651,1807600,1,11,8,23,72,40103072
25723,5715,1807600,5,11,8,28,787,40108787
25724,1,1807600,3,11,8,28,788,40108788
25725,4216,1807600,1,11,8,33,4,40113004
25726,992,1807700,3,11,8,33,996,40113996
25727,1692,1807600,1,11,8,35,688,40115688
25728,3075,1807600,2,11,8,38,763,40118763
25729,3017,1807600,1,11,8,41,780,40121780
25730,1127,1807600,2,11,8,42,907,40122907
25731,3698,1807600,1,11,8,46,605,40126605
25732,1,1807600,1,11,8,46,606,40126606
25733,74,1807600,3,11,8,46,680,40126680
25734,3030,1807600,2,11,8,49,710,40129710
25735,7180,1807600,1,11,8,56,890,40136890
25736,272,1807600,1,11,8,57,162,40137162
25737,1719,1807600,2,11,8,58,881,40138881
25738,1615,1807600,5,11,9,0,496,40140496
25739,692,1807500,95,11,9,1,188,40141188
25740,0,1807500,3,11,9,1,188,40141188
25741,0,1807500,16,11,9,1,188,40141188
25742,1,1807500,16,11,9,1,189,40141189
25743,0,1807500,1,11,9,1,189,40141189
25744,0,1807500,1,11,9,1,189,40141189
25745,0,1807500,52,11,9,1,189,40141189
25746,2,1807500,7,11,9,1,191,40141191
25747,0,1807400,5,11,9,1,191,40141191
25748,0,1807500,2,11,9,1,191,40141191
25749,0,1807500,1,11,9,1,191,40141191
25750,43,1807400,1,11,9,1,234,40141234
25751,7,1807400,1,11,9,1,241,40141241
25752,32,1807400,1,11,9,1,273,40141273
25753,128,1807400,1,11,9,1,401,40141401
25754,2,1807400,1,11,9,1,403,40141403
25755,45,1807400,1,11,9,1,448,40141448
25756,1773,1807400,2,11,9,3,221,40143221
25757,2199,1807400,1,11,9,5,420,40145420
25758,1644,1807500,23,11,9,7,64,40147064
25760,2,1807600,18,11,9,7,66,40147066
25761,64,1807500,1,11,9,7,130,40147130
25762,2938,1807500,1,11,9,10,68,40150068
25763,28,1807600,3,11,9,10,96,40150096
25764,385,1807500,1,11,9,10,481,40150481
25765,2599,1807500,1,11,9,13,80,40153080
25766,252,1807500,1,11,9,13,332,40153332
25767,784,1807600,1,11,9,14,116,40154116
25768,0,1807600,3,11,9,14,116,40154116
25769,1,1807600,1,11,9,14,117,40154117
25770,1154,1807700,2,11,9,15,271,40155271
25771,0,1807700,5,11,9,15,271,40155271
25772,0,1807700,2,11,9,15,271,40155271
25773,0,1807700,1,11,9,15,271,40155271
25774,3005,1807700,1,11,9,18,276,40158276
25775,1583,1807800,2,11,9,19,859,40159859
25776,0,1807800,7,11,9,19,859,40159859
25777,0,1807800,3,11,9,19,859,40159859
25778,0,1807800,1,11,9,19,859,40159859
25779,1,1807800,1,11,9,19,860,40159860
25780,0,1807800,10,11,9,19,860,40159860
25781,221,1807800,1,11,9,20,81,40160081
25782,2944,1807900,1,11,9,23,25,40163025
25783,1054,1807900,1,11,9,24,79,40164079
25784,2361,1807800,8,11,9,26,440,40166440
25785,2,1807800,1,11,9,26,442,40166442
25786,1280,1807800,1,11,9,27,722,40167722
25787,3415,1807900,2,11,9,31,137,40171137
25788,1803,1807800,1,11,9,32,940,40172940
25789,3603,1807800,1,11,9,36,543,40176543
25790,2007,1807800,2,11,9,38,550,40178550
25791,5146,1807900,2,11,9,43,696,40183696
25792,5082,1807900,3,11,9,48,778,40188778
25793,10353,1807800,6,11,9,59,131,40199131
25795,211,1807700,1,11,9,59,342,40199342
25796,185,1807600,1,11,9,59,527,40199527
25797,290,1807700,1,11,9,59,817,40199817
25798,1464,1807700,1,11,10,1,281,40201281
25799,79,1807700,3,11,10,1,360,40201360
25800,0,1807700,1,11,10,1,360,40201360
25801,0,1807700,1,11,10,1,360,40201360
25802,0,1807700,1,11,10,1,360,40201360
25803,0,1807700,1,11,10,1,360,40201360
25804,1,1807700,2,11,10,1,361,40201361
25805,0,1807700,1,11,10,1,361,40201361
25806,280,1807700,1,11,10,1,641,40201641
25807,2974,1807700,6,11,10,4,615,40204615
25808,2661,1807800,1,11,10,7,276,40207276
25809,1815,1807900,1,11,10,9,91,40209091
25810,1173,1807900,1,11,10,10,264,40210264
25811,214,1808000,1,11,10,10,478,40210478
25812,514,1808000,1,11,10,10,992,40210992
25813,457,1807800,1,11,10,11,449,40211449
25814,1067,1807900,5,11,10,12,516,40212516
25815,719,1807800,1,11,10,13,235,40213235
25816,6730,1807800,1,11,10,19,965,40219965
25817,5057,1807800,1,11,10,25,22,40225022
25818,5397,1807900,1,11,10,30,419,40230419
25819,2723,1807900,1,11,10,33,142,40233142
25820,4167,1807900,2,11,10,37,309,40237309
25821,12447,1808000,5,11,10,49,756,40249756
25822,6678,1808000,1,11,10,56,434,40256434
25823,133,1808000,1,11,10,56,567,40256567
25824,0,1808000,3,11,10,56,567,40256567
25825,1,1808000,14,11,10,56,568,40256568
25826,944,1808100,1,11,10,57,512,40257512
25827,837,1808100,1,11,10,58,349,40258349
25828,517,1808100,3,11,10,58,866,40258866
25829,1,1808100,5,11,10,58,867,40258867
25830,0,1808100,2,11,10,58,867,40258867
25831,0,1808100,1,11,10,58,867,40258867
25832,2093,1808200,1,11,11,0,960,40260960
25833,57,1808200,2,11,11,1,17,40261017
25834,138,1808100,1,11,11,1,155,40261155
25835,59,1808200,1,11,11,1,214,40261214
25836,193,1808100,1,11,11,1,407,40261407
25837,480,1808100,16,11,11,1,887,40261887
25839,1,1808000,5,11,11,1,888,40261888
25840,2,1808000,1,11,11,1,890,40261890
25841,113,1808100,5,11,11,2,3,40262003
25842,197,1808100,1,11,11,2,200,40262200
25843,525,1808100,1,11,11,2,725,40262725
25844,705,1808100,2,11,11,3,430,40263430
25845,2732,1808000,1,11,11,6,162,40266162
25846,734,1808000,2,11,11,6,896,40266896
25847,25,1808100,1,11,11,6,921,40266921
25848,3015,1808100,1,11,11,9,936,40269936
25849,768,1808100,1,11,11,10,704,40270704
25850,2297,1808100,1,11,11,13,1,40273001
25851,158,1808000,1,11,11,13,159,40273159
25852,552,1808200,1,11,11,13,711,40273711
25853,304,1808100,1,11,11,14,15,40274015
25854,1828,1808100,1,11,11,15,843,40275843
25855,4,1808100,1,11,11,15,847,40275847
25856,447,1808000,5,11,11,16,294,40276294
25857,3,1807900,2,11,11,16,297,40276297
25858,71,1807800,2,11,11,16,368,40276368
25859,353,1807900,1,11,11,16,721,40276721
25860,337,1807900,1,11,11,17,58,40277058
25862,2259,1808000,4,11,11,19,317,40279317
25863,5596,1807900,1,11,11,24,913,40284913
25864,1,1807900,3,11,11,24,914,40284914
25865,1,1807800,1,11,11,24,915,40284915
25866,0,1807800,1,11,11,24,915,40284915
25867,0,1807800,1,11,11,24,915,40284915
25868,0,1807800,1,11,11,24,915,40284915
25869,87,1807800,2,11,11,25,2,40285002
25870,2054,1807800,3,11,11,27,56,40287056
25871,1,1807800,1,11,11,27,57,40287057
25872,189,1807700,1,11,11,27,246,40287246
25873,247,1807800,1,11,11,27,493,40287493
25874,631,1807800,1,11,11,28,124,40288124
25875,848,1807800,2,11,11,28,972,40288972
25876,147,1807800,1,11,11,29,119,40289119
25877,2001,1807800,1,11,11,31,120,40291120
25878,3446,1807800,1,11,11,34,566,40294566
25879,1995,1807700,6,11,11,36,561,40296561
25880,2,1807600,7,11,11,36,563,40296563
25881,242,1807600,1,11,11,36,805,40296805
25882,544,1807700,1,11,11,37,349,40297349
25883,4379,1807500,5,11,11,41,728,40301728
25884,61,1807600,1,11,11,41,789,40301789
25885,7185,1807600,1,11,11,48,974,40308974
25886,1438,1807600,1,11,11,50,412,40310412
25887,11766,1807600,1,11,12,2,178,40322178
25888,246,1807600,1,11,12,2,424,40322424
25889,34,1807600,1,11,12,2,458,40322458
25890,364,1807500,1,11,12,2,822,40322822
25891,1806,1807600,3,11,12,4,628,40324628
25892,1561,1807600,2,11,12,6,189,40326189
25893,1,1807600,1,11,12,6,190,40326190
25894,3857,1807500,1,11,12,10,47,40330047
25895,4038,1807500,1,11,12,14,85,40334085
25896,0,1807500,5,11,12,14,85,40334085
25897,441,1807500,1,11,12,14,526,40334526
25898,3696,1807500,1,11,12,18,222,40338222
25899,43,1807500,1,11,12,18,265,40338265
25901,4906,1807400,1,11,12,23,171,40343171
25902,37,1807400,1,11,12,23,208,40343208
25903,1457,1807400,5,11,12,24,665,40344665
25904,318,1807400,1,11,12,24,983,40344983
25905,427,1807400,1,11,12,25,410,40345410
25906,97,1807400,2,11,12,25,507,40345507
25907,1109,1807500,1,11,12,26,616,40346616
25908,1217,1807500,1,11,12,27,833,40347833
25909,1117,1807400,1,11,12,28,950,40348950
25910,5026,1807400,4,11,12,33,976,40353976
25911,4215,1807300,6,11,12,38,191,40358191
25912,56,1807300,1,11,12,38,247,40358247
25913,49,1807300,1,11,12,38,296,40358296
25914,946,1807400,1,11,12,39,242,40359242
25915,136,1807300,1,11,12,39,378,40359378
25916,148,1807300,1,11,12,39,526,40359526
25917,186,1807300,1,11,12,39,712,40359712
25918,200,1807300,1,11,12,39,912,40359912
25919,4801,1807300,1,11,12,44,713,40364713
25920,486,1807300,1,11,12,45,199,40365199
25921,3424,1807300,1,11,12,48,623,40368623
25922,3578,1807300,1,11,12,52,201,40372201
25923,195,1807300,1,11,12,52,396,40372396
25924,1611,1807400,2,11,12,54,7,40374007
25925,1204,1807200,4,11,12,55,211,40375211
25926,149,1807200,1,11,12,55,360,40375360
25927,200,1807200,1,11,12,55,560,40375560
25928,5161,1807300,1,11,13,0,721,40380721
25929,956,1807300,1,11,13,1,677,40381677
25930,57,1807200,1,11,13,1,734,40381734
25931,212,1807300,1,11,13,1,946,40381946
25932,387,1807200,1,11,13,2,333,40382333
25933,1676,1807300,1,11,13,4,9,40384009
25934,183,1807300,1,11,13,4,192,40384192
25935,1332,1807300,1,11,13,5,524,40385524
25936,5483,1807400,5,11,13,11,7,40391007
25937,3620,1807300,2,11,13,14,627,40394627
25938,552,1807300,4,11,13,15,179,40395179
25939,3202,1807400,1,11,13,18,381,40398381
25940,1993,1807300,1,11,13,20,374,40400374
25941,2370,1807200,2,11,13,22,744,40402744
25942,757,1807200,2,11,13,23,501,40403501
25943,0,1807200,1,11,13,23,501,40403501
25944,1,1807200,12,11,13,23,502,40403502
25945,131,1807200,1,11,13,23,633,40403633
25946,390,1807200,1,11,13,24,23,40404023
25947,1423,1807100,2,11,13,25,446,40405446
25948,620,1807200,1,11,13,26,66,40406066
25949,74,1807200,1,11,13,26,140,40406140
25950,42,1807300,1,11,13,26,182,40406182
25951,229,1807200,1,11,13,26,411,40406411
25952,919,1807200,1,11,13,27,330,40407330
25953,1028,1807100,2,11,13,28,358,40408358
25954,1808,1807100,1,11,13,30,166,40410166
25955,1474,1807100,1,11,13,31,640,40411640
25956,2384,1807200,4,11,13,34,24,40414024
25957,143,1807200,1,11,13,34,167,40414167
25958,930,1807200,1,11,13,35,97,40415097
25959,1824,1807300,1,11,13,36,921,40416921
25960,1944,1807200,3,11,13,38,865,40418865
25961,4138,1807200,1,11,13,43,3,40423003
25962,2392,1807200,1,11,13,45,395,40425395
25963,2196,1807200,1,11,13,47,591,40427591
25964,3150,1807200,2,11,13,50,741,40430741
25965,584,1807100,1,11,13,51,325,40431325
25966,366,1807100,1,11,13,51,691,40431691
25967,1416,1807100,10,11,13,53,107,40433107
25968,4205,1807100,1,11,13,57,312,40437312
25969,178,1807200,1,11,13,57,490,40437490
25970,2510,1807200,1,11,14,0,0,40440000
25971,0,1807200,6,11,14,0,0,40440000
25972,220,1807200,1,11,14,0,220,40440220
25973,96,1807300,3,11,14,0,316,40440316
25974,78,1807300,1,11,14,0,394,40440394
25975,1588,1807200,2,11,14,1,982,40441982
25976,295,1807300,1,11,14,2,277,40442277
25977,692,1807200,1,11,14,2,969,40442969
25978,1580,1807200,2,11,14,4,549,40444549
25979,2628,1807200,1,11,14,7,177,40447177
25980,207,1807300,1,11,14,7,384,40447384
25981,451,1807300,1,11,14,7,835,40447835
25982,376,1807300,1,11,14,8,211,40448211
25983,2064,1807300,1,11,14,10,275,40450275
25984,505,1807300,1,11,14,10,780,40450780
25985,187,1807300,1,11,14,10,967,40450967
25986,2035,1807300,1,11,14,13,2,40453002
25987,27,1807300,1,11,14,13,29,40453029
25988,2298,1807300,5,11,14,15,327,40455327
25989,3989,1807400,2,11,14,19,316,40459316
25990,2227,1807400,1,11,14,21,543,40461543
25991,3097,1807300,1,11,14,24,640,40464640
25992,197,1807400,1,11,14,24,837,40464837
25993,877,1807400,1,11,14,25,714,40465714
25994,64,1807400,2,11,14,25,778,40465778
25995,1662,1807400,1,11,14,27,440,40467440
25996,4766,1807400,1,11,14,32,206,40472206
25997,9126,1807400,1,11,14,41,332,40481332
25998,7069,1807400,1,11,14,48,401,40488401
25999,599,1807500,12,11,14,49,0,40489000
26000,1513,1807500,4,11,14,50,513,40490513
26001,345,1807600,1,11,14,50,858,40490858
26002,645,1807600,1,11,14,51,503,40491503
26003,2738,1807500,1,11,14,54,241,40494241
26004,2470,1807500,1,11,14,56,711,40496711
26005,2335,1807400,2,11,14,59,46,40499046
26006,1625,1807500,1,11,15,0,671,40500671
26007,193,1807400,1,11,15,0,864,40500864
26009,175,1807500,2,11,15,1,39,40501039
26010,235,1807500,1,11,15,1,274,40501274
26011,133,1807300,5,11,15,1,407,40501407
26012,182,1807400,2,11,15,1,589,40501589
26013,6,1807500,2,11,15,1,595,40501595
26014,1,1807500,2,11,15,1,596,40501596
26015,18,1807500,1,11,15,1,614,40501614
26017,360,1807500,1,11,15,1,974,40501974
26019,3,1807600,4,11,15,1,977,40501977
26020,28,1807600,2,11,15,2,5,40502005
26021,14605,1807500,2,11,15,16,610,40516610
26022,169,1807400,1,11,15,16,779,40516779
26023,1,1807400,1,11,15,16,780,40516780
26024,47,1807500,1,11,15,16,827,40516827
26025,1948,1807300,2,11,15,18,775,40518775
26026,8360,1807500,1,11,15,27,135,40527135
26027,1568,1807500,1,11,15,28,703,40528703
26028,1950,1807500,1,11,15,30,653,40530653
26029,5238,1807500,1,11,15,35,891,40535891
26030,593,1807500,1,11,15,36,484,40536484
26031,486,1807500,2,11,15,36,970,40536970
26032,3123,1807500,2,11,15,40,93,40540093
26033,832,1807500,1,11,15,40,925,40540925
26034,4146,1807600,10,11,15,45,71,40545071
26035,0,1807600,1,11,15,45,71,40545071
26036,0,1807600,5,11,15,45,71,40545071
26037,75,1807600,3,11,15,45,146,40545146
26039,875,1807700,3,11,15,46,21,40546021
26040,0,1807700,6,11,15,46,21,40546021
26041,237,1807700,1,11,15,46,258,40546258
26042,2289,1807600,4,11,15,48,547,40548547
26043,2966,1807800,1,11,15,51,513,40551513
26044,1691,1807700,1,11,15,53,204,40553204
26045,3636,1807800,1,11,15,56,840,40556840
26046,541,1807800,1,11,15,57,381,40557381
26047,571,1807800,1,11,15,57,952,40557952
26048,36,1807700,1,11,15,57,988,40557988
26049,796,1807700,1,11,15,58,784,40558784
26050,0,1807700,2,11,15,58,784,40558784
26051,7101,1807600,2,11,16,5,885,40565885
26052,196,1807500,3,11,16,6,81,40566081
26053,1,1807500,1,11,16,6,82,40566082
26054,0,1807500,1,11,16,6,82,40566082
26055,275,1807500,1,11,16,6,357,40566357
26056,62,1807500,1,11,16,6,419,40566419
26057,13,1807600,1,11,16,6,432,40566432
26058,120,1807600,1,11,16,6,552,40566552
26059,724,1807600,1,11,16,7,276,40567276
26060,195,1807700,1,11,16,7,471,40567471
26061,5251,1807600,1,11,16,12,722,40572722
26062,925,1807600,5,11,16,13,647,40573647
26064,7807,1807600,1,11,16,21,454,40581454
26065,1438,1807600,1,11,16,22,892,40582892
26066,2029,1807600,2,11,16,24,921,40584921
26067,769,1807700,3,11,16,25,690,40585690
26068,1698,1807600,3,11,16,27,388,40587388
26069,2476,1807500,3,11,16,29,864,40589864
26070,41,1807400,3,11,16,29,905,40589905
26071,0,1807400,3,11,16,29,905,40589905
26072,367,1807300,2,11,16,30,272,40590272
26073,234,1807300,1,11,16,30,506,40590506
26074,2686,1807300,1,11,16,33,192,40593192
26075,4437,1807400,1,11,16,37,629,40597629
26076,0,1807400,2,11,16,37,629,40597629
26077,311,1807400,3,11,16,37,940,40597940
26078,993,1807400,1,11,16,38,933,40598933
26080,2149,1807500,1,11,16,41,82,40601082
26081,22577,1807400,1,11,17,3,659,40623659
26082,47,1807500,2,11,17,3,706,40623706
26083,2112,1807400,2,11,17,5,818,40625818
26084,3442,1807400,3,11,17,9,260,40629260
26085,9819,1807300,1,11,17,19,79,40639079
26086,4715,1807400,1,11,17,23,794,40643794
26087,4970,1807300,1,11,17,28,764,40648764
26088,3451,1807300,2,11,17,32,215,40652215
26089,1372,1807300,2,11,17,33,587,40653587
26090,2353,1807300,5,11,17,35,940,40655940
26091,2739,1807300,3,11,17,38,679,40658679
26092,192,1807300,1,11,17,38,871,40658871
26093,1851,1807300,1,11,17,40,722,40660722
26094,9,1807300,1,11,17,40,731,40660731
26095,75,1807300,1,11,17,40,806,40660806
26096,2999,1807300,1,11,17,43,805,40663805
26097,65,1807200,1,11,17,43,870,40663870
26098,553,1807300,1,11,17,44,423,40664423
26099,2591,1807300,1,11,17,47,14,40667014
26100,73,1807300,1,11,17,47,87,40667087
26101,2122,1807300,1,11,17,49,209,40669209
26102,2428,1807300,1,11,17,51,637,40671637
26103,765,1807300,1,11,17,52,402,40672402
26104,460,1807300,4,11,17,52,862,40672862
26105,1,1807300,1,11,17,52,863,40672863
26106,1296,1807300,1,11,17,54,159,40674159
26107,1310,1807300,1,11,17,55,469,40675469
26108,3019,1807300,1,11,17,58,488,40678488
26109,396,1807300,1,11,17,58,884,40678884
26110,563,1807300,1,11,17,59,447,40679447
26111,3306,1807400,1,11,18,2,753,40682753
26112,7905,1807400,1,11,18,10,658,40690658
26113,2,1807400,1,11,18,10,660,40690660
26114,0,1807400,8,11,18,10,660,40690660
26115,0,1807400,1,11,18,10,660,40690660
26116,1,1807400,1,11,18,10,661,40690661
26117,0,1807400,5,11,18,10,661,40690661
26118,2542,1807500,1,11,18,13,203,40693203
26119,2665,1807400,2,11,18,15,868,40695868
26120,154,1807500,7,11,18,16,22,40696022
26121,3,1807500,2,11,18,16,25,40696025
26122,0,1807500,1,11,18,16,25,40696025
26123,0,1807500,1,11,18,16,25,40696025
26124,1,1807500,1,11,18,16,26,40696026
26125,0,1807500,1,11,18,16,26,40696026
26126,1647,1807400,2,11,18,17,673,40697673
26127,53,1807400,1,11,18,17,726,40697726
26128,1,1807300,1,11,18,17,727,40697727
26129,354,1807300,2,11,18,18,81,40698081
26130,0,1807300,1,11,18,18,81,40698081
26131,7311,1807300,1,11,18,25,392,40705392
26132,3438,1807300,1,11,18,28,830,40708830
26133,3402,1807400,1,11,18,32,232,40712232
26134,119,1807300,1,11,18,32,351,40712351
26135,0,1807300,1,11,18,32,351,40712351
26136,0,1807300,1,11,18,32,351,40712351
26137,0,1807300,1,11,18,32,351,40712351
26138,2910,1807400,1,11,18,35,261,40715261
26139,960,1807300,1,11,18,36,221,40716221
26140,1056,1807300,1,11,18,37,277,40717277
26141,73,1807300,1,11,18,37,350,40717350
26142,1,1807300,1,11,18,37,351,40717351
26143,3834,1807400,2,11,18,41,185,40721185
26144,1615,1807300,1,11,18,42,800,40722800
26145,4072,1807300,2,11,18,46,872,40726872
26146,3639,1807300,1,11,18,50,511,40730511
26147,2079,1807300,1,11,18,52,590,40732590
26148,6617,1807400,1,11,18,59,207,40739207
26149,942,1807300,4,11,19,0,149,40740149
26150,2,1807300,6,11,19,0,151,40740151
26151,1801,1807200,1,11,19,1,952,40741952
26152,0,1807200,17,11,19,1,952,40741952
26153,48,1807100,1,11,19,2,0,40742000
26154,152,1807100,1,11,19,2,152,40742152
26155,93,1807100,1,11,19,2,245,40742245
26156,11,1807100,1,11,19,2,256,40742256
26157,280,1807100,1,11,19,2,536,40742536
26158,77,1807100,1,11,19,2,613,40742613
26159,88,1807100,10,11,19,2,701,40742701
26160,939,1807000,5,11,19,3,640,40743640
26161,184,1807000,1,11,19,3,824,40743824
26162,686,1807000,2,11,19,4,510,40744510
26163,34,1807000,1,11,19,4,544,40744544
26164,191,1807000,2,11,19,4,735,40744735
26165,60,1807000,1,11,19,4,795,40744795
26166,2721,1807000,1,11,19,7,516,40747516
26167,1855,1807100,2,11,19,9,371,40749371
26168,1772,1807000,1,11,19,11,143,40751143
26169,123,1807100,1,11,19,11,266,40751266
26170,885,1807000,4,11,19,12,151,40752151
26171,2934,1807000,2,11,19,15,85,40755085
26172,2198,1807000,1,11,19,17,283,40757283
26173,923,1807000,1,11,19,18,206,40758206
26174,70,1807000,1,11,19,18,276,40758276
26175,3952,1807100,2,11,19,22,228,40762228
26176,75,1807100,1,11,19,22,303,40762303
26177,2838,1807100,1,11,19,25,141,40765141
26178,411,1807100,2,11,19,25,552,40765552
26179,1327,1807100,1,11,19,26,879,40766879
26180,2553,1807100,1,11,19,29,432,40769432
26181,1149,1807100,2,11,19,30,581,40770581
26182,3932,1807100,1,11,19,34,513,40774513
26183,2221,1807100,1,11,19,36,734,40776734
26184,2726,1807100,1,11,19,39,460,40779460
26185,133,1807100,1,11,19,39,593,40779593
26186,1154,1807100,1,11,19,40,747,40780747
26187,8872,1807200,1,11,19,49,619,40789619
26188,357,1807100,1,11,19,49,976,40789976
26189,4581,1807100,1,11,19,54,557,40794557
26190,276,1807200,1,11,19,54,833,40794833
26191,1449,1807200,1,11,19,56,282,40796282
26192,80,1807100,1,11,19,56,362,40796362
26193,134,1807100,2,11,19,56,496,40796496
26194,67,1807100,1,11,19,56,563,40796563
26195,406,1807200,1,11,19,56,969,40796969
26196,1673,1807200,1,11,19,58,642,40798642
26197,1094,1807200,1,11,19,59,736,40799736
26198,498,1807200,1,11,20,0,234,40800234
26199,542,1807100,1,11,20,0,776,40800776
26200,260,1807100,1,11,20,1,36,40801036
26201,2223,1807200,1,11,20,3,259,40803259
26202,3537,1807200,2,11,20,6,796,40806796
26203,480,1807100,2,11,20,7,276,40807276
26204,327,1807100,1,11,20,7,603,40807603
26205,1591,1807300,1,11,20,9,194,40809194
26206,1,1807300,3,11,20,9,195,40809195
26207,127,1807300,1,11,20,9,322,40809322
26208,399,1807400,1,11,20,9,721,40809721
26209,7510,1807400,2,11,20,17,231,40817231
26210,821,1807300,1,11,20,18,52,40818052
26211,1736,1807300,2,11,20,19,788,40819788
26212,3950,1807300,1,11,20,23,738,40823738
26213,1081,1807200,1,11,20,24,819,40824819
26214,1071,1807200,1,11,20,25,890,40825890
26215,8423,1807300,1,11,20,34,313,40834313
26216,636,1807400,1,11,20,34,949,40834949
26217,775,1807400,1,11,20,35,724,40835724
26218,17063,1807400,13,11,20,52,787,40852787
26219,872,1807300,2,11,20,53,659,40853659
26220,5788,1807400,2,11,20,59,447,40859447
26221,1507,1807400,1,11,21,0,954,40860954
26222,393,1807500,1,11,21,1,347,40861347
26223,1096,1807400,1,11,21,2,443,40862443
26224,2659,1807400,2,11,21,5,102,40865102
26225,4015,1807500,6,11,21,9,117,40869117
26226,0,1807500,9,11,21,9,117,40869117
26227,1,1807500,3,11,21,9,118,40869118
26228,1962,1807600,9,11,21,11,80,40871080
26229,35,1807700,1,11,21,11,115,40871115
26230,98,1807700,1,11,21,11,213,40871213
26231,15,1807700,1,11,21,11,228,40871228
26232,4,1807700,1,11,21,11,232,40871232
26233,845,1807600,1,11,21,12,77,40872077
26234,190,1807600,1,11,21,12,267,40872267
26235,1906,1807700,1,11,21,14,173,40874173
26236,225,1807700,1,11,21,14,398,40874398
26237,665,1807700,1,11,21,15,63,40875063
26238,1049,1807700,1,11,21,16,112,40876112
26239,2540,1807700,3,11,21,18,652,40878652
26240,745,1807800,2,11,21,19,397,40879397
26241,1390,1807800,1,11,21,20,787,40880787
26242,35,1807700,4,11,21,20,822,40880822
26244,3306,1807700,1,11,21,24,128,40884128
26245,867,1807700,1,11,21,24,995,40884995
26246,3483,1807700,1,11,21,28,478,40888478
26247,870,1807700,1,11,21,29,348,40889348
26248,2448,1807700,1,11,21,31,796,40891796
26249,257,1807700,1,11,21,32,53,40892053
26250,933,1807800,17,11,21,32,986,40892986
26251,584,1807700,1,11,21,33,570,40893570
26252,1583,1807900,1,11,21,35,153,40895153
26253,0,1807900,4,11,21,35,153,40895153
26254,1,1807900,1,11,21,35,154,40895154
26255,0,1807900,3,11,21,35,154,40895154
26256,1,1807900,1,11,21,35,155,40895155
26257,474,1808000,2,11,21,35,629,40895629
26258,382,1808000,1,11,21,36,11,40896011
26259,1249,1808000,3,11,21,37,260,40897260
26260,23,1808000,6,11,21,37,283,40897283
26261,225,1808100,15,11,21,37,508,40897508
26262,118,1808100,1,11,21,37,626,40897626
26263,160,1808100,1,11,21,37,786,40897786
26264,31,1808100,1,11,21,37,817,40897817
26265,1463,1808000,1,11,21,39,280,40899280
26266,11,1808100,1,11,21,39,291,40899291
26267,235,1808000,1,11,21,39,526,40899526
26268,63,1807900,18,11,21,39,589,40899589
26270,115,1807900,1,11,21,39,704,40899704
26271,1788,1807900,1,11,21,41,492,40901492
26272,5882,1807900,2,11,21,47,374,40907374
26273,7,1808000,1,11,21,47,381,40907381
26274,263,1808000,1,11,21,47,644,40907644
26275,137,1808000,2,11,21,47,781,40907781
26276,2117,1808100,1,11,21,49,898,40909898
26277,1750,1808100,1,11,21,51,648,40911648
26278,1244,1808100,1,11,21,52,892,40912892
26280,166,1808200,1,11,21,53,58,40913058
26281,70,1808000,19,11,21,53,128,40913128
26283,2,1807900,1,11,21,53,130,40913130
26284,71,1808000,1,11,21,53,201,40913201
26285,185,1808000,1,11,21,53,386,40913386
26286,146,1808000,1,11,21,53,532,40913532
26287,58,1808000,2,11,21,53,590,40913590
26288,2032,1808000,1,11,21,55,622,40915622
26289,1246,1808000,2,11,21,56,868,40916868
26290,479,1807900,6,11,21,57,347,40917347
26291,8,1807800,2,11,21,57,355,40917355
26292,844,1807900,1,11,21,58,199,40918199
26293,134,1807900,1,11,21,58,333,40918333
26294,2585,1807900,1,11,22,0,918,40920918
26295,3720,1807800,8,11,22,4,638,40924638
26296,2476,1807800,1,11,22,7,114,40927114
26297,6888,1807800,18,11,22,14,2,40934002
26298,197,1807900,1,11,22,14,199,40934199
26299,499,1807900,1,11,22,14,698,40934698
26300,668,1807800,1,11,22,15,366,40935366
26301,523,1807800,1,11,22,15,889,40935889
26302,4008,1807900,21,11,22,19,897,40939897
26303,131,1808000,1,11,22,20,28,40940028
26304,3069,1808100,3,11,22,23,97,40943097
26305,1700,1808100,3,11,22,24,797,40944797
26306,1822,1808100,1,11,22,26,619,40946619
26308,123,1808200,1,11,22,26,742,40946742
26309,64,1808000,1,11,22,26,806,40946806
26310,16,1808200,1,11,22,26,822,40946822
26311,2259,1808100,1,11,22,29,81,40949081
26312,960,1808200,1,11,22,30,41,40950041
26313,82,1808200,3,11,22,30,123,40950123
26314,326,1808200,1,11,22,30,449,40950449
26315,462,1808300,1,11,22,30,911,40950911
26316,23,1808200,1,11,22,30,934,40950934
26317,143,1808100,1,11,22,31,77,40951077
26318,45,1808300,2,11,22,31,122,40951122
26319,152,1808300,1,11,22,31,274,40951274
26320,11,1808300,1,11,22,31,285,40951285
26321,1342,1808100,6,11,22,32,627,40952627
26322,0,1808100,6,11,22,32,627,40952627
26324,2,1807900,5,11,22,32,629,40952629
26325,0,1807900,2,11,22,32,629,40952629
26326,1,1807900,14,11,22,32,630,40952630
26327,0,1807900,19,11,22,32,630,40952630
26328,1,1807900,1,11,22,32,631,40952631
26329,244,1807900,1,11,22,32,875,40952875
26330,9,1808000,1,11,22,32,884,40952884
26331,67,1808000,2,11,22,32,951,40952951
26332,20,1808000,5,11,22,32,971,40952971
26333,1264,1807800,1,11,22,34,235,40954235
26334,0,1807800,11,11,22,34,235,40954235
26335,2,1807700,12,11,22,34,237,40954237
26336,5,1807600,5,11,22,34,242,40954242
26337,3,1807600,5,11,22,34,245,40954245
26338,1,1807700,1,11,22,34,246,40954246
26339,1,1807600,2,11,22,34,247,40954247
26340,113,1807500,1,11,22,34,360,40954360
26341,0,1807500,1,11,22,34,360,40954360
26342,1,1807500,2,11,22,34,361,40954361
26343,0,1807500,1,11,22,34,361,40954361
26344,0,1807500,1,11,22,34,361,40954361
26345,117,1807600,1,11,22,34,478,40954478
26346,112,1807600,2,11,22,34,590,40954590
26347,495,1807700,1,11,22,35,85,40955085
26348,246,1807700,2,11,22,35,331,40955331
26350,157,1807800,3,11,22,35,488,40955488
26351,769,1807800,1,11,22,36,257,40956257
26352,1357,1807800,1,11,22,37,614,40957614
26353,47,1807900,5,11,22,37,661,40957661
26354,4089,1808000,2,11,22,41,750,40961750
26355,4575,1807900,1,11,22,46,325,40966325
26356,236,1807900,1,11,22,46,561,40966561
26358,657,1807800,1,11,22,47,218,40967218
26359,3769,1807900,1,11,22,50,987,40970987
26360,763,1807900,2,11,22,51,750,40971750
26361,796,1807800,1,11,22,52,546,40972546
26362,356,1807800,1,11,22,52,902,40972902
26363,1379,1807900,3,11,22,54,281,40974281
26364,2123,1807900,1,11,22,56,404,40976404
26366,2761,1808000,2,11,22,59,165,40979165
26367,1706,1807800,1,11,23,0,871,40980871
26368,0,1807800,3,11,23,0,871,40980871
26369,0,1807800,4,11,23,0,871,40980871
26370,1028,1807900,1,11,23,1,899,40981899
26371,57,1807900,1,11,23,1,956,40981956
26372,50,1807900,2,11,23,2,6,40982006
26373,43,1807900,2,11,23,2,49,40982049
26374,104,1807900,1,11,23,2,153,40982153
26375,29,1807900,1,11,23,2,182,40982182
26376,43,1807900,1,11,23,2,225,40982225
26377,21,1807900,1,11,23,2,246,40982246
26378,475,1807900,1,11,23,2,721,40982721
26379,114,1807900,1,11,23,2,835,40982835
26380,4300,1807800,1,11,23,7,135,40987135
26381,226,1807700,1,11,23,7,361,40987361
26382,0,1807700,1,11,23,7,361,40987361
26383,82,1807600,3,11,23,7,443,40987443
26384,0,1807600,1,11,23,7,443,40987443
26385,1,1807500,2,11,23,7,444,40987444
26386,0,1807500,1,11,23,7,444,40987444
26387,794,1807500,1,11,23,8,238,40988238
26388,5118,1807600,2,11,23,13,356,40993356
26389,1217,1807500,1,11,23,14,573,40994573
26390,15,1807500,2,11,23,14,588,40994588
26391,295,1807600,8,11,23,14,883,40994883
26392,183,1807600,1,11,23,15,66,40995066
26393,1697,1807500,3,11,23,16,763,40996763
26394,2,1807400,1,11,23,16,765,40996765
26395,0,1807400,2,11,23,16,765,40996765
26396,0,1807400,2,11,23,16,765,40996765
26397,0,1807400,3,11,23,16,765,40996765
26398,208,1807400,2,11,23,16,973,40996973
26399,1077,1807300,4,11,23,18,50,40998050
26400,1,1807300,1,11,23,18,51,40998051
26401,71,1807300,1,11,23,18,122,40998122
26402,569,1807300,1,11,23,18,691,40998691
26403,2792,1807300,2,11,23,21,483,41001483
26404,341,1807200,2,11,23,21,824,41001824
26405,1338,1807300,1,11,23,23,162,41003162
26406,467,1807200,2,11,23,23,629,41003629
26407,1346,1807200,1,11,23,24,975,41004975
26408,2079,1807200,1,11,23,27,54,41007054
26409,0,1807200,1,11,23,27,54,41007054
26410,486,1807100,1,11,23,27,540,41007540
26411,1086,1807100,12,11,23,28,626,41008626
26412,30,1807100,1,11,23,28,656,41008656
26413,1119,1807100,1,11,23,29,775,41009775
26414,5277,1807200,1,11,23,35,52,41015052
26415,317,1807100,1,11,23,35,369,41015369
26416,89,1807100,1,11,23,35,458,41015458
26417,686,1807100,1,11,23,36,144,41016144
26418,106,1807200,2,11,23,36,250,41016250
26419,7514,1807200,5,11,23,43,764,41023764
26420,1,1807200,1,11,23,43,765,41023765
26421,96,1807300,2,11,23,43,861,41023861
26422,1475,1807300,1,11,23,45,336,41025336
26423,2461,1807200,1,11,23,47,797,41027797
26424,317,1807200,1,11,23,48,114,41028114
26425,465,1807200,2,11,23,48,579,41028579
26426,99,1807300,1,11,23,48,678,41028678
26427,1093,1807300,1,11,23,49,771,41029771
26428,230,1807300,1,11,23,50,1,41030001
26429,1708,1807200,1,11,23,51,709,41031709
26430,139,1807300,1,11,23,51,848,41031848
26431,1376,1807200,1,11,23,53,224,41033224
26432,776,1807200,2,11,23,54,0,41034000
26433,859,1807300,2,11,23,54,859,41034859
26434,2442,1807200,3,11,23,57,301,41037301
26435,1173,1807200,1,11,23,58,474,41038474
26436,249,1807100,1,11,23,58,723,41038723
26437,581,1807100,1,11,23,59,304,41039304
26438,405,1807200,1,11,23,59,709,41039709
26439,46,1807200,1,11,23,59,755,41039755
26440,757,1807200,2,11,24,0,512,41040512
26441,202,1807100,11,11,24,0,714,41040714
26442,2374,1807100,2,11,24,3,88,41043088
26443,1374,1807100,1,11,24,4,462,41044462
26444,2335,1807100,1,11,24,6,797,41046797
26445,1437,1807200,1,11,24,8,234,41048234
26446,125,1807200,1,11,24,8,359,41048359
26447,178,1807200,1,11,24,8,537,41048537
26448,3482,1807200,1,11,24,12,19,41052019
26449,432,1807200,1,11,24,12,451,41052451
26450,3102,1807200,1,11,24,15,553,41055553
26451,1016,1807200,1,11,24,16,569,41056569
26452,5524,1807300,1,11,24,22,93,41062093
26453,0,1807300,1,11,24,22,93,41062093
26454,0,1807300,2,11,24,22,93,41062093
26455,0,1807300,1,11,24,22,93,41062093
26456,5509,1807300,4,11,24,27,602,41067602
26457,292,1807300,2,11,24,27,894,41067894
26458,280,1807300,1,11,24,28,174,41068174
26459,1548,1807200,3,11,24,29,722,41069722
26460,3304,1807300,1,11,24,33,26,41073026
26461,8165,1807300,1,11,24,41,191,41081191
26462,2545,1807300,1,11,24,43,736,41083736
26463,3676,1807300,1,11,24,47,412,41087412
26464,5310,1807200,3,11,24,52,722,41092722
26465,1544,1807300,2,11,24,54,266,41094266
26466,1636,1807200,2,11,24,55,902,41095902
26467,4188,1807300,2,11,25,0,90,41100090
26468,18,1807200,2,11,25,0,108,41100108
26469,0,1807200,1,11,25,0,108,41100108
26470,243,1807200,2,11,25,0,351,41100351
26471,64,1807300,2,11,25,0,415,41100415
26472,732,1807300,1,11,25,1,147,41101147
26473,410,1807400,2,11,25,1,557,41101557
26474,1419,1807300,2,11,25,2,976,41102976
26475,1102,1807200,1,11,25,4,78,41104078
26476,2538,1807200,2,11,25,6,616,41106616
26478,2363,1807200,1,11,25,8,979,41108979
26479,1886,1807200,2,11,25,10,865,41110865
26480,278,1807300,3,11,25,11,143,41111143
26481,818,1807300,1,11,25,11,961,41111961
26482,766,1807400,6,11,25,12,727,41112727
26483,2314,1807500,3,11,25,15,41,41115041
26484,1,1807500,1,11,25,15,42,41115042
26485,0,1807500,15,11,25,15,42,41115042
26486,0,1807500,9,11,25,15,42,41115042
26487,0,1807500,1,11,25,15,42,41115042
26488,0,1807500,1,11,25,15,42,41115042
26489,0,1807500,2,11,25,15,42,41115042
26490,0,1807500,1,11,25,15,42,41115042
26491,1,1807500,20,11,25,15,43,41115043
26492,0,1807500,1,11,25,15,43,41115043
26493,1,1807500,44,11,25,15,44,41115044
26494,1,1807600,1,11,25,15,45,41115045
26495,0,1807600,1,11,25,15,45,41115045
26496,0,1807600,5,11,25,15,45,41115045
26497,10188,1807600,2,11,25,25,233,41125233
26498,8461,1807500,1,11,25,33,694,41133694
26499,1,1807500,1,11,25,33,695,41133695
26500,2759,1807600,1,11,25,36,454,41136454
26501,0,1807600,1,11,25,36,454,41136454
26502,1808,1807600,1,11,25,38,262,41138262
26503,2838,1807700,1,11,25,41,100,41141100
26504,0,1807700,1,11,25,41,100,41141100
26505,0,1807700,6,11,25,41,100,41141100
26506,0,1807700,1,11,25,41,100,41141100
26507,1,1807700,2,11,25,41,101,41141101
26508,1094,1807700,1,11,25,42,195,41142195
26509,7279,1807700,2,11,25,49,474,41149474
26510,5296,1807800,1,11,25,54,770,41154770
26511,83,1807800,1,11,25,54,853,41154853
26512,1397,1807800,5,11,25,56,250,41156250
26513,822,1807800,1,11,25,57,72,41157072
26514,639,1807800,1,11,25,57,711,41157711
26515,408,1807800,1,11,25,58,119,41158119
26516,4056,1807700,5,11,26,2,175,41162175
26517,119,1807600,2,11,26,2,294,41162294
26518,573,1807800,1,11,26,2,867,41162867
26519,674,1807700,1,11,26,3,541,41163541
26520,3021,1807600,1,11,26,6,562,41166562
26521,1,1807600,2,11,26,6,563,41166563
26522,293,1807600,2,11,26,6,856,41166856
26523,383,1807600,1,11,26,7,239,41167239
26524,3764,1807700,1,11,26,11,3,41171003
26525,6307,1807700,1,11,26,17,310,41177310
26526,7612,1807700,1,11,26,24,922,41184922
26527,0,1807700,3,11,26,24,922,41184922
26528,1,1807600,1,11,26,24,923,41184923
26529,0,1807600,1,11,26,24,923,41184923
26530,175,1807500,3,11,26,25,98,41185098
26531,1902,1807700,3,11,26,27,0,41187000
26532,3761,1807700,1,11,26,30,761,41190761
26533,10748,1807700,2,11,26,41,509,41201509
26534,2702,1807700,1,11,26,44,211,41204211
26535,4858,1807600,4,11,26,49,69,41209069
26536,1283,1807700,1,11,26,50,352,41210352
26537,7847,1807500,1,11,26,58,199,41218199
26538,8944,1807500,2,11,27,7,143,41227143
26539,10917,1807500,1,11,27,18,60,41238060
26540,2628,1807500,1,11,27,20,688,41240688
26541,1060,1807600,1,11,27,21,748,41241748
26542,2291,1807600,1,11,27,24,39,41244039
26543,5896,1807500,1,11,27,29,935,41249935
26544,2898,1807500,1,11,27,32,833,41252833
26545,2247,1807600,1,11,27,35,80,41255080
26546,1895,1807500,2,11,27,36,975,41256975
26547,4423,1807500,1,11,27,41,398,41261398
26548,155,1807500,2,11,27,41,553,41261553
26549,300,1807500,1,11,27,41,853,41261853
26550,3446,1807600,1,11,27,45,299,41265299
26551,168,1807600,1,11,27,45,467,41265467
26552,165,1807600,1,11,27,45,632,41265632
26553,225,1807600,1,11,27,45,857,41265857
26554,165,1807600,1,11,27,46,22,41266022
26555,370,1807600,1,11,27,46,392,41266392
26556,438,1807600,2,11,27,46,830,41266830
26557,868,1807700,1,11,27,47,698,41267698
26558,2647,1807600,1,11,27,50,345,41270345
26559,10587,1807700,1,11,28,0,932,41280932
26560,8384,1807700,1,11,28,9,316,41289316
26561,2361,1807600,1,11,28,11,677,41291677
26562,2081,1807700,4,11,28,13,758,41293758
26563,3825,1807700,1,11,28,17,583,41297583
26564,2496,1807700,1,11,28,20,79,41300079
26565,1,1807700,1,11,28,20,80,41300080
26566,0,1807700,3,11,28,20,80,41300080
26567,58,1807800,1,11,28,20,138,41300138
26568,934,1807800,1,11,28,21,72,41301072
26569,2929,1807800,23,11,28,24,1,41304001
26570,571,1807800,2,11,28,24,572,41304572
26571,1193,1807900,1,11,28,25,765,41305765
26572,260,1807900,2,11,28,26,25,41306025
26573,1469,1807900,2,11,28,27,494,41307494
26574,4343,1807900,2,11,28,31,837,41311837
26575,63,1807900,1,11,28,31,900,41311900
26576,2074,1807900,1,11,28,33,974,41313974
26577,444,1807800,5,11,28,34,418,41314418
26579,8781,1807800,1,11,28,43,199,41323199
26580,345,1807800,1,11,28,43,544,41323544
26581,678,1807800,1,11,28,44,222,41324222
26582,1051,1807700,1,11,28,45,273,41325273
26583,4280,1807700,1,11,28,49,553,41329553
26584,5391,1807800,1,11,28,54,944,41334944
26585,183,1807700,1,11,28,55,127,41335127
26586,0,1807700,6,11,28,55,127,41335127
26587,3472,1807600,1,11,28,58,599,41338599
26588,1,1807600,1,11,28,58,600,41338600
26589,219,1807600,1,11,28,58,819,41338819
26590,627,1807500,1,11,28,59,446,41339446
26591,14735,1807400,19,11,29,14,181,41354181
26592,9,1807300,4,11,29,14,190,41354190
26593,64,1807300,3,11,29,14,254,41354254
26595,75,1807200,3,11,29,14,329,41354329
26596,1924,1807200,1,11,29,16,253,41356253
26597,735,1807200,1,11,29,16,988,41356988
26598,177,1807200,5,11,29,17,165,41357165
26599,0,1807200,1,11,29,17,165,41357165
26600,450,1807200,1,11,29,17,615,41357615
26601,59,1807300,1,11,29,17,674,41357674
26602,1106,1807200,1,11,29,18,780,41358780
26603,377,1807100,6,11,29,19,157,41359157
26604,1,1807100,18,11,29,19,158,41359158
26605,3,1807000,4,11,29,19,161,41359161
26606,0,1807000,17,11,29,19,161,41359161
26607,0,1807000,1,11,29,19,161,41359161
26608,0,1807000,2,11,29,19,161,41359161
26609,1,1807000,14,11,29,19,162,41359162
26610,72,1806900,5,11,29,19,234,41359234
26611,103,1806900,3,11,29,19,337,41359337
26612,25,1806900,5,11,29,19,362,41359362
26613,37,1806900,1,11,29,19,399,41359399
26614,1,1806900,40,11,29,19,400,41359400
26615,1,1806800,1,11,29,19,401,41359401
26616,15,1806900,1,11,29,19,416,41359416
26617,7,1806800,1,11,29,19,423,41359423
26618,55,1806800,2,11,29,19,478,41359478
26619,93,1806800,1,11,29,19,571,41359571
26620,31,1806800,1,11,29,19,602,41359602
26621,93,1806800,22,11,29,19,695,41359695
26622,5,1806700,1,11,29,19,700,41359700
26623,0,1806700,3,11,29,19,700,41359700
26624,4,1806700,2,11,29,19,704,41359704
26625,32,1806700,26,11,29,19,736,41359736
26626,1,1806700,1,11,29,19,737,41359737
26627,0,1806700,1,11,29,19,737,41359737
26628,0,1806700,1,11,29,19,737,41359737
26629,0,1806700,5,11,29,19,737,41359737
26630,9,1806700,1,11,29,19,746,41359746
26631,1,1806600,5,11,29,19,747,41359747
26632,13,1806600,3,11,29,19,760,41359760
26633,5,1806600,1,11,29,19,765,41359765
26634,32,1806600,1,11,29,19,797,41359797
26635,16,1806600,3,11,29,19,813,41359813
26636,42,1806600,1,11,29,19,855,41359855
26637,23,1806600,1,11,29,19,878,41359878
26638,6,1806600,1,11,29,19,884,41359884
26639,10,1806500,5,11,29,19,894,41359894
26640,6,1806500,1,11,29,19,900,41359900
26641,7,1806500,5,11,29,19,907,41359907
26642,22,1806500,2,11,29,19,929,41359929
26643,5,1806500,3,11,29,19,934,41359934
26644,27,1806500,5,11,29,19,961,41359961
26645,29,1806400,2,11,29,19,990,41359990
26646,12,1806400,1,11,29,20,2,41360002
26647,10,1806400,1,11,29,20,12,41360012
26648,2,1806400,1,11,29,20,14,41360014
26649,7,1806400,1,11,29,20,21,41360021
26650,11,1806400,5,11,29,20,32,41360032
26651,11,1806400,1,11,29,20,43,41360043
26652,11,1806400,1,11,29,20,54,41360054
26653,0,1806400,1,11,29,20,54,41360054
26654,6,1806400,1,11,29,20,60,41360060
26655,37,1806500,1,11,29,20,97,41360097
26656,12,1806600,2,11,29,20,109,41360109
26657,0,1806500,2,11,29,20,109,41360109
26658,1,1806600,1,11,29,20,110,41360110
26659,0,1806600,1,11,29,20,110,41360110
26660,12,1806500,1,11,29,20,122,41360122
26661,19,1806500,8,11,29,20,141,41360141
26663,1,1806500,1,11,29,20,142,41360142
26664,11,1806400,1,11,29,20,153,41360153
26665,0,1806400,2,11,29,20,153,41360153
26666,0,1806500,3,11,29,20,153,41360153
26667,24,1806400,5,11,29,20,177,41360177
26668,4,1806400,2,11,29,20,181,41360181
26669,32,1806400,1,11,29,20,213,41360213
26670,16,1806400,1,11,29,20,229,41360229
26671,5,1806400,1,11,29,20,234,41360234
26672,8,1806500,1,11,29,20,242,41360242
26673,11,1806400,1,11,29,20,253,41360253
26674,1,1806400,1,11,29,20,254,41360254
26675,42,1806600,1,11,29,20,296,41360296
26676,11,1806400,1,11,29,20,307,41360307
26677,129,1806500,1,11,29,20,436,41360436
26678,6,1806400,1,11,29,20,442,41360442
26679,23,1806400,1,11,29,20,465,41360465
26680,23,1806400,1,11,29,20,488,41360488
26681,2,1806400,7,11,29,20,490,41360490
26682,25,1806400,2,11,29,20,515,41360515
26683,12,1806400,1,11,29,20,527,41360527
26684,53,1806300,4,11,29,20,580,41360580
26685,6,1806500,1,11,29,20,586,41360586
26686,44,1806500,1,11,29,20,630,41360630
26688,32,1806400,5,11,29,20,662,41360662
26689,123,1806400,1,11,29,20,785,41360785
26690,97,1806600,1,11,29,20,882,41360882
26691,4,1806500,1,11,29,20,886,41360886
26692,0,1806500,1,11,29,20,886,41360886
26693,78,1806500,1,11,29,20,964,41360964
26694,119,1806500,1,11,29,21,83,41361083
26695,138,1806500,1,11,29,21,221,41361221
26696,345,1806500,1,11,29,21,566,41361566
26697,5,1806500,1,11,29,21,571,41361571
26698,6,1806500,1,11,29,21,577,41361577
26699,5,1806500,1,11,29,21,582,41361582
26700,6,1806500,1,11,29,21,588,41361588
26701,5,1806500,1,11,29,21,593,41361593
26702,209,1806400,1,11,29,21,802,41361802
26703,12,1806600,2,11,29,21,814,41361814
26704,0,1806500,2,11,29,21,814,41361814
26705,211,1806600,1,11,29,22,25,41362025
26706,255,1806500,1,11,29,22,280,41362280
26707,578,1806600,1,11,29,22,858,41362858
26708,4,1806600,2,11,29,22,862,41362862
26709,1046,1806500,2,11,29,23,908,41363908
26710,470,1806500,1,11,29,24,378,41364378
26711,1009,1806500,1,11,29,25,387,41365387
26712,249,1806600,1,11,29,25,636,41365636
26713,784,1806500,2,11,29,26,420,41366420
26714,481,1806500,1,11,29,26,901,41366901
26715,564,1806500,2,11,29,27,465,41367465
26716,211,1806600,1,11,29,27,676,41367676
26717,285,1806400,1,11,29,27,961,41367961
26718,378,1806400,3,11,29,28,339,41368339
26719,419,1806400,2,11,29,28,758,41368758
26721,2,1806500,1,11,29,28,760,41368760
26722,230,1806500,1,11,29,28,990,41368990
26723,210,1806400,3,11,29,29,200,41369200
26724,110,1806400,4,11,29,29,310,41369310
26725,65,1806400,1,11,29,29,375,41369375
26726,47,1806400,1,11,29,29,422,41369422
26727,194,1806400,3,11,29,29,616,41369616
26728,237,1806500,1,11,29,29,853,41369853
26729,87,1806400,1,11,29,29,940,41369940
26730,79,1806400,4,11,29,30,19,41370019
26732,83,1806300,3,11,29,30,102,41370102
26733,790,1806400,3,11,29,30,892,41370892
26734,153,1806400,1,11,29,31,45,41371045
26736,629,1806400,2,11,29,31,674,41371674
26737,131,1806300,1,11,29,31,805,41371805
26738,259,1806300,3,11,29,32,64,41372064
26739,1165,1806400,1,11,29,33,229,41373229
26740,213,1806300,2,11,29,33,442,41373442
26741,32,1806400,1,11,29,33,474,41373474
26742,198,1806400,1,11,29,33,672,41373672
26743,20,1806300,1,11,29,33,692,41373692
26744,163,1806400,1,11,29,33,855,41373855
26745,692,1806300,1,11,29,34,547,41374547
26746,128,1806300,3,11,29,34,675,41374675
26747,327,1806300,1,11,29,35,2,41375002
26748,204,1806400,1,11,29,35,206,41375206
26749,1,1806400,2,11,29,35,207,41375207
26750,0,1806400,2,11,29,35,207,41375207
26751,0,1806400,1,11,29,35,207,41375207
26752,189,1806400,1,11,29,35,396,41375396
26753,20,1806400,1,11,29,35,416,41375416
26754,795,1806400,2,11,29,36,211,41376211
26755,66,1806400,1,11,29,36,277,41376277
26756,278,1806400,1,11,29,36,555,41376555
26757,730,1806400,2,11,29,37,285,41377285
26758,793,1806400,1,11,29,38,78,41378078
26759,125,1806500,1,11,29,38,203,41378203
26760,448,1806400,1,11,29,38,651,41378651
26761,424,1806400,1,11,29,39,75,41379075
26762,61,1806400,2,11,29,39,136,41379136
26763,241,1806400,1,11,29,39,377,41379377
26764,971,1806400,1,11,29,40,348,41380348
26765,201,1806300,2,11,29,40,549,41380549
26766,189,1806500,1,11,29,40,738,41380738
26767,471,1806300,1,11,29,41,209,41381209
26768,243,1806300,1,11,29,41,452,41381452
26769,997,1806300,1,11,29,42,449,41382449
26770,8,1806400,1,11,29,42,457,41382457
26771,600,1806300,2,11,29,43,57,41383057
26772,1930,1806400,1,11,29,44,987,41384987
26773,76,1806400,2,11,29,45,63,41385063
26774,557,1806300,2,11,29,45,620,41385620
26775,399,1806400,1,11,29,46,19,41386019
26776,163,1806400,1,11,29,46,182,41386182
26777,968,1806500,1,11,29,47,150,41387150
26778,229,1806400,2,11,29,47,379,41387379
26779,632,1806500,1,11,29,48,11,41388011
26780,626,1806500,5,11,29,48,637,41388637
26781,1,1806500,3,11,29,48,638,41388638
26782,737,1806500,2,11,29,49,375,41389375
26783,534,1806500,1,11,29,49,909,41389909
26784,85,1806400,1,11,29,49,994,41389994
26785,710,1806400,1,11,29,50,704,41390704
26786,73,1806500,1,11,29,50,777,41390777
26787,793,1806400,3,11,29,51,570,41391570
26788,249,1806400,1,11,29,51,819,41391819
26789,45,1806400,1,11,29,51,864,41391864
26790,229,1806500,1,11,29,52,93,41392093
26791,1816,1806400,1,11,29,53,909,41393909
26792,566,1806400,1,11,29,54,475,41394475
26793,775,1806400,1,11,29,55,250,41395250
26795,495,1806500,3,11,29,55,745,41395745
26796,446,1806400,2,11,29,56,191,41396191
26797,0,1806400,1,11,29,56,191,41396191
26798,213,1806300,2,11,29,56,404,41396404
26799,0,1806300,1,11,29,56,404,41396404
26800,1,1806300,8,11,29,56,405,41396405
26801,0,1806300,2,11,29,56,405,41396405
26802,0,1806300,1,11,29,56,405,41396405
26803,80,1806300,1,11,29,56,485,41396485
26804,186,1806200,2,11,29,56,671,41396671
26805,123,1806200,1,11,29,56,794,41396794
26806,0,1806200,2,11,29,56,794,41396794
26807,0,1806200,2,11,29,56,794,41396794
26808,1,1806200,1,11,29,56,795,41396795
26809,0,1806200,1,11,29,56,795,41396795
26810,0,1806200,2,11,29,56,795,41396795
26811,0,1806200,1,11,29,56,795,41396795
26812,0,1806200,4,11,29,56,795,41396795
26813,0,1806200,4,11,29,56,795,41396795
26814,0,1806200,1,11,29,56,795,41396795
26815,0,1806200,8,11,29,56,795,41396795
26816,1,1806100,16,11,29,56,796,41396796
26817,1,1806100,4,11,29,56,797,41396797
26818,0,1806100,2,11,29,56,797,41396797
26819,0,1806100,2,11,29,56,797,41396797
26820,0,1806100,2,11,29,56,797,41396797
26821,0,1806100,1,11,29,56,797,41396797
26822,1,1806100,3,11,29,56,798,41396798
26823,0,1806100,1,11,29,56,798,41396798
26824,0,1806000,1,11,29,56,798,41396798
26825,68,1806000,2,11,29,56,866,41396866
26826,31,1806000,1,11,29,56,897,41396897
26827,19,1806000,1,11,29,56,916,41396916
26828,5,1806000,1,11,29,56,921,41396921
26829,5,1806000,1,11,29,56,926,41396926
26830,29,1806000,1,11,29,56,955,41396955
26831,1,1806000,1,11,29,56,956,41396956
26832,93,1806100,1,11,29,57,49,41397049
26833,6,1806000,1,11,29,57,55,41397055
26834,209,1806100,1,11,29,57,264,41397264
26835,83,1806000,1,11,29,57,347,41397347
26836,477,1806000,23,11,29,57,824,41397824
26837,22,1805900,1,11,29,57,846,41397846
26838,10,1805900,1,11,29,57,856,41397856
26839,2,1805900,2,11,29,57,858,41397858
26840,0,1805900,2,11,29,57,858,41397858
26841,10,1805900,1,11,29,57,868,41397868
26842,58,1805900,4,11,29,57,926,41397926
26843,60,1805800,3,11,29,57,986,41397986
26844,2,1805800,6,11,29,57,988,41397988
26845,0,1805800,3,11,29,57,988,41397988
26846,1,1805800,1,11,29,57,989,41397989
26847,0,1805800,2,11,29,57,989,41397989
26848,0,1805800,6,11,29,57,989,41397989
26849,0,1805800,1,11,29,57,989,41397989
26850,12,1805800,2,11,29,58,1,41398001
26852,49,1805700,1,11,29,58,50,41398050
26853,79,1805700,1,11,29,58,129,41398129
26854,4,1805700,3,11,29,58,133,41398133
26855,2,1805700,8,11,29,58,135,41398135
26856,1,1805700,1,11,29,58,136,41398136
26857,5,1805700,1,11,29,58,141,41398141
26858,8,1805700,1,11,29,58,149,41398149
26859,23,1805700,2,11,29,58,172,41398172
26861,56,1805600,2,11,29,58,228,41398228
26862,88,1805600,1,11,29,58,316,41398316
26863,20,1805600,1,11,29,58,336,41398336
26864,62,1805800,2,11,29,58,398,41398398
26865,1,1805800,2,11,29,58,399,41398399
26866,28,1805800,1,11,29,58,427,41398427
26867,10,1805800,1,11,29,58,437,41398437
26868,179,1805900,1,11,29,58,616,41398616
26869,63,1806000,1,11,29,58,679,41398679
26870,6,1805900,1,11,29,58,685,41398685
26871,51,1805900,1,11,29,58,736,41398736
26873,16,1806000,1,11,29,58,752,41398752
26874,28,1805800,1,11,29,58,780,41398780
26875,3,1805800,1,11,29,58,783,41398783
26876,110,1805800,1,11,29,58,893,41398893
26877,266,1805800,1,11,29,59,159,41399159
26878,101,1805900,1,11,29,59,260,41399260
26880,318,1805900,1,11,29,59,578,41399578
26881,26,1805900,1,11,29,59,604,41399604
26882,128,1805800,1,11,29,59,732,41399732
26883,3,1805800,1,11,29,59,735,41399735
26884,120,1805900,1,11,29,59,855,41399855
26885,68,1805900,4,11,29,59,923,41399923
26886,0,1805900,2,11,29,59,923,41399923
26887,199,1805900,4,11,30,0,122,41400122
26888,11,1805800,1,11,30,0,133,41400133
26889,17,1805800,2,11,30,0,150,41400150
26890,40,1805800,1,11,30,0,190,41400190
26891,39,1806000,1,11,30,0,229,41400229
26892,0,1806000,2,11,30,0,229,41400229
26893,0,1806000,2,11,30,0,229,41400229
26894,1,1806100,1,11,30,0,230,41400230
26895,3,1806100,1,11,30,0,233,41400233
26896,49,1805900,1,11,30,0,282,41400282
26897,59,1805900,1,11,30,0,341,41400341
26898,79,1805900,1,11,30,0,420,41400420
26899,193,1805900,1,11,30,0,613,41400613
26900,256,1806000,1,11,30,0,869,41400869
26901,47,1805900,1,11,30,0,916,41400916
26902,38,1806100,1,11,30,0,954,41400954
26903,2,1805900,3,11,30,0,956,41400956
26904,9,1805900,3,11,30,0,965,41400965
26905,35,1806100,1,11,30,1,0,41401000
26906,65,1806000,1,11,30,1,65,41401065
26907,35,1806100,1,11,30,1,100,41401100
26908,14,1806100,1,11,30,1,114,41401114
26909,76,1806200,1,11,30,1,190,41401190
26910,36,1806000,1,11,30,1,226,41401226
26911,102,1806000,1,11,30,1,328,41401328
26912,66,1806200,1,11,30,1,394,41401394
26913,78,1806000,1,11,30,1,472,41401472
26914,15,1806000,2,11,30,1,487,41401487
26915,69,1806000,1,11,30,1,556,41401556
26916,90,1806000,1,11,30,1,646,41401646
26917,0,1806200,1,11,30,1,646,41401646
26918,59,1806100,1,11,30,1,705,41401705
26919,41,1805900,1,11,30,1,746,41401746
26920,212,1806100,4,11,30,1,958,41401958
26921,122,1806200,2,11,30,2,80,41402080
26922,394,1806000,1,11,30,2,474,41402474
26923,456,1806000,1,11,30,2,930,41402930
26924,120,1806100,1,11,30,3,50,41403050
26925,233,1806000,2,11,30,3,283,41403283
26926,739,1806000,1,11,30,4,22,41404022
26927,542,1806000,5,11,30,4,564,41404564
26928,169,1806000,2,11,30,4,733,41404733
26929,638,1806000,1,11,30,5,371,41405371
26930,761,1806100,3,11,30,6,132,41406132
26931,1,1805900,1,11,30,6,133,41406133
26932,28,1805900,3,11,30,6,161,41406161
26933,7,1805900,3,11,30,6,168,41406168
26934,118,1805800,1,11,30,6,286,41406286
26935,95,1805900,1,11,30,6,381,41406381
26936,74,1805900,2,11,30,6,455,41406455
26938,288,1805900,2,11,30,6,743,41406743
26939,278,1805800,4,11,30,7,21,41407021
26940,1,1805800,4,11,30,7,22,41407022
26941,1,1805800,1,11,30,7,23,41407023
26942,77,1805800,1,11,30,7,100,41407100
26943,1,1805800,1,11,30,7,101,41407101
26944,0,1805800,1,11,30,7,101,41407101
26945,0,1805900,1,11,30,7,101,41407101
26946,14,1805900,1,11,30,7,115,41407115
26947,134,1805900,1,11,30,7,249,41407249
26948,152,1805800,1,11,30,7,401,41407401
26949,598,1805700,2,11,30,7,999,41407999
26950,162,1805700,1,11,30,8,161,41408161
26951,97,1805700,2,11,30,8,258,41408258
26952,153,1805600,1,11,30,8,411,41408411
26953,168,1805600,1,11,30,8,579,41408579
26954,85,1805600,1,11,30,8,664,41408664
26955,194,1805600,1,11,30,8,858,41408858
26956,652,1805800,4,11,30,9,510,41409510
26957,0,1805800,9,11,30,9,510,41409510
26958,379,1805800,2,11,30,9,889,41409889
26959,184,1805800,1,11,30,10,73,41410073
26960,877,1805800,1,11,30,10,950,41410950
26961,383,1805800,2,11,30,11,333,41411333
26962,19,1805800,1,11,30,11,352,41411352
26963,245,1805800,1,11,30,11,597,41411597
26964,301,1805900,2,11,30,11,898,41411898
26965,286,1805800,3,11,30,12,184,41412184
26966,343,1805700,8,11,30,12,527,41412527
26967,42,1805600,5,11,30,12,569,41412569
26968,117,1805600,3,11,30,12,686,41412686
26969,29,1805600,5,11,30,12,715,41412715
26970,1,1805600,4,11,30,12,716,41412716
26971,0,1805600,1,11,30,12,716,41412716
26972,5,1805500,4,11,30,12,721,41412721
26973,231,1805500,2,11,30,12,952,41412952
26974,51,1805500,23,11,30,13,3,41413003
26976,145,1805600,1,11,30,13,148,41413148
26977,35,1805400,2,11,30,13,183,41413183
26978,2,1805400,2,11,30,13,185,41413185
26979,0,1805400,2,11,30,13,185,41413185
26980,130,1805400,1,11,30,13,315,41413315
26981,4,1805400,1,11,30,13,319,41413319
26982,46,1805400,1,11,30,13,365,41413365
26983,791,1805500,2,11,30,14,156,41414156
26984,18,1805500,2,11,30,14,174,41414174
26985,63,1805400,1,11,30,14,237,41414237
26986,291,1805400,2,11,30,14,528,41414528
26987,47,1805500,1,11,30,14,575,41414575
26989,0,1805600,3,11,30,14,575,41414575
26990,245,1805700,3,11,30,14,820,41414820
26991,768,1805600,1,11,30,15,588,41415588
26992,190,1805800,1,11,30,15,778,41415778
26993,67,1805800,1,11,30,15,845,41415845
26994,462,1805700,1,11,30,16,307,41416307
26995,188,1805700,1,11,30,16,495,41416495
26996,1908,1805800,1,11,30,18,403,41418403
26997,72,1805800,1,11,30,18,475,41418475
26998,0,1805800,1,11,30,18,475,41418475
26999,1,1805800,1,11,30,18,476,41418476
27000,1,1805800,1,11,30,18,477,41418477
27001,86,1805700,1,11,30,18,563,41418563
27002,312,1805800,4,11,30,18,875,41418875
27003,0,1805800,5,11,30,18,875,41418875
27004,1,1805800,1,11,30,18,876,41418876
27005,160,1805800,1,11,30,19,36,41419036
27006,72,1805700,1,11,30,19,108,41419108
27007,95,1805700,3,11,30,19,203,41419203
27008,32,1805700,3,11,30,19,235,41419235
27009,405,1805800,1,11,30,19,640,41419640
27010,189,1805700,1,11,30,19,829,41419829
27011,132,1805700,1,11,30,19,961,41419961
27012,184,1805700,1,11,30,20,145,41420145
27013,192,1805800,1,11,30,20,337,41420337
27014,642,1805700,2,11,30,20,979,41420979
27015,67,1805700,1,11,30,21,46,41421046
27016,170,1805700,1,11,30,21,216,41421216
27017,940,1805600,3,11,30,22,156,41422156
27018,523,1805700,1,11,30,22,679,41422679
27019,44,1805600,1,11,30,22,723,41422723
27020,971,1805700,1,11,30,23,694,41423694
27021,528,1805700,1,11,30,24,222,41424222
27022,331,1805600,3,11,30,24,553,41424553
27023,1508,1805600,2,11,30,26,61,41426061
27024,38,1805800,1,11,30,26,99,41426099
27025,854,1805800,1,11,30,26,953,41426953
27026,239,1805800,1,11,30,27,192,41427192
27027,370,1805700,1,11,30,27,562,41427562
27028,115,1805700,2,11,30,27,677,41427677
27029,70,1805600,2,11,30,27,747,41427747
27030,586,1805600,2,11,30,28,333,41428333
27031,1241,1805600,1,11,30,29,574,41429574
27032,640,1805600,1,11,30,30,214,41430214
27033,642,1805600,2,11,30,30,856,41430856
27034,197,1805500,5,11,30,31,53,41431053
27035,405,1805500,2,11,30,31,458,41431458
27036,1325,1805600,1,11,30,32,783,41432783
27037,668,1805600,1,11,30,33,451,41433451
27038,988,1805600,1,11,30,34,439,41434439
27039,461,1805500,1,11,30,34,900,41434900
27040,240,1805600,1,11,30,35,140,41435140
27041,9,1805700,1,11,30,35,149,41435149
27042,5,1805700,1,11,30,35,154,41435154
27043,4,1805700,1,11,30,35,158,41435158
27044,5,1805700,1,11,30,35,163,41435163
27045,1,1805700,3,11,30,35,164,41435164
27046,3,1805700,1,11,30,35,167,41435167
27047,39,1805700,1,11,30,35,206,41435206
27048,833,1805600,2,11,30,36,39,41436039
27049,879,1805600,1,11,30,36,918,41436918
27050,814,1805500,5,11,30,37,732,41437732
27051,457,1805500,2,11,30,38,189,41438189
27052,381,1805700,2,11,30,38,570,41438570
27053,1172,1805800,13,11,30,39,742,41439742
27054,339,1805700,1,11,30,40,81,41440081
27055,972,1805900,3,11,30,41,53,41441053
27056,358,1805800,1,11,30,41,411,41441411
27057,357,1805900,1,11,30,41,768,41441768
27058,149,1805800,1,11,30,41,917,41441917
27059,332,1805800,1,11,30,42,249,41442249
27060,805,1805900,2,11,30,43,54,41443054
27061,27,1805700,5,11,30,43,81,41443081
27062,125,1805800,1,11,30,43,206,41443206
27063,338,1805900,3,11,30,43,544,41443544
27064,966,1805800,1,11,30,44,510,41444510
27065,11,1805700,1,11,30,44,521,41444521
27066,1027,1805900,2,11,30,45,548,41445548
27067,1534,1805800,1,11,30,47,82,41447082
27068,580,1805900,1,11,30,47,662,41447662
27069,1823,1805700,1,11,30,49,485,41449485
27070,167,1805800,1,11,30,49,652,41449652
27071,430,1805700,1,11,30,50,82,41450082
27072,508,1805700,2,11,30,50,590,41450590
27073,87,1805800,2,11,30,50,677,41450677
27074,267,1805700,1,11,30,50,944,41450944
27075,1394,1805800,1,11,30,52,338,41452338
27076,3026,1805700,1,11,30,55,364,41455364
27077,430,1805800,1,11,30,55,794,41455794
27078,455,1805700,1,11,30,56,249,41456249
27079,184,1805700,1,11,30,56,433,41456433
27080,182,1805800,1,11,30,56,615,41456615
27081,718,1805700,2,11,30,57,333,41457333
27082,1094,1805600,5,11,30,58,427,41458427
27083,2536,1805700,1,11,31,0,963,41460963
27084,258,1805600,1,11,31,1,221,41461221
27085,109,1805600,1,11,31,1,330,41461330
27086,159,1805600,1,11,31,1,489,41461489
27087,60,1805700,2,11,31,1,549,41461549
27088,102,1805600,1,11,31,1,651,41461651
27089,203,1805800,3,11,31,1,854,41461854
27090,5,1805900,1,11,31,1,859,41461859
27091,6,1805700,1,11,31,1,865,41461865
27092,99,1805900,1,11,31,1,964,41461964
27093,1021,1805700,1,11,31,2,985,41462985
27094,34,1805600,1,11,31,3,19,41463019
27095,1,1805600,1,11,31,3,20,41463020
27096,215,1805600,1,11,31,3,235,41463235
27097,25,1805600,1,11,31,3,260,41463260
27098,50,1805600,1,11,31,3,310,41463310
27099,631,1805600,1,11,31,3,941,41463941
27100,382,1805500,1,11,31,4,323,41464323
27101,1182,1805600,1,11,31,5,505,41465505
27102,1922,1805600,1,11,31,7,427,41467427
27103,1094,1805500,1,11,31,8,521,41468521
27104,580,1805600,1,11,31,9,101,41469101
27105,1676,1805600,1,11,31,10,777,41470777
27106,615,1805600,1,11,31,11,392,41471392
27107,743,1805500,1,11,31,12,135,41472135
27108,901,1805500,1,11,31,13,36,41473036
27109,48,1805500,1,11,31,13,84,41473084
27110,10,1805500,1,11,31,13,94,41473094
27111,34,1805500,1,11,31,13,128,41473128
27112,23,1805500,1,11,31,13,151,41473151
27113,164,1805600,1,11,31,13,315,41473315
27114,16,1805600,2,11,31,13,331,41473331
27115,1448,1805600,2,11,31,14,779,41474779
27116,3113,1805700,12,11,31,17,892,41477892
27117,0,1805700,2,11,31,17,892,41477892
27118,144,1805700,1,11,31,18,36,41478036
27120,1113,1805700,3,11,31,19,149,41479149
27122,234,1805700,1,11,31,19,383,41479383
27124,281,1805700,1,11,31,19,664,41479664
27125,3716,1805700,1,11,31,23,380,41483380
27126,463,1805800,1,11,31,23,843,41483843
27127,119,1805800,1,11,31,23,962,41483962
27128,1323,1805700,3,11,31,25,285,41485285
27129,323,1805800,1,11,31,25,608,41485608
27130,940,1805800,1,11,31,26,548,41486548
27131,1518,1805800,1,11,31,28,66,41488066
27132,2148,1805800,4,11,31,30,214,41490214
27133,2930,1805700,4,11,31,33,144,41493144
27134,1358,1805800,2,11,31,34,502,41494502
27135,1979,1805800,2,11,31,36,481,41496481
27136,1780,1805800,1,11,31,38,261,41498261
27137,1907,1805800,1,11,31,40,168,41500168
27138,477,1805800,1,11,31,40,645,41500645
27139,148,1805800,1,11,31,40,793,41500793
27141,2038,1805800,1,11,31,42,831,41502831
27143,1629,1805700,3,11,31,44,460,41504460
27144,160,1805600,3,11,31,44,620,41504620
27145,1272,1805600,2,11,31,45,892,41505892
27146,0,1805600,1,11,31,45,892,41505892
27147,1,1805600,1,11,31,45,893,41505893
27148,0,1805600,5,11,31,45,893,41505893
27149,332,1805500,37,11,31,46,225,41506225
27150,1,1805400,1,11,31,46,226,41506226
27151,1,1805400,1,11,31,46,227,41506227
27152,40,1805400,2,11,31,46,267,41506267
27153,139,1805400,3,11,31,46,406,41506406
27154,251,1805400,3,11,31,46,657,41506657
27155,156,1805400,1,11,31,46,813,41506813
27156,435,1805500,1,11,31,47,248,41507248
27157,184,1805400,3,11,31,47,432,41507432
27158,683,1805600,1,11,31,48,115,41508115
27159,1039,1805600,1,11,31,49,154,41509154
27161,113,1805700,2,11,31,49,267,41509267
27162,1010,1805600,5,11,31,50,277,41510277
27163,742,1805700,1,11,31,51,19,41511019
27164,1115,1805500,1,11,31,52,134,41512134
27165,1113,1805500,1,11,31,53,247,41513247
27166,519,1805600,1,11,31,53,766,41513766
27167,1472,1805500,1,11,31,55,238,41515238
27168,824,1805400,4,11,31,56,62,41516062
27169,257,1805500,1,11,31,56,319,41516319
27170,1870,1805400,5,11,31,58,189,41518189
27171,37,1805500,1,11,31,58,226,41518226
27172,313,1805500,1,11,31,58,539,41518539
27173,1750,1805400,1,11,32,0,289,41520289
27174,75,1805400,3,11,32,0,364,41520364
27175,323,1805400,1,11,32,0,687,41520687
27176,9,1805400,1,11,32,0,696,41520696
27177,85,1805400,1,11,32,0,781,41520781
27178,89,1805400,1,11,32,0,870,41520870
27179,0,1805400,3,11,32,0,870,41520870
27180,1,1805400,3,11,32,0,871,41520871
27181,0,1805400,1,11,32,0,871,41520871
27182,29,1805300,1,11,32,0,900,41520900
27183,4,1805300,1,11,32,0,904,41520904
27184,177,1805300,2,11,32,1,81,41521081
27185,26,1805300,4,11,32,1,107,41521107
27186,14,1805300,2,11,32,1,121,41521121
27187,5,1805300,2,11,32,1,126,41521126
27188,161,1805300,5,11,32,1,287,41521287
27189,190,1805300,5,11,32,1,477,41521477
27190,0,1805300,1,11,32,1,477,41521477
27191,22,1805200,1,11,32,1,499,41521499
27192,28,1805200,2,11,32,1,527,41521527
27193,80,1805200,3,11,32,1,607,41521607
27194,106,1805200,1,11,32,1,713,41521713
27195,186,1805200,1,11,32,1,899,41521899
27196,67,1805200,2,11,32,1,966,41521966
27197,0,1805200,12,11,32,1,966,41521966
27198,0,1805200,4,11,32,1,966,41521966
27199,0,1805200,1,11,32,1,966,41521966
27200,0,1805200,1,11,32,1,966,41521966
27201,0,1805200,1,11,32,1,966,41521966
27202,1,1805200,1,11,32,1,967,41521967
27203,0,1805200,1,11,32,1,967,41521967
27204,0,1805200,1,11,32,1,967,41521967
27205,0,1805200,1,11,32,1,967,41521967
27206,0,1805200,3,11,32,1,967,41521967
27207,0,1805200,1,11,32,1,967,41521967
27208,217,1805200,2,11,32,2,184,41522184
27209,121,1805200,2,11,32,2,305,41522305
27210,113,1805200,1,11,32,2,418,41522418
27211,66,1805200,5,11,32,2,484,41522484
27212,1,1805200,2,11,32,2,485,41522485
27213,161,1805300,3,11,32,2,646,41522646
27214,3,1805200,4,11,32,2,649,41522649
27215,22,1805300,1,11,32,2,671,41522671
27216,96,1805400,1,11,32,2,767,41522767
27217,285,1805300,4,11,32,3,52,41523052
27218,104,1805400,3,11,32,3,156,41523156
27219,136,1805300,2,11,32,3,292,41523292
27220,61,1805300,3,11,32,3,353,41523353
27221,135,1805300,1,11,32,3,488,41523488
27223,163,1805300,1,11,32,3,651,41523651
27224,1,1805300,2,11,32,3,652,41523652
27225,121,1805500,1,11,32,3,773,41523773
27226,297,1805500,1,11,32,4,70,41524070
27227,365,1805300,1,11,32,4,435,41524435
27228,867,1805300,1,11,32,5,302,41525302
27229,285,1805200,1,11,32,5,587,41525587
27230,910,1805400,2,11,32,6,497,41526497
27231,39,1805300,1,11,32,6,536,41526536
27232,1042,1805500,14,11,32,7,578,41527578
27233,7,1805400,1,11,32,7,585,41527585
27234,143,1805600,1,11,32,7,728,41527728
27235,314,1805500,1,11,32,8,42,41528042
27236,549,1805400,1,11,32,8,591,41528591
27237,486,1805400,1,11,32,9,77,41529077
27238,40,1805400,1,11,32,9,117,41529117
27239,172,1805400,2,11,32,9,289,41529289
27240,112,1805400,1,11,32,9,401,41529401
27241,1029,1805500,1,11,32,10,430,41530430
27242,1094,1805400,2,11,32,11,524,41531524
27243,90,1805400,1,11,32,11,614,41531614
27244,55,1805400,1,11,32,11,669,41531669
27245,27,1805400,1,11,32,11,696,41531696
27246,36,1805300,2,11,32,11,732,41531732
27247,256,1805500,4,11,32,11,988,41531988
27248,294,1805600,5,11,32,12,282,41532282
27249,146,1805400,1,11,32,12,428,41532428
27250,1,1805400,3,11,32,12,429,41532429
27251,1343,1805400,3,11,32,13,772,41533772
27252,1059,1805400,1,11,32,14,831,41534831
27253,728,1805500,1,11,32,15,559,41535559
27254,0,1805500,3,11,32,15,559,41535559
27255,241,1805500,1,11,32,15,800,41535800
27256,178,1805600,1,11,32,15,978,41535978
27257,1303,1805400,1,11,32,17,281,41537281
27258,732,1805500,1,11,32,18,13,41538013
27259,2596,1805400,3,11,32,20,609,41540609
27260,90,1805400,1,11,32,20,699,41540699
27261,627,1805500,1,11,32,21,326,41541326
27262,1436,1805500,3,11,32,22,762,41542762
27263,3419,1805400,1,11,32,26,181,41546181
27264,1498,1805500,1,11,32,27,679,41547679
27265,804,1805400,1,11,32,28,483,41548483
27266,608,1805500,1,11,32,29,91,41549091
27267,92,1805400,1,11,32,29,183,41549183
27268,179,1805500,2,11,32,29,362,41549362
27269,1256,1805400,1,11,32,30,618,41550618
27270,2830,1805500,2,11,32,33,448,41553448
27271,437,1805400,2,11,32,33,885,41553885
27272,1169,1805500,1,11,32,35,54,41555054
27273,218,1805500,2,11,32,35,272,41555272
27274,1214,1805500,5,11,32,36,486,41556486
27275,412,1805500,1,11,32,36,898,41556898
27276,132,1805400,1,11,32,37,30,41557030
27277,430,1805400,5,11,32,37,460,41557460
27279,929,1805500,2,11,32,38,389,41558389
27280,650,1805500,1,11,32,39,39,41559039
27281,203,1805500,1,11,32,39,242,41559242
27282,158,1805500,1,11,32,39,400,41559400
27283,730,1805500,1,11,32,40,130,41560130
27284,52,1805500,1,11,32,40,182,41560182
27285,894,1805500,3,11,32,41,76,41561076
27286,278,1805600,6,11,32,41,354,41561354
27287,402,1805700,1,11,32,41,756,41561756
27288,145,1805800,1,11,32,41,901,41561901
27289,40,1805600,1,11,32,41,941,41561941
27290,13,1805800,1,11,32,41,954,41561954
27291,28,1805800,1,11,32,41,982,41561982
27292,123,1805800,1,11,32,42,105,41562105
27293,22,1805700,3,11,32,42,127,41562127
27294,152,1805700,1,11,32,42,279,41562279
27295,1129,1805700,1,11,32,43,408,41563408
27296,602,1805900,1,11,32,44,10,41564010
27297,112,1805700,1,11,32,44,122,41564122
27298,217,1805900,1,11,32,44,339,41564339
27299,776,1805900,1,11,32,45,115,41565115
27300,0,1805900,1,11,32,45,115,41565115
27301,0,1805900,1,11,32,45,115,41565115
27302,0,1805900,1,11,32,45,115,41565115
27303,0,1805900,2,11,32,45,115,41565115
27304,999,1805900,1,11,32,46,114,41566114
27305,23,1805800,1,11,32,46,137,41566137
27306,31,1805800,1,11,32,46,168,41566168
27307,51,1805800,1,11,32,46,219,41566219
27308,57,1805800,1,11,32,46,276,41566276
27309,351,1805800,1,11,32,46,627,41566627
27310,791,1805800,1,11,32,47,418,41567418
27311,799,1805800,1,11,32,48,217,41568217
27312,155,1805900,1,11,32,48,372,41568372
27313,370,1805900,2,11,32,48,742,41568742
27314,764,1805800,1,11,32,49,506,41569506
27315,158,1805800,1,11,32,49,664,41569664
27316,1311,1805900,1,11,32,50,975,41570975
27317,1084,1806000,1,11,32,52,59,41572059
27318,168,1806000,1,11,32,52,227,41572227
27319,7,1806000,1,11,32,52,234,41572234
27320,10,1806000,1,11,32,52,244,41572244
27321,179,1805900,1,11,32,52,423,41572423
27322,4952,1805900,1,11,32,57,375,41577375
27323,1521,1805900,1,11,32,58,896,41578896
27324,2548,1805900,2,11,33,1,444,41581444
27325,2,1805900,2,11,33,1,446,41581446
27326,6,1805800,4,11,33,1,452,41581452
27327,347,1805800,2,11,33,1,799,41581799
27328,46,1805800,1,11,33,1,845,41581845
27329,1,1805800,1,11,33,1,846,41581846
27330,116,1805700,1,11,33,1,962,41581962
27331,21,1805700,1,11,33,1,983,41581983
27332,478,1805800,1,11,33,2,461,41582461
27333,123,1805700,1,11,33,2,584,41582584
27334,586,1805900,2,11,33,3,170,41583170
27335,404,1805700,1,11,33,3,574,41583574
27336,1324,1805900,1,11,33,4,898,41584898
27337,918,1805800,1,11,33,5,816,41585816
27338,482,1805900,2,11,33,6,298,41586298
27339,1,1805900,1,11,33,6,299,41586299
27340,0,1806000,16,11,33,6,299,41586299
27341,84,1806100,1,11,33,6,383,41586383
27342,438,1806100,1,11,33,6,821,41586821
27343,54,1806100,1,11,33,6,875,41586875
27344,199,1805900,1,11,33,7,74,41587074
27345,1157,1806000,1,11,33,8,231,41588231
27346,725,1806000,1,11,33,8,956,41588956
27348,350,1806100,1,11,33,9,306,41589306
27349,394,1806100,1,11,33,9,700,41589700
27350,2207,1806000,1,11,33,11,907,41591907
27351,91,1806000,1,11,33,11,998,41591998
27352,742,1806100,6,11,33,12,740,41592740
27353,629,1806000,1,11,33,13,369,41593369
27354,272,1806000,1,11,33,13,641,41593641
27355,85,1806100,1,11,33,13,726,41593726
27356,6420,1806000,1,11,33,20,146,41600146
27357,1814,1806100,1,11,33,21,960,41601960
27358,3865,1806000,1,11,33,25,825,41605825
27359,296,1806100,2,11,33,26,121,41606121
27360,1118,1806100,1,11,33,27,239,41607239
27361,0,1806100,3,11,33,27,239,41607239
27362,748,1806000,1,11,33,27,987,41607987
27363,36,1806100,1,11,33,28,23,41608023
27364,1625,1806100,1,11,33,29,648,41609648
27366,968,1806100,1,11,33,30,616,41610616
27368,2833,1806100,2,11,33,33,449,41613449
27370,1619,1806100,1,11,33,35,68,41615068
27371,1115,1806000,1,11,33,36,183,41616183
27372,726,1806000,1,11,33,36,909,41616909
27373,1814,1805900,1,11,33,38,723,41618723
27374,987,1806000,1,11,33,39,710,41619710
27375,6400,1806000,1,11,33,46,110,41626110
27376,2109,1806000,1,11,33,48,219,41628219
27377,694,1806000,1,11,33,48,913,41628913
27378,2172,1806000,4,11,33,51,85,41631085
27379,223,1806100,1,11,33,51,308,41631308
27380,192,1806000,1,11,33,51,500,41631500
27381,408,1806000,1,11,33,51,908,41631908
27382,1713,1806100,1,11,33,53,621,41633621
27383,2372,1806000,2,11,33,55,993,41635993
27384,2,1806000,1,11,33,55,995,41635995
27385,2303,1806000,2,11,33,58,298,41638298
27386,202,1806000,1,11,33,58,500,41638500
27387,1239,1806000,1,11,33,59,739,41639739
27388,614,1806000,3,11,34,0,353,41640353
27389,2085,1806100,4,11,34,2,438,41642438
27390,619,1806000,1,11,34,3,57,41643057
27391,40,1806000,2,11,34,3,97,41643097
27393,1330,1806000,1,11,34,4,427,41644427
27394,693,1806100,2,11,34,5,120,41645120
27395,2,1806200,2,11,34,5,122,41645122
27396,425,1806100,1,11,34,5,547,41645547
27397,0,1806200,9,11,34,5,547,41645547
27398,901,1806300,1,11,34,6,448,41646448
27399,738,1806300,1,11,34,7,186,41647186
27400,917,1806300,1,11,34,8,103,41648103
27401,1333,1806300,1,11,34,9,436,41649436
27402,11,1806300,1,11,34,9,447,41649447
27403,321,1806300,1,11,34,9,768,41649768
27404,2831,1806300,9,11,34,12,599,41652599
27405,1337,1806400,3,11,34,13,936,41653936
27406,79,1806400,1,11,34,14,15,41654015
27407,10,1806500,1,11,34,14,25,41654025
27408,12,1806500,1,11,34,14,37,41654037
27409,77,1806500,2,11,34,14,114,41654114
27410,106,1806500,1,11,34,14,220,41654220
27411,1538,1806500,1,11,34,15,758,41655758
27412,928,1806500,1,11,34,16,686,41656686
27413,876,1806400,1,11,34,17,562,41657562
27414,550,1806500,3,11,34,18,112,41658112
27415,735,1806400,2,11,34,18,847,41658847
27417,1894,1806500,2,11,34,20,741,41660741
27418,1227,1806500,1,11,34,21,968,41661968
27419,5289,1806400,1,11,34,27,257,41667257
27420,664,1806400,1,11,34,27,921,41667921
27421,2,1806400,3,11,34,27,923,41667923
27422,1450,1806300,1,11,34,29,373,41669373
27423,437,1806400,1,11,34,29,810,41669810
27424,380,1806200,1,11,34,30,190,41670190
27425,189,1806400,2,11,34,30,379,41670379
27426,1064,1806400,2,11,34,31,443,41671443
27427,1241,1806400,1,11,34,32,684,41672684
27428,1543,1806200,1,11,34,34,227,41674227
27429,194,1806300,1,11,34,34,421,41674421
27430,1663,1806400,11,11,34,36,84,41676084
27431,44,1806500,1,11,34,36,128,41676128
27432,2187,1806400,4,11,34,38,315,41678315
27434,1614,1806400,1,11,34,39,929,41679929
27435,1123,1806400,1,11,34,41,52,41681052
27436,1080,1806400,1,11,34,42,132,41682132
27437,73,1806400,1,11,34,42,205,41682205
27438,844,1806400,1,11,34,43,49,41683049
27439,348,1806300,1,11,34,43,397,41683397
27440,3934,1806300,1,11,34,47,331,41687331
27441,957,1806400,1,11,34,48,288,41688288
27442,2518,1806300,2,11,34,50,806,41690806
27443,1,1806300,1,11,34,50,807,41690807
27444,1578,1806400,1,11,34,52,385,41692385
27445,890,1806300,1,11,34,53,275,41693275
27446,1252,1806400,1,11,34,54,527,41694527
27447,894,1806400,7,11,34,55,421,41695421
27448,429,1806400,2,11,34,55,850,41695850
27449,28,1806400,1,11,34,55,878,41695878
27450,1598,1806400,2,11,34,57,476,41697476
27451,242,1806400,1,11,34,57,718,41697718
27452,578,1806400,1,11,34,58,296,41698296
27453,923,1806400,1,11,34,59,219,41699219
27454,129,1806300,2,11,34,59,348,41699348
27455,2,1806300,2,11,34,59,350,41699350
27456,0,1806300,2,11,34,59,350,41699350
27457,3093,1806300,1,11,35,2,443,41702443
27458,223,1806400,2,11,35,2,666,41702666
27459,984,1806400,1,11,35,3,650,41703650
27460,1777,1806300,1,11,35,5,427,41705427
27461,2800,1806400,2,11,35,8,227,41708227
27462,1013,1806400,1,11,35,9,240,41709240
27463,9,1806500,25,11,35,9,249,41709249
27464,847,1806500,1,11,35,10,96,41710096
27465,1032,1806600,1,11,35,11,128,41711128
27466,1535,1806500,3,11,35,12,663,41712663
27467,573,1806500,1,11,35,13,236,41713236
27468,532,1806600,6,11,35,13,768,41713768
27469,48,1806500,1,11,35,13,816,41713816
27470,70,1806500,1,11,35,13,886,41713886
27471,1439,1806400,3,11,35,15,325,41715325
27472,4352,1806400,1,11,35,19,677,41719677
27473,6159,1806500,1,11,35,25,836,41725836
27474,1107,1806600,2,11,35,26,943,41726943
27475,878,1806400,1,11,35,27,821,41727821
27476,1105,1806500,1,11,35,28,926,41728926
27477,1320,1806500,1,11,35,30,246,41730246
27478,1026,1806500,1,11,35,31,272,41731272
27479,1316,1806600,1,11,35,32,588,41732588
27480,139,1806500,1,11,35,32,727,41732727
27481,4637,1806600,2,11,35,37,364,41737364
27482,20,1806500,1,11,35,37,384,41737384
27483,172,1806600,5,11,35,37,556,41737556
27484,2248,1806600,2,11,35,39,804,41739804
27485,591,1806600,1,11,35,40,395,41740395
27486,420,1806600,2,11,35,40,815,41740815
27487,181,1806600,1,11,35,40,996,41740996
27488,1668,1806600,1,11,35,42,664,41742664
27489,501,1806500,1,11,35,43,165,41743165
27490,1244,1806600,1,11,35,44,409,41744409
27491,519,1806600,1,11,35,44,928,41744928
27492,1631,1806500,5,11,35,46,559,41746559
27494,4097,1806600,1,11,35,50,656,41750656
27495,1438,1806500,1,11,35,52,94,41752094
27496,293,1806600,2,11,35,52,387,41752387
27497,507,1806600,1,11,35,52,894,41752894
27498,184,1806600,1,11,35,53,78,41753078
27499,1328,1806700,1,11,35,54,406,41754406
27500,96,1806700,2,11,35,54,502,41754502
27501,5,1806600,1,11,35,54,507,41754507
27503,3755,1806600,1,11,35,58,262,41758262
27504,94,1806600,1,11,35,58,356,41758356
27505,1853,1806600,1,11,36,0,209,41760209
27506,2237,1806600,1,11,36,2,446,41762446
27507,813,1806700,1,11,36,3,259,41763259
27508,219,1806600,1,11,36,3,478,41763478
27509,3525,1806600,1,11,36,7,3,41767003
27510,636,1806700,1,11,36,7,639,41767639
27511,152,1806600,1,11,36,7,791,41767791
27512,846,1806600,1,11,36,8,637,41768637
27513,764,1806600,1,11,36,9,401,41769401
27514,1787,1806700,3,11,36,11,188,41771188
27515,0,1806700,3,11,36,11,188,41771188
27516,1,1806700,1,11,36,11,189,41771189
27517,583,1806700,1,11,36,11,772,41771772
27518,49,1806700,1,11,36,11,821,41771821
27519,697,1806800,1,11,36,12,518,41772518
27520,114,1806800,1,11,36,12,632,41772632
27521,246,1806800,3,11,36,12,878,41772878
27522,712,1806700,1,11,36,13,590,41773590
27523,274,1806800,7,11,36,13,864,41773864
27525,1786,1806800,1,11,36,15,650,41775650
27526,109,1806900,2,11,36,15,759,41775759
27527,20,1806900,1,11,36,15,779,41775779
27528,77,1806800,1,11,36,15,856,41775856
27529,223,1806900,1,11,36,16,79,41776079
27530,0,1806900,3,11,36,16,79,41776079
27531,0,1806900,1,11,36,16,79,41776079
27532,1,1806900,2,11,36,16,80,41776080
27533,40,1806900,1,11,36,16,120,41776120
27534,438,1807000,1,11,36,16,558,41776558
27535,285,1807000,1,11,36,16,843,41776843
27536,389,1807000,1,11,36,17,232,41777232
27537,1662,1807000,1,11,36,18,894,41778894
27538,841,1806900,1,11,36,19,735,41779735
27539,345,1806900,1,11,36,20,80,41780080
27540,135,1806900,3,11,36,20,215,41780215
27541,26,1806800,1,11,36,20,241,41780241
27542,3107,1806900,1,11,36,23,348,41783348
27543,1879,1806900,1,11,36,25,227,41785227
27544,616,1806900,1,11,36,25,843,41785843
27545,351,1806900,1,11,36,26,194,41786194
27546,1211,1806900,1,11,36,27,405,41787405
27547,1917,1806900,1,11,36,29,322,41789322
27548,379,1807000,2,11,36,29,701,41789701
27549,360,1806900,1,11,36,30,61,41790061
27550,948,1806900,2,11,36,31,9,41791009
27551,2012,1807000,1,11,36,33,21,41793021
27552,0,1807000,1,11,36,33,21,41793021
27553,1948,1807000,1,11,36,34,969,41794969
27554,1083,1807000,1,11,36,36,52,41796052
27555,2234,1807000,2,11,36,38,286,41798286
27556,451,1807000,1,11,36,38,737,41798737
27557,1781,1807000,2,11,36,40,518,41800518
27558,2093,1806900,1,11,36,42,611,41802611
27559,222,1807000,1,11,36,42,833,41802833
27560,1057,1807000,1,11,36,43,890,41803890
27561,3030,1807000,1,11,36,46,920,41806920
27562,2742,1807000,1,11,36,49,662,41809662
27563,703,1806900,5,11,36,50,365,41810365
27564,0,1806900,2,11,36,50,365,41810365
27565,162,1806800,13,11,36,50,527,41810527
27566,194,1806800,1,11,36,50,721,41810721
27567,1583,1806900,2,11,36,52,304,41812304
27568,514,1806700,1,11,36,52,818,41812818
27569,50,1806700,1,11,36,52,868,41812868
27570,99,1806800,1,11,36,52,967,41812967
27571,39,1806800,1,11,36,53,6,41813006
27572,973,1806900,1,11,36,53,979,41813979
27573,862,1806900,1,11,36,54,841,41814841
27574,3328,1806900,1,11,36,58,169,41818169
27575,1,1806900,1,11,36,58,170,41818170
27576,1503,1806900,1,11,36,59,673,41819673
27577,3181,1806900,1,11,37,2,854,41822854
27578,366,1806900,1,11,37,3,220,41823220
27579,1521,1806800,1,11,37,4,741,41824741
27580,33,1806800,1,11,37,4,774,41824774
27581,1,1806800,1,11,37,4,775,41824775
27582,1438,1806900,4,11,37,6,213,41826213
27583,1,1806900,1,11,37,6,214,41826214
27584,4322,1806800,1,11,37,10,536,41830536
27585,147,1806800,1,11,37,10,683,41830683
27586,0,1806800,3,11,37,10,683,41830683
27587,0,1806800,1,11,37,10,683,41830683
27588,3145,1806700,2,11,37,13,828,41833828
27590,2584,1806600,1,11,37,16,412,41836412
27591,896,1806600,3,11,37,17,308,41837308
27592,1040,1806600,2,11,37,18,348,41838348
27593,0,1806600,1,11,37,18,348,41838348
27594,996,1806700,4,11,37,19,344,41839344
27595,784,1806600,1,11,37,20,128,41840128
27596,1508,1806600,1,11,37,21,636,41841636
27597,3641,1806700,1,11,37,25,277,41845277
27598,4629,1806700,2,11,37,29,906,41849906
27599,9317,1806700,3,11,37,39,223,41859223
27600,1,1806700,2,11,37,39,224,41859224
27601,4564,1806700,2,11,37,43,788,41863788
27602,10230,1806600,3,11,37,54,18,41874018
27603,87,1806600,1,11,37,54,105,41874105
27604,250,1806600,1,11,37,54,355,41874355
27605,256,1806600,2,11,37,54,611,41874611
27606,52,1806600,1,11,37,54,663,41874663
27607,531,1806600,6,11,37,55,194,41875194
27608,0,1806600,1,11,37,55,194,41875194
27609,5049,1806500,6,11,38,0,243,41880243
27610,784,1806500,1,11,38,1,27,41881027
27611,245,1806500,5,11,38,1,272,41881272
27612,0,1806500,2,11,38,1,272,41881272
27613,0,1806500,1,11,38,1,272,41881272
27614,0,1806500,1,11,38,1,272,41881272
27615,1,1806500,1,11,38,1,273,41881273
27616,0,1806500,1,11,38,1,273,41881273
27617,1,1806500,6,11,38,1,274,41881274
27618,54,1806500,1,11,38,1,328,41881328
27619,91,1806600,4,11,38,1,419,41881419
27620,1018,1806600,4,11,38,2,437,41882437
27621,1,1806600,1,11,38,2,438,41882438
27622,200,1806500,1,11,38,2,638,41882638
27623,809,1806700,6,11,38,3,447,41883447
27624,2,1806700,2,11,38,3,449,41883449
27625,603,1806600,1,11,38,4,52,41884052
27626,417,1806700,3,11,38,4,469,41884469
27627,1476,1806500,1,11,38,5,945,41885945
27628,162,1806500,1,11,38,6,107,41886107
27629,386,1806600,1,11,38,6,493,41886493
27631,3394,1806600,4,11,38,9,887,41889887
27632,1010,1806600,3,11,38,10,897,41890897
27633,2161,1806600,4,11,38,13,58,41893058
27634,8630,1806500,1,11,38,21,688,41901688
27635,1952,1806400,1,11,38,23,640,41903640
27636,0,1806400,5,11,38,23,640,41903640
27637,180,1806300,1,11,38,23,820,41903820
27638,749,1806300,1,11,38,24,569,41904569
27639,155,1806300,1,11,38,24,724,41904724
27640,305,1806500,1,11,38,25,29,41905029
27641,25,1806500,1,11,38,25,54,41905054
27642,487,1806400,2,11,38,25,541,41905541
27643,4365,1806400,2,11,38,29,906,41909906
27644,103,1806400,2,11,38,30,9,41910009
27645,2412,1806400,1,11,38,32,421,41912421
27646,9077,1806500,2,11,38,41,498,41921498
27647,543,1806400,1,11,38,42,41,41922041
27648,3323,1806400,1,11,38,45,364,41925364
27649,1359,1806400,1,11,38,46,723,41926723
27650,1378,1806300,3,11,38,48,101,41928101
27651,3662,1806200,1,11,38,51,763,41931763
27652,1516,1806200,2,11,38,53,279,41933279
27653,516,1806200,1,11,38,53,795,41933795
27654,0,1806200,8,11,38,53,795,41933795
27655,0,1806200,1,11,38,53,795,41933795
27656,0,1806200,8,11,38,53,795,41933795
27657,0,1806200,2,11,38,53,795,41933795
27658,117,1806200,2,11,38,53,912,41933912
27659,6820,1806100,6,11,39,0,732,41940732
27660,1030,1806000,1,11,39,1,762,41941762
27661,65,1806000,1,11,39,1,827,41941827
27662,94,1806200,1,11,39,1,921,41941921
27663,751,1806200,1,11,39,2,672,41942672
27664,1139,1806200,1,11,39,3,811,41943811
27665,1974,1806200,2,11,39,5,785,41945785
27666,0,1806200,1,11,39,5,785,41945785
27667,1,1806200,3,11,39,5,786,41945786
27668,1365,1806200,1,11,39,7,151,41947151
27669,1884,1806200,1,11,39,9,35,41949035
27670,2116,1806100,1,11,39,11,151,41951151
27671,1080,1806200,1,11,39,12,231,41952231
27672,563,1806100,4,11,39,12,794,41952794
27673,1168,1806200,1,11,39,13,962,41953962
27674,89,1806200,1,11,39,14,51,41954051
27675,42,1806200,1,11,39,14,93,41954093
27676,3965,1806300,4,11,39,18,58,41958058
27677,2050,1806400,3,11,39,20,108,41960108
27678,2,1806400,1,11,39,20,110,41960110
27679,531,1806400,3,11,39,20,641,41960641
27680,2642,1806400,3,11,39,23,283,41963283
27681,1005,1806300,11,11,39,24,288,41964288
27682,1,1806300,1,11,39,24,289,41964289
27683,0,1806300,1,11,39,24,289,41964289
27684,2761,1806200,3,11,39,27,50,41967050
27685,146,1806300,1,11,39,27,196,41967196
27686,338,1806200,1,11,39,27,534,41967534
27687,1520,1806200,1,11,39,29,54,41969054
27688,331,1806300,1,11,39,29,385,41969385
27689,1121,1806400,1,11,39,30,506,41970506
27690,97,1806400,1,11,39,30,603,41970603
27691,17,1806400,1,11,39,30,620,41970620
27692,185,1806300,1,11,39,30,805,41970805
27693,5,1806300,1,11,39,30,810,41970810
27694,3319,1806300,1,11,39,34,129,41974129
27695,113,1806300,1,11,39,34,242,41974242
27696,170,1806300,1,11,39,34,412,41974412
27697,381,1806300,1,11,39,34,793,41974793
27698,1769,1806200,1,11,39,36,562,41976562
27699,1272,1806200,1,11,39,37,834,41977834
27700,209,1806300,2,11,39,38,43,41978043
27701,697,1806300,1,11,39,38,740,41978740
27702,102,1806300,1,11,39,38,842,41978842
27703,362,1806300,1,11,39,39,204,41979204
27704,126,1806300,1,11,39,39,330,41979330
27706,1769,1806200,1,11,39,41,99,41981099
27707,1239,1806200,1,11,39,42,338,41982338
27708,505,1806200,1,11,39,42,843,41982843
27709,348,1806300,1,11,39,43,191,41983191
27710,5485,1806200,6,11,39,48,676,41988676
27711,1501,1806200,1,11,39,50,177,41990177
27712,66,1806300,1,11,39,50,243,41990243
27713,1416,1806200,1,11,39,51,659,41991659
27714,281,1806300,1,11,39,51,940,41991940
27715,524,1806400,1,11,39,52,464,41992464
27716,60,1806300,1,11,39,52,524,41992524
27717,411,1806300,1,11,39,52,935,41992935
27718,126,1806400,1,11,39,53,61,41993061
27719,853,1806300,1,11,39,53,914,41993914
27720,496,1806300,1,11,39,54,410,41994410
27721,4171,1806300,3,11,39,58,581,41998581
27722,1,1806300,7,11,39,58,582,41998582
27723,2874,1806300,1,11,40,1,456,42001456
27724,578,1806300,1,11,40,2,34,42002034
27725,782,1806300,1,11,40,2,816,42002816
27726,988,1806300,1,11,40,3,804,42003804
27727,1,1806300,1,11,40,3,805,42003805
27728,341,1806300,1,11,40,4,146,42004146
27729,1172,1806300,2,11,40,5,318,42005318
27730,347,1806300,1,11,40,5,665,42005665
27731,450,1806300,1,11,40,6,115,42006115
27732,603,1806300,1,11,40,6,718,42006718
27733,323,1806300,1,11,40,7,41,42007041
27734,3194,1806200,1,11,40,10,235,42010235
27735,63,1806300,2,11,40,10,298,42010298
27736,2239,1806200,1,11,40,12,537,42012537
27737,576,1806200,1,11,40,13,113,42013113
27738,290,1806200,1,11,40,13,403,42013403
27739,407,1806200,1,11,40,13,810,42013810
27740,1219,1806200,1,11,40,15,29,42015029
27741,4457,1806300,7,11,40,19,486,42019486
27742,1051,1806400,6,11,40,20,537,42020537
27743,730,1806300,1,11,40,21,267,42021267
27744,709,1806300,1,11,40,21,976,42021976
27745,2111,1806300,1,11,40,24,87,42024087
27746,5386,1806300,2,11,40,29,473,42029473
27747,802,1806400,2,11,40,30,275,42030275
27748,269,1806300,1,11,40,30,544,42030544
27750,3856,1806200,1,11,40,34,400,42034400
27751,1669,1806200,1,11,40,36,69,42036069
27752,3412,1806200,1,11,40,39,481,42039481
27753,816,1806200,1,11,40,40,297,42040297
27754,510,1806200,1,11,40,40,807,42040807
27755,81,1806200,1,11,40,40,888,42040888
27756,2668,1806200,1,11,40,43,556,42043556
27757,4520,1806200,1,11,40,48,76,42048076
27758,2398,1806200,1,11,40,50,474,42050474
27759,10872,1806300,1,11,41,1,346,42061346
27760,8100,1806300,7,11,41,9,446,42069446
27761,1,1806300,1,11,41,9,447,42069447
27762,1068,1806300,1,11,41,10,515,42070515
27763,3018,1806200,25,11,41,13,533,42073533
27764,2123,1806100,1,11,41,15,656,42075656
27765,874,1806200,4,11,41,16,530,42076530
27766,138,1806100,1,11,41,16,668,42076668
27767,1125,1806200,1,11,41,17,793,42077793
27768,1986,1806200,1,11,41,19,779,42079779
27769,1106,1806200,1,11,41,20,885,42080885
27770,170,1806200,1,11,41,21,55,42081055
27771,0,1806200,1,11,41,21,55,42081055
27772,3134,1806200,1,11,41,24,189,42084189
27773,1589,1806200,3,11,41,25,778,42085778
27774,272,1806200,1,11,41,26,50,42086050
27775,5583,1806200,1,11,41,31,633,42091633
27776,7136,1806200,2,11,41,38,769,42098769
27777,0,1806200,1,11,41,38,769,42098769
27778,0,1806200,4,11,41,38,769,42098769
27779,1,1806200,1,11,41,38,770,42098770
27780,0,1806200,2,11,41,38,770,42098770
27781,0,1806200,1,11,41,38,770,42098770
27782,0,1806200,1,11,41,38,770,42098770
27783,77,1806200,2,11,41,38,847,42098847
27784,47,1806200,1,11,41,38,894,42098894
27785,26,1806200,1,11,41,38,920,42098920
27786,20,1806200,3,11,41,38,940,42098940
27787,1980,1806100,1,11,41,40,920,42100920
27788,454,1806200,1,11,41,41,374,42101374
27789,558,1806100,3,11,41,41,932,42101932
27790,2322,1806100,1,11,41,44,254,42104254
27791,523,1806100,1,11,41,44,777,42104777
27792,5079,1806200,2,11,41,49,856,42109856
27793,358,1806100,1,11,41,50,214,42110214
27794,4177,1806100,1,11,41,54,391,42114391
27795,1789,1806100,1,11,41,56,180,42116180
27796,1359,1806200,1,11,41,57,539,42117539
27797,49,1806200,1,11,41,57,588,42117588
27798,585,1806100,1,11,41,58,173,42118173
27799,2869,1806100,1,11,42,1,42,42121042
27800,826,1806100,1,11,42,1,868,42121868
27801,2299,1806100,1,11,42,4,167,42124167
27802,2005,1806100,1,11,42,6,172,42126172
27803,1990,1806100,1,11,42,8,162,42128162
27804,549,1806100,1,11,42,8,711,42128711
27805,202,1806100,1,11,42,8,913,42128913
27806,1258,1806100,1,11,42,10,171,42130171
27807,1041,1806200,1,11,42,11,212,42131212
27808,965,1806100,1,11,42,12,177,42132177
27809,428,1806100,1,11,42,12,605,42132605
27810,1575,1806100,1,11,42,14,180,42134180
27811,1775,1806200,2,11,42,15,955,42135955
27812,217,1806100,1,11,42,16,172,42136172
27813,505,1806200,1,11,42,16,677,42136677
27814,3909,1806200,1,11,42,20,586,42140586
27815,2121,1806200,2,11,42,22,707,42142707
27816,0,1806200,1,11,42,22,707,42142707
27817,0,1806200,2,11,42,22,707,42142707
27818,0,1806200,2,11,42,22,707,42142707
27819,0,1806200,8,11,42,22,707,42142707
27820,2,1806200,1,11,42,22,709,42142709
27821,100,1806200,2,11,42,22,809,42142809
27822,3816,1806200,1,11,42,26,625,42146625
27823,3202,1806300,2,11,42,29,827,42149827
27824,1162,1806300,2,11,42,30,989,42150989
27825,0,1806300,8,11,42,30,989,42150989
27826,1,1806300,1,11,42,30,990,42150990
27827,0,1806300,2,11,42,30,990,42150990
27828,0,1806300,6,11,42,30,990,42150990
27829,148,1806300,1,11,42,31,138,42151138
27830,741,1806300,1,11,42,31,879,42151879
27831,130,1806300,1,11,42,32,9,42152009
27832,6493,1806400,1,11,42,38,502,42158502
27833,553,1806400,3,11,42,39,55,42159055
27834,2061,1806400,4,11,42,41,116,42161116
27835,0,1806400,5,11,42,41,116,42161116
27836,56,1806400,2,11,42,41,172,42161172
27837,0,1806400,1,11,42,41,172,42161172
27838,0,1806400,1,11,42,41,172,42161172
27839,2677,1806400,1,11,42,43,849,42163849
27840,163,1806400,1,11,42,44,12,42164012
27841,271,1806500,3,11,42,44,283,42164283
27842,85,1806500,1,11,42,44,368,42164368
27843,10638,1806500,26,11,42,55,6,42175006
27844,1473,1806600,20,11,42,56,479,42176479
27845,1,1806700,1,11,42,56,480,42176480
27846,0,1806700,7,11,42,56,480,42176480
27847,58,1806700,1,11,42,56,538,42176538
27848,52,1806700,1,11,42,56,590,42176590
27849,1,1806700,1,11,42,56,591,42176591
27850,1528,1806800,1,11,42,58,119,42178119
27851,1099,1806800,1,11,42,59,218,42179218
27852,46,1806800,1,11,42,59,264,42179264
27853,202,1806700,1,11,42,59,466,42179466
27854,2796,1806700,1,11,43,2,262,42182262
27855,155,1806700,1,11,43,2,417,42182417
27856,279,1806800,2,11,43,2,696,42182696
27857,173,1806700,1,11,43,2,869,42182869
27858,2016,1806700,1,11,43,4,885,42184885
27859,4866,1806800,2,11,43,9,751,42189751
27860,1317,1806800,1,11,43,11,68,42191068
27861,969,1806800,1,11,43,12,37,42192037
27862,691,1806700,3,11,43,12,728,42192728
27863,2004,1806800,1,11,43,14,732,42194732
27864,966,1806800,1,11,43,15,698,42195698
27865,1002,1806800,1,11,43,16,700,42196700
27866,0,1806900,10,11,43,16,700,42196700
27867,70,1807000,1,11,43,16,770,42196770
27868,24,1807000,3,11,43,16,794,42196794
27869,20,1807000,1,11,43,16,814,42196814
27870,249,1807000,1,11,43,17,63,42197063
27871,51,1807000,1,11,43,17,114,42197114
27872,1422,1806900,2,11,43,18,536,42198536
27873,465,1806900,1,11,43,19,1,42199001
27875,677,1806800,1,11,43,19,678,42199678
27876,13,1807000,1,11,43,19,691,42199691
27877,1591,1806900,3,11,43,21,282,42201282
27878,53,1806900,1,11,43,21,335,42201335
27879,264,1806900,1,11,43,21,599,42201599
27880,488,1807000,1,11,43,22,87,42202087
27881,1288,1806900,1,11,43,23,375,42203375
27882,440,1807000,1,11,43,23,815,42203815
27883,711,1806900,1,11,43,24,526,42204526
27884,2852,1806800,7,11,43,27,378,42207378
27885,9,1806700,4,11,43,27,387,42207387
27886,0,1806700,1,11,43,27,387,42207387
27887,1533,1806600,6,11,43,28,920,42208920
27888,1,1806600,3,11,43,28,921,42208921
27889,103,1806700,2,11,43,29,24,42209024
27890,795,1806600,1,11,43,29,819,42209819
27891,740,1806600,1,11,43,30,559,42210559
27892,5198,1806700,1,11,43,35,757,42215757
27893,3093,1806600,1,11,43,38,850,42218850
27894,0,1806600,1,11,43,38,850,42218850
27895,0,1806600,6,11,43,38,850,42218850
27896,33,1806600,1,11,43,38,883,42218883
27897,534,1806600,4,11,43,39,417,42219417
27898,2746,1806500,1,11,43,42,163,42222163
27899,9877,1806500,6,11,43,52,40,42232040
27900,1,1806500,3,11,43,52,41,42232041
27901,0,1806500,2,11,43,52,41,42232041
27902,0,1806500,1,11,43,52,41,42232041
27903,1611,1806300,2,11,43,53,652,42233652
27904,1714,1806400,1,11,43,55,366,42235366
27905,1115,1806500,1,11,43,56,481,42236481
27906,262,1806400,1,11,43,56,743,42236743
27907,5065,1806400,1,11,44,1,808,42241808
27908,0,1806400,5,11,44,1,808,42241808
27909,1,1806400,1,11,44,1,809,42241809
27910,1962,1806300,2,11,44,3,771,42243771
27911,2982,1806200,3,11,44,6,753,42246753
27912,5024,1806200,2,11,44,11,777,42251777
27913,1249,1806200,1,11,44,13,26,42253026
27914,108,1806200,4,11,44,13,134,42253134
27915,1717,1806200,1,11,44,14,851,42254851
27916,2125,1806100,2,11,44,16,976,42256976
27917,5567,1806200,7,11,44,22,543,42262543
27919,1,1806400,1,11,44,22,544,42262544
27920,0,1806400,4,11,44,22,544,42262544
27921,1,1806400,1,11,44,22,545,42262545
27922,0,1806400,2,11,44,22,545,42262545
27923,0,1806400,1,11,44,22,545,42262545
27924,0,1806300,1,11,44,22,545,42262545
27925,0,1806400,2,11,44,22,545,42262545
27926,1,1806300,1,11,44,22,546,42262546
27927,1,1806400,3,11,44,22,547,42262547
27928,0,1806400,1,11,44,22,547,42262547
27929,121,1806400,1,11,44,22,668,42262668
27930,169,1806400,1,11,44,22,837,42262837
27931,372,1806500,1,11,44,23,209,42263209
27932,2971,1806500,1,11,44,26,180,42266180
27933,2172,1806500,1,11,44,28,352,42268352
27934,467,1806500,1,11,44,28,819,42268819
27935,1426,1806500,1,11,44,30,245,42270245
27936,1739,1806400,1,11,44,31,984,42271984
27937,2217,1806400,1,11,44,34,201,42274201
27938,405,1806400,2,11,44,34,606,42274606
27939,2558,1806500,1,11,44,37,164,42277164
27940,1026,1806500,1,11,44,38,190,42278190
27941,0,1806500,1,11,44,38,190,42278190
27942,851,1806500,1,11,44,39,41,42279041
27943,3823,1806500,1,11,44,42,864,42282864
27944,6747,1806400,1,11,44,49,611,42289611
27945,721,1806500,5,11,44,50,332,42290332
27946,146,1806500,2,11,44,50,478,42290478
27947,2065,1806500,1,11,44,52,543,42292543
27948,637,1806600,1,11,44,53,180,42293180
27949,780,1806500,1,11,44,53,960,42293960
27950,88,1806500,6,11,44,54,48,42294048
27951,1507,1806500,1,11,44,55,555,42295555
27952,1391,1806500,1,11,44,56,946,42296946
27953,3765,1806400,1,11,45,0,711,42300711
27954,452,1806400,1,11,45,1,163,42301163
27955,119,1806400,1,11,45,1,282,42301282
27956,140,1806500,1,11,45,1,422,42301422
27958,216,1806500,1,11,45,1,638,42301638
27959,0,1806400,14,11,45,1,638,42301638
27960,57,1806500,1,11,45,1,695,42301695
27961,715,1806300,2,11,45,2,410,42302410
27962,5,1806300,2,11,45,2,415,42302415
27963,188,1806500,1,11,45,2,603,42302603
27964,118,1806500,1,11,45,2,721,42302721
27965,64,1806500,3,11,45,2,785,42302785
27966,0,1806500,3,11,45,2,785,42302785
27968,2,1806500,1,11,45,2,787,42302787
27969,46,1806700,1,11,45,2,833,42302833
27970,79,1806600,1,11,45,2,912,42302912
27971,59,1806700,9,11,45,2,971,42302971
27972,941,1806500,1,11,45,3,912,42303912
27973,1279,1806600,1,11,45,5,191,42305191
27974,2908,1806600,1,11,45,8,99,42308099
27975,1284,1806400,3,11,45,9,383,42309383
27976,530,1806300,4,11,45,9,913,42309913
27977,547,1806500,1,11,45,10,460,42310460
27978,389,1806500,1,11,45,10,849,42310849
27979,6703,1806400,1,11,45,17,552,42317552
27980,209,1806400,2,11,45,17,761,42317761
27981,3621,1806400,3,11,45,21,382,42321382
27982,72,1806400,1,11,45,21,454,42321454
27983,1250,1806400,1,11,45,22,704,42322704
27984,1923,1806300,2,11,45,24,627,42324627
27985,1287,1806300,2,11,45,25,914,42325914
27986,9193,1806400,1,11,45,35,107,42335107
27987,1700,1806300,1,11,45,36,807,42336807
27988,6239,1806300,48,11,45,43,46,42343046
27989,1,1806300,4,11,45,43,47,42343047
27990,0,1806300,4,11,45,43,47,42343047
27991,0,1806300,1,11,45,43,47,42343047
27992,0,1806300,1,11,45,43,47,42343047
27993,1,1806300,1,11,45,43,48,42343048
27994,0,1806300,95,11,45,43,48,42343048
27995,0,1806300,1,11,45,43,48,42343048
27996,0,1806300,3,11,45,43,48,42343048
27997,1,1806200,1,11,45,43,49,42343049
27998,1,1806200,5,11,45,43,50,42343050
27999,40,1806100,1,11,45,43,90,42343090
28000,356,1806200,1,11,45,43,446,42343446
28001,3844,1806100,1,11,45,47,290,42347290
28002,694,1806100,9,11,45,47,984,42347984
28003,1444,1806000,1,11,45,49,428,42349428
28004,0,1806000,16,11,45,49,428,42349428
28005,2,1805900,6,11,45,49,430,42349430
28006,1,1805900,1,11,45,49,431,42349431
28007,0,1805900,2,11,45,49,431,42349431
28008,50,1805800,4,11,45,49,481,42349481
28009,122,1805800,3,11,45,49,603,42349603
28010,25,1805800,1,11,45,49,628,42349628
28011,105,1805800,1,11,45,49,733,42349733
28012,36,1805800,1,11,45,49,769,42349769
28013,148,1805900,1,11,45,49,917,42349917
28014,3863,1805800,2,11,45,53,780,42353780
28015,886,1805800,1,11,45,54,666,42354666
28016,60,1805900,16,11,45,54,726,42354726
28017,0,1805900,16,11,45,54,726,42354726
28019,3,1806100,2,11,45,54,729,42354729
28020,0,1806100,1,11,45,54,729,42354729
28021,0,1806100,2,11,45,54,729,42354729
28022,679,1806000,9,11,45,55,408,42355408
28023,461,1806000,2,11,45,55,869,42355869
28025,1347,1806000,3,11,45,57,216,42357216
28027,720,1806000,1,11,45,57,936,42357936
28028,1796,1806100,2,11,45,59,732,42359732
28029,596,1806100,3,11,46,0,328,42360328
28030,926,1806100,1,11,46,1,254,42361254
28031,166,1806200,8,11,46,1,420,42361420
28033,86,1806300,1,11,46,1,506,42361506
28034,1318,1806300,1,11,46,2,824,42362824
28035,651,1806300,1,11,46,3,475,42363475
28036,1099,1806400,7,11,46,4,574,42364574
28037,2426,1806500,1,11,46,7,0,42367000
28038,109,1806500,1,11,46,7,109,42367109
28039,0,1806500,1,11,46,7,109,42367109
28040,0,1806500,3,11,46,7,109,42367109
28041,84,1806400,1,11,46,7,193,42367193
28042,0,1806500,4,11,46,7,193,42367193
28043,623,1806500,1,11,46,7,816,42367816
28044,1177,1806500,1,11,46,8,993,42368993
28045,693,1806600,1,11,46,9,686,42369686
28046,0,1806600,4,11,46,9,686,42369686
28047,0,1806600,1,11,46,9,686,42369686
28048,85,1806700,1,11,46,9,771,42369771
28049,302,1806700,1,11,46,10,73,42370073
28050,1090,1806600,1,11,46,11,163,42371163
28051,99,1806700,4,11,46,11,262,42371262
28052,385,1806600,2,11,46,11,647,42371647
28053,378,1806600,10,11,46,12,25,42372025
28054,652,1806700,2,11,46,12,677,42372677
28055,742,1806700,1,11,46,13,419,42373419
28056,1293,1806700,1,11,46,14,712,42374712
28057,565,1806600,2,11,46,15,277,42375277
28058,0,1806700,1,11,46,15,277,42375277
28059,1313,1806600,1,11,46,16,590,42376590
28060,1496,1806600,1,11,46,18,86,42378086
28061,7202,1806500,1,11,46,25,288,42385288
28062,2611,1806600,6,11,46,27,899,42387899
28063,94,1806600,1,11,46,27,993,42387993
28064,241,1806600,1,11,46,28,234,42388234
28065,308,1806600,2,11,46,28,542,42388542
28066,1104,1806600,1,11,46,29,646,42389646
28067,2696,1806600,1,11,46,32,342,42392342
28068,411,1806600,1,11,46,32,753,42392753
28069,2444,1806600,1,11,46,35,197,42395197
28070,23,1806600,1,11,46,35,220,42395220
28071,220,1806600,2,11,46,35,440,42395440
28072,5015,1806500,1,11,46,40,455,42400455
28073,2940,1806500,1,11,46,43,395,42403395
28074,659,1806500,1,11,46,44,54,42404054
28075,48,1806600,9,11,46,44,102,42404102
28076,751,1806600,1,11,46,44,853,42404853
28077,1288,1806600,2,11,46,46,141,42406141
28078,2697,1806500,1,11,46,48,838,42408838
28079,4693,1806400,2,11,46,53,531,42413531
28080,11769,1806400,2,11,47,5,300,42425300
28081,1,1806400,2,11,47,5,301,42425301
28082,741,1806400,1,11,47,6,42,42426042
28083,38,1806400,1,11,47,6,80,42426080
28084,29,1806400,1,11,47,6,109,42426109
28085,10,1806400,1,11,47,6,119,42426119
28086,5125,1806400,1,11,47,11,244,42431244
28087,2485,1806500,9,11,47,13,729,42433729
28088,169,1806600,1,11,47,13,898,42433898
28089,1466,1806600,1,11,47,15,364,42435364
28090,0,1806600,1,11,47,15,364,42435364
28091,0,1806600,1,11,47,15,364,42435364
28092,1,1806700,4,11,47,15,365,42435365
28093,3043,1806600,8,11,47,18,408,42438408
28095,2,1806500,36,11,47,18,410,42438410
28096,1,1806500,1,11,47,18,411,42438411
28097,69,1806400,2,11,47,18,480,42438480
28098,1911,1806400,1,11,47,20,391,42440391
28099,1634,1806300,2,11,47,22,25,42442025
28100,1,1806300,1,11,47,22,26,42442026
28101,0,1806300,1,11,47,22,26,42442026
28102,0,1806300,1,11,47,22,26,42442026
28103,2278,1806200,1,11,47,24,304,42444304
28104,205,1806200,1,11,47,24,509,42444509
28105,391,1806200,1,11,47,24,900,42444900
28106,236,1806200,1,11,47,25,136,42445136
28107,4483,1806300,4,11,47,29,619,42449619
28108,57,1806400,2,11,47,29,676,42449676
28109,2799,1806200,2,11,47,32,475,42452475
28110,5486,1806400,1,11,47,37,961,42457961
28111,16454,1806300,1,11,47,54,415,42474415
28112,321,1806200,1,11,47,54,736,42474736
28113,554,1806200,1,11,47,55,290,42475290
28114,2265,1806200,1,11,47,57,555,42477555
28115,1042,1806200,1,11,47,58,597,42478597
28116,3308,1806200,2,11,48,1,905,42481905
28117,138,1806200,2,11,48,2,43,42482043
28118,1614,1806200,2,11,48,3,657,42483657
28119,547,1806200,1,11,48,4,204,42484204
28120,1386,1806300,4,11,48,5,590,42485590
28121,2368,1806400,3,11,48,7,958,42487958
28122,1,1806400,1,11,48,7,959,42487959
28123,209,1806400,1,11,48,8,168,42488168
28124,1559,1806500,3,11,48,9,727,42489727
28125,1790,1806500,3,11,48,11,517,42491517
28126,332,1806500,6,11,48,11,849,42491849
28127,5304,1806500,1,11,48,17,153,42497153
28128,1035,1806500,5,11,48,18,188,42498188
28129,1,1806400,1,11,48,18,189,42498189
28130,923,1806400,2,11,48,19,112,42499112
28131,6554,1806300,2,11,48,25,666,42505666
28132,13068,1806300,4,11,48,38,734,42518734
28133,6197,1806300,1,11,48,44,931,42524931
28134,2968,1806200,1,11,48,47,899,42527899
28135,659,1806300,5,11,48,48,558,42528558
28136,950,1806400,7,11,48,49,508,42529508
28137,1605,1806400,1,11,48,51,113,42531113
28138,12148,1806400,1,11,49,3,261,42543261
28139,6916,1806400,6,11,49,10,177,42550177
28141,2,1806300,12,11,49,10,179,42550179
28142,1,1806300,1,11,49,10,180,42550180
28144,207,1806300,1,11,49,10,387,42550387
28145,100,1806200,1,11,49,10,487,42550487
28146,777,1806200,1,11,49,11,264,42551264
28147,98,1806200,1,11,49,11,362,42551362
28148,1468,1806300,1,11,49,12,830,42552830
28149,4075,1806400,2,11,49,16,905,42556905
28150,0,1806400,1,11,49,16,905,42556905
28151,1049,1806400,1,11,49,17,954,42557954
28152,821,1806500,2,11,49,18,775,42558775
28153,3179,1806500,5,11,49,21,954,42561954
28154,228,1806500,1,11,49,22,182,42562182
28155,494,1806500,1,11,49,22,676,42562676
28156,67,1806400,8,11,49,22,743,42562743
28158,1,1806300,13,11,49,22,744,42562744
28159,1307,1806400,1,11,49,24,51,42564051
28160,4639,1806400,1,11,49,28,690,42568690
28161,9470,1806500,1,11,49,38,160,42578160
28162,9733,1806400,2,11,49,47,893,42587893
28163,0,1806400,1,11,49,47,893,42587893
28164,0,1806400,1,11,49,47,893,42587893
28165,0,1806400,3,11,49,47,893,42587893
28166,108,1806300,2,11,49,48,1,42588001
28167,1363,1806200,2,11,49,49,364,42589364
28168,294,1806200,1,11,49,49,658,42589658
28169,42,1806200,1,11,49,49,700,42589700
28170,6761,1806100,9,11,49,56,461,42596461
28171,3769,1806100,2,11,50,0,230,42600230
28172,8,1806100,1,11,50,0,238,42600238
28173,350,1806100,2,11,50,0,588,42600588
28174,380,1806100,1,11,50,0,968,42600968
28175,173,1806100,2,11,50,1,141,42601141
28176,1229,1806200,3,11,50,2,370,42602370
28177,49,1806100,1,11,50,2,419,42602419
28178,3009,1806100,1,11,50,5,428,42605428
28179,1864,1806300,1,11,50,7,292,42607292
28180,1970,1806200,1,11,50,9,262,42609262
28181,140,1806100,2,11,50,9,402,42609402
28182,2264,1806100,1,11,50,11,666,42611666
28183,246,1806200,9,11,50,11,912,42611912
28184,63,1806300,1,11,50,11,975,42611975
28185,215,1806200,1,11,50,12,190,42612190
28186,2114,1806200,2,11,50,14,304,42614304
28187,996,1806200,2,11,50,15,300,42615300
28188,9102,1806200,2,11,50,24,402,42624402
28189,452,1806200,1,11,50,24,854,42624854
28190,17168,1806100,5,11,50,42,22,42642022
28191,2408,1806000,7,11,50,44,430,42644430
28192,1,1806000,1,11,50,44,431,42644431
28193,3235,1806000,1,11,50,47,666,42647666
28194,1950,1806000,1,11,50,49,616,42649616
28195,4147,1805900,1,11,50,53,763,42653763
28196,477,1806000,1,11,50,54,240,42654240
28197,1175,1806000,1,11,50,55,415,42655415
28199,241,1806100,1,11,50,55,656,42655656
28200,666,1806000,1,11,50,56,322,42656322
28201,517,1805900,1,11,50,56,839,42656839
28202,0,1805900,2,11,50,56,839,42656839
28203,1,1805900,4,11,50,56,840,42656840
28204,1371,1805900,10,11,50,58,211,42658211
28205,546,1806000,1,11,50,58,757,42658757
28206,2482,1806000,2,11,51,1,239,42661239
28207,5315,1805900,2,11,51,6,554,42666554
28208,405,1805900,1,11,51,6,959,42666959
28209,3060,1805900,1,11,51,10,19,42670019
28210,170,1805900,1,11,51,10,189,42670189
28211,3,1805900,2,11,51,10,192,42670192
28212,733,1805900,1,11,51,10,925,42670925
28213,178,1805900,2,11,51,11,103,42671103
28215,393,1805900,1,11,51,11,496,42671496
28216,2141,1805900,1,11,51,13,637,42673637
28217,6092,1806000,2,11,51,19,729,42679729
28218,4552,1806000,1,11,51,24,281,42684281
28219,5044,1806000,1,11,51,29,325,42689325
28220,1029,1806000,2,11,51,30,354,42690354
28221,235,1806000,1,11,51,30,589,42690589
28222,3609,1806000,1,11,51,34,198,42694198
28223,5640,1806000,1,11,51,39,838,42699838
28224,4613,1806000,1,11,51,44,451,42704451
28225,3475,1805900,1,11,51,47,926,42707926
28226,1,1805900,2,11,51,47,927,42707927
28227,549,1806000,1,11,51,48,476,42708476
28228,4855,1806000,1,11,51,53,331,42713331
28229,809,1805900,1,11,51,54,140,42714140
28230,0,1805900,3,11,51,54,140,42714140
28231,134,1805900,2,11,51,54,274,42714274
28232,2087,1805800,2,11,51,56,361,42716361
28233,378,1805800,2,11,51,56,739,42716739
28234,1926,1805800,11,11,51,58,665,42718665
28235,0,1805800,11,11,51,58,665,42718665
28236,0,1805800,11,11,51,58,665,42718665
28237,0,1805800,11,11,51,58,665,42718665
28239,5,1805500,1,11,51,58,670,42718670
28240,1,1805400,5,11,51,58,671,42718671
28241,11,1805500,1,11,51,58,682,42718682
28242,95,1805400,1,11,51,58,777,42718777
28243,74,1805400,1,11,51,58,851,42718851
28244,12,1805400,1,11,51,58,863,42718863
28245,25,1805400,1,11,51,58,888,42718888
28246,50,1805500,1,11,51,58,938,42718938
28247,3,1805400,4,11,51,58,941,42718941
28248,0,1805400,1,11,51,58,941,42718941
28249,0,1805300,1,11,51,58,941,42718941
28250,7,1805400,1,11,51,58,948,42718948
28251,30,1805400,1,11,51,58,978,42718978
28252,34,1805400,1,11,51,59,12,42719012
28253,17,1805400,2,11,51,59,29,42719029
28254,9,1805300,1,11,51,59,38,42719038
28255,8,1805300,1,11,51,59,46,42719046
28256,8,1805300,1,11,51,59,54,42719054
28257,29,1805300,1,11,51,59,83,42719083
28258,8,1805300,1,11,51,59,91,42719091
28259,2,1805300,1,11,51,59,93,42719093
28260,20,1805300,1,11,51,59,113,42719113
28261,14,1805300,1,11,51,59,127,42719127
28262,139,1805300,1,11,51,59,266,42719266
28263,105,1805500,2,11,51,59,371,42719371
28264,47,1805500,2,11,51,59,418,42719418
28265,46,1805500,2,11,51,59,464,42719464
28266,17,1805500,2,11,51,59,481,42719481
28267,23,1805300,3,11,51,59,504,42719504
28268,17,1805300,1,11,51,59,521,42719521
28269,82,1805300,1,11,51,59,603,42719603
28270,166,1805300,1,11,51,59,769,42719769
28271,242,1805400,5,11,52,0,11,42720011
28272,106,1805500,3,11,52,0,117,42720117
28273,922,1805500,2,11,52,1,39,42721039
28274,540,1805400,10,11,52,1,579,42721579
28275,149,1805400,1,11,52,1,728,42721728
28276,334,1805400,1,11,52,2,62,42722062
28277,1226,1805600,1,11,52,3,288,42723288
28278,795,1805400,5,11,52,4,83,42724083
28280,685,1805300,2,11,52,4,768,42724768
28281,9,1805300,2,11,52,4,777,42724777
28282,66,1805300,1,11,52,4,843,42724843
28283,769,1805500,4,11,52,5,612,42725612
28284,461,1805400,5,11,52,6,73,42726073
28285,223,1805300,3,11,52,6,296,42726296
28286,103,1805400,1,11,52,6,399,42726399
28287,505,1805300,1,11,52,6,904,42726904
28288,901,1805400,1,11,52,7,805,42727805
28289,0,1805400,28,11,52,7,805,42727805
28290,863,1805500,1,11,52,8,668,42728668
28291,651,1805500,4,11,52,9,319,42729319
28292,603,1805600,1,11,52,9,922,42729922
28293,60,1805500,1,11,52,9,982,42729982
28294,126,1805600,1,11,52,10,108,42730108
28295,1,1805700,5,11,52,10,109,42730109
28296,73,1805600,2,11,52,10,182,42730182
28297,261,1805800,1,11,52,10,443,42730443
28298,1557,1805600,1,11,52,12,0,42732000
28299,334,1805700,1,11,52,12,334,42732334
28300,574,1805700,2,11,52,12,908,42732908
28301,2267,1805500,2,11,52,15,175,42735175
28302,5762,1805500,1,11,52,20,937,42740937
28303,25,1805600,1,11,52,20,962,42740962
28304,170,1805500,1,11,52,21,132,42741132
28305,42,1805600,1,11,52,21,174,42741174
28306,327,1805600,1,11,52,21,501,42741501
28307,1427,1805600,3,11,52,22,928,42742928
28308,4113,1805700,3,11,52,27,41,42747041
28309,595,1805800,1,11,52,27,636,42747636
28310,650,1805700,2,11,52,28,286,42748286
28311,1295,1805700,1,11,52,29,581,42749581
28312,644,1805900,1,11,52,30,225,42750225
28313,825,1805800,2,11,52,31,50,42751050
28314,0,1805800,2,11,52,31,50,42751050
28316,427,1805600,1,11,52,31,477,42751477
28317,3015,1805700,2,11,52,34,492,42754492
28318,291,1805700,1,11,52,34,783,42754783
28319,2553,1805700,1,11,52,37,336,42757336
28321,2,1805600,1,11,52,37,338,42757338
28322,0,1805600,1,11,52,37,338,42757338
28323,1765,1805600,4,11,52,39,103,42759103
28324,325,1805600,1,11,52,39,428,42759428
28325,720,1805600,1,11,52,40,148,42760148
28326,1356,1805600,1,11,52,41,504,42761504
28327,2,1805600,4,11,52,41,506,42761506
28328,1530,1805700,2,11,52,43,36,42763036
28330,3163,1805700,2,11,52,46,199,42766199
28331,3000,1805700,1,11,52,49,199,42769199
28332,2953,1805800,4,11,52,52,152,42772152
28333,770,1805600,2,11,52,52,922,42772922
28334,480,1805700,4,11,52,53,402,42773402
28335,1226,1805700,2,11,52,54,628,42774628
28336,1640,1805800,4,11,52,56,268,42776268
28337,100,1805900,5,11,52,56,368,42776368
28338,786,1805800,1,11,52,57,154,42777154
28339,940,1806000,1,11,52,58,94,42778094
28340,283,1806000,5,11,52,58,377,42778377
28341,1626,1806000,1,11,53,0,3,42780003
28342,128,1806000,3,11,53,0,131,42780131
28343,602,1806000,3,11,53,0,733,42780733
28344,612,1805900,1,11,53,1,345,42781345
28345,1490,1806000,2,11,53,2,835,42782835
28346,1953,1806000,3,11,53,4,788,42784788
28347,43,1806100,4,11,53,4,831,42784831
28348,539,1806100,1,11,53,5,370,42785370
28349,204,1806200,1,11,53,5,574,42785574
28350,1603,1806000,1,11,53,7,177,42787177
28351,0,1806000,8,11,53,7,177,42787177
28352,1,1806000,2,11,53,7,178,42787178
28353,4240,1806100,1,11,53,11,418,42791418
28354,149,1806100,3,11,53,11,567,42791567
28355,1397,1806000,1,11,53,12,964,42792964
28356,4642,1806000,1,11,53,17,606,42797606
28357,226,1806000,1,11,53,17,832,42797832
28358,6177,1806000,2,11,53,24,9,42804009
28359,4021,1806000,2,11,53,28,30,42808030
28361,1,1806100,3,11,53,28,31,42808031
28362,83,1806000,1,11,53,28,114,42808114
28363,855,1805900,9,11,53,28,969,42808969
28364,1,1805900,1,11,53,28,970,42808970
28365,129,1806000,1,11,53,29,99,42809099
28366,287,1805800,4,11,53,29,386,42809386
28367,762,1806000,3,11,53,30,148,42810148
28368,1015,1806000,1,11,53,31,163,42811163
28369,709,1806100,3,11,53,31,872,42811872
28370,2127,1806000,1,11,53,33,999,42813999
28371,3281,1806000,1,11,53,37,280,42817280
28372,7229,1805900,2,11,53,44,509,42824509
28373,2026,1805900,4,11,53,46,535,42826535
28374,548,1805900,1,11,53,47,83,42827083
28375,11379,1805900,1,11,53,58,462,42838462
28376,1394,1806000,9,11,53,59,856,42839856
28377,638,1805900,2,11,54,0,494,42840494
28378,3074,1806000,3,11,54,3,568,42843568
28380,8186,1806000,1,11,54,11,754,42851754
28381,1371,1805900,1,11,54,13,125,42853125
28382,1493,1805900,5,11,54,14,618,42854618
28383,11090,1806000,1,11,54,25,708,42865708
28384,4598,1806100,3,11,54,30,306,42870306
28385,3419,1806200,2,11,54,33,725,42873725
28386,1805,1806200,1,11,54,35,530,42875530
28387,1072,1806200,1,11,54,36,602,42876602
28388,403,1806100,1,11,54,37,5,42877005
28389,123,1806100,3,11,54,37,128,42877128
28391,43,1805900,1,11,54,37,171,42877171
28392,0,1805900,1,11,54,37,171,42877171
28393,65,1805900,1,11,54,37,236,42877236
28394,10222,1806000,1,11,54,47,458,42887458
28395,5483,1805900,1,11,54,52,941,42892941
28396,656,1805900,2,11,54,53,597,42893597
28397,149,1805900,1,11,54,53,746,42893746
28398,2053,1805900,1,11,54,55,799,42895799
28399,70,1805800,6,11,54,55,869,42895869
28400,2938,1805700,1,11,54,58,807,42898807
28401,42,1805800,1,11,54,58,849,42898849
28402,147,1805700,1,11,54,58,996,42898996
28403,701,1805700,1,11,54,59,697,42899697
28404,292,1805700,1,11,54,59,989,42899989
28405,6535,1805800,1,11,55,6,524,42906524
28406,79,1805800,1,11,55,6,603,42906603
28407,0,1805800,3,11,55,6,603,42906603
28408,0,1805900,1,11,55,6,603,42906603
28409,1,1805900,1,11,55,6,604,42906604
28410,0,1805900,1,11,55,6,604,42906604
28411,0,1805900,1,11,55,6,604,42906604
28412,193,1805800,1,11,55,6,797,42906797
28413,1201,1805700,1,11,55,7,998,42907998
28414,102,1805900,1,11,55,8,100,42908100
28415,0,1805900,1,11,55,8,100,42908100
28416,1,1805900,1,11,55,8,101,42908101
28417,1655,1805700,1,11,55,9,756,42909756
28418,2681,1805700,1,11,55,12,437,42912437
28419,997,1805900,1,11,55,13,434,42913434
28420,307,1805700,1,11,55,13,741,42913741
28421,5789,1805900,1,11,55,19,530,42919530
28422,506,1805900,1,11,55,20,36,42920036
28423,65,1805900,1,11,55,20,101,42920101
28424,0,1805900,1,11,55,20,101,42920101
28425,3128,1805900,1,11,55,23,229,42923229
28426,30,1805800,1,11,55,23,259,42923259
28427,1352,1805800,2,11,55,24,611,42924611
28428,671,1805900,1,11,55,25,282,42925282
28429,729,1805800,4,11,55,26,11,42926011
28430,499,1805800,1,11,55,26,510,42926510
28431,3322,1805900,2,11,55,29,832,42929832
28432,1,1805900,3,11,55,29,833,42929833
28433,17,1806000,1,11,55,29,850,42929850
28434,3825,1805800,1,11,55,33,675,42933675
28435,2306,1805900,1,11,55,35,981,42935981
28436,861,1805900,1,11,55,36,842,42936842
28437,9923,1805900,1,11,55,46,765,42946765
28438,13703,1805900,1,11,56,0,468,42960468
28439,1,1805900,1,11,56,0,469,42960469
28440,14521,1806000,1,11,56,14,990,42974990
28441,1657,1805900,1,11,56,16,647,42976647
28442,3859,1805800,2,11,56,20,506,42980506
28443,23841,1805900,1,11,56,44,347,43004347
28444,54,1805900,1,11,56,44,401,43004401
28445,381,1805800,9,11,56,44,782,43004782
28446,1,1805700,7,11,56,44,783,43004783
28447,44,1805700,4,11,56,44,827,43004827
28448,92,1805700,1,11,56,44,919,43004919
28449,315,1805600,10,11,56,45,234,43005234
28450,980,1805600,1,11,56,46,214,43006214
28451,940,1805500,3,11,56,47,154,43007154
28452,1085,1805500,6,11,56,48,239,43008239
28453,66,1805500,1,11,56,48,305,43008305
28454,1915,1805500,1,11,56,50,220,43010220
28455,358,1805400,2,11,56,50,578,43010578
28456,454,1805500,1,11,56,51,32,43011032
28457,0,1805500,1,11,56,51,32,43011032
28458,2972,1805500,2,11,56,54,4,43014004
28459,935,1805400,2,11,56,54,939,43014939
28460,387,1805600,1,11,56,55,326,43015326
28461,9,1805600,1,11,56,55,335,43015335
28462,1318,1805500,5,11,56,56,653,43016653
28463,3419,1805600,3,11,57,0,72,43020072
28464,365,1805500,1,11,57,0,437,43020437
28466,1128,1805500,1,11,57,1,565,43021565
28467,3009,1805500,1,11,57,4,574,43024574
28468,558,1805500,3,11,57,5,132,43025132
28469,42,1805500,1,11,57,5,174,43025174
28470,529,1805400,1,11,57,5,703,43025703
28471,767,1805400,1,11,57,6,470,43026470
28472,80,1805500,1,11,57,6,550,43026550
28473,449,1805400,1,11,57,6,999,43026999
28474,374,1805400,1,11,57,7,373,43027373
28475,396,1805400,1,11,57,7,769,43027769
28476,162,1805400,1,11,57,7,931,43027931
28477,444,1805500,3,11,57,8,375,43028375
28478,160,1805400,1,11,57,8,535,43028535
28479,996,1805500,1,11,57,9,531,43029531
28480,307,1805500,1,11,57,9,838,43029838
28481,812,1805400,4,11,57,10,650,43030650
28482,147,1805500,4,11,57,10,797,43030797
28484,163,1805500,2,11,57,10,960,43030960
28485,3023,1805500,1,11,57,13,983,43033983
28486,1380,1805500,1,11,57,15,363,43035363
28487,2700,1805500,3,11,57,18,63,43038063
28488,765,1805400,9,11,57,18,828,43038828
28489,45,1805400,1,11,57,18,873,43038873
28490,743,1805400,2,11,57,19,616,43039616
28491,636,1805300,1,11,57,20,252,43040252
28492,6,1805400,1,11,57,20,258,43040258
28494,164,1805300,2,11,57,20,422,43040422
28495,545,1805300,1,11,57,20,967,43040967
28496,52,1805300,1,11,57,21,19,43041019
28497,2652,1805300,1,11,57,23,671,43043671
28498,2883,1805400,1,11,57,26,554,43046554
28499,1,1805400,1,11,57,26,555,43046555
28500,0,1805400,1,11,57,26,555,43046555
28501,20,1805400,1,11,57,26,575,43046575
28502,0,1805400,1,11,57,26,575,43046575
28503,0,1805400,2,11,57,26,575,43046575
28504,178,1805400,1,11,57,26,753,43046753
28505,24,1805500,3,11,57,26,777,43046777
28506,1529,1805400,1,11,57,28,306,43048306
28507,1310,1805400,1,11,57,29,616,43049616
28508,610,1805600,2,11,57,30,226,43050226
28509,1314,1805500,1,11,57,31,540,43051540
28510,1701,1805600,1,11,57,33,241,43053241
28511,1,1805600,1,11,57,33,242,43053242
28512,201,1805600,1,11,57,33,443,43053443
28513,586,1805700,1,11,57,34,29,43054029
28514,309,1805500,1,11,57,34,338,43054338
28515,2144,1805700,3,11,57,36,482,43056482
28517,249,1805700,1,11,57,36,731,43056731
28518,797,1805600,1,11,57,37,528,43057528
28519,317,1805700,1,11,57,37,845,43057845
28520,1772,1805600,3,11,57,39,617,43059617
28521,244,1805600,1,11,57,39,861,43059861
28522,1005,1805600,1,11,57,40,866,43060866
28524,2658,1805700,1,11,57,43,524,43063524
28525,0,1805700,1,11,57,43,524,43063524
28526,72,1805600,1,11,57,43,596,43063596
28527,2263,1805700,3,11,57,45,859,43065859
28528,159,1805700,1,11,57,46,18,43066018
28529,1127,1805600,1,11,57,47,145,43067145
28530,8030,1805600,1,11,57,55,175,43075175
28531,7634,1805600,2,11,58,2,809,43082809
28532,2832,1805600,8,11,58,5,641,43085641
28534,3,1805500,3,11,58,5,644,43085644
28535,1921,1805600,1,11,58,7,565,43087565
28536,1086,1805600,1,11,58,8,651,43088651
28537,11088,1805600,3,11,58,19,739,43099739
28538,2475,1805600,2,11,58,22,214,43102214
28539,6719,1805600,1,11,58,28,933,43108933
28540,92,1805600,1,11,58,29,25,43109025
28541,0,1805600,1,11,58,29,25,43109025
28542,2306,1805600,1,11,58,31,331,43111331
28543,3063,1805600,4,11,58,34,394,43114394
28544,67,1805600,1,11,58,34,461,43114461
28545,499,1805500,6,11,58,34,960,43114960
28546,0,1805500,6,11,58,34,960,43114960
28547,0,1805500,6,11,58,34,960,43114960
28548,0,1805500,6,11,58,34,960,43114960
28550,17,1805300,3,11,58,34,977,43114977
28551,0,1805300,2,11,58,34,977,43114977
28552,2,1805400,1,11,58,34,979,43114979
28553,0,1805200,1,11,58,34,979,43114979
28554,1,1805200,1,11,58,34,980,43114980
28555,0,1805200,1,11,58,34,980,43114980
28556,5,1805200,2,11,58,34,985,43114985
28557,2,1805100,1,11,58,34,987,43114987
28558,1,1805100,5,11,58,34,988,43114988
28559,17,1805100,4,11,58,35,5,43115005
28560,1,1805100,15,11,58,35,6,43115006
28561,1,1805100,1,11,58,35,7,43115007
28562,0,1805100,1,11,58,35,7,43115007
28563,0,1805100,4,11,58,35,7,43115007
28564,0,1805100,1,11,58,35,7,43115007
28565,0,1805100,1,11,58,35,7,43115007
28566,0,1805100,1,11,58,35,7,43115007
28567,1,1805100,1,11,58,35,8,43115008
28568,0,1805100,1,11,58,35,8,43115008
28570,4,1805100,1,11,58,35,12,43115012
28571,4,1805000,1,11,58,35,16,43115016
28572,3,1805200,1,11,58,35,19,43115019
28573,2,1805000,1,11,58,35,21,43115021
28574,4,1805000,4,11,58,35,25,43115025
28575,8,1805200,1,11,58,35,33,43115033
28576,3,1805000,10,11,58,35,36,43115036
28577,2,1805100,2,11,58,35,38,43115038
28578,8,1805100,2,11,58,35,46,43115046
28579,2,1805100,2,11,58,35,48,43115048
28580,2,1805100,2,11,58,35,50,43115050
28581,8,1805000,2,11,58,35,58,43115058
28582,21,1805200,1,11,58,35,79,43115079
28583,1,1805100,1,11,58,35,80,43115080
28584,40,1805200,1,11,58,35,120,43115120
28585,12,1805100,1,11,58,35,132,43115132
28586,55,1805100,2,11,58,35,187,43115187
28587,18,1805100,2,11,58,35,205,43115205
28588,22,1805100,2,11,58,35,227,43115227
28589,1,1805100,1,11,58,35,228,43115228
28590,6,1805000,1,11,58,35,234,43115234
28591,95,1805200,1,11,58,35,329,43115329
28592,90,1805100,1,11,58,35,419,43115419
28593,22,1805100,2,11,58,35,441,43115441
28594,153,1805200,1,11,58,35,594,43115594
28595,25,1805200,1,11,58,35,619,43115619
28596,5,1805200,1,11,58,35,624,43115624
28597,1,1805200,4,11,58,35,625,43115625
28599,15,1805200,1,11,58,35,640,43115640
28600,41,1805200,4,11,58,35,681,43115681
28601,121,1805100,1,11,58,35,802,43115802
28602,24,1805100,1,11,58,35,826,43115826
28603,11,1805100,1,11,58,35,837,43115837
28604,340,1805100,1,11,58,36,177,43116177
28605,56,1805100,2,11,58,36,233,43116233
28606,266,1805100,1,11,58,36,499,43116499
28607,1107,1805100,1,11,58,37,606,43117606
28608,3758,1805100,1,11,58,41,364,43121364
28609,167,1805300,1,11,58,41,531,43121531
28610,1399,1805200,1,11,58,42,930,43122930
28611,52,1805200,1,11,58,42,982,43122982
28612,1987,1805100,1,11,58,44,969,43124969
28613,17,1805200,1,11,58,44,986,43124986
28614,120,1805100,2,11,58,45,106,43125106
28615,1059,1805100,2,11,58,46,165,43126165
28616,1250,1805100,1,11,58,47,415,43127415
28617,1450,1805100,1,11,58,48,865,43128865
28618,35,1805100,1,11,58,48,900,43128900
28619,515,1805100,8,11,58,49,415,43129415
28620,15,1805200,1,11,58,49,430,43129430
28621,1329,1805100,2,11,58,50,759,43130759
28622,2631,1805200,1,11,58,53,390,43133390
28623,36,1805200,1,11,58,53,426,43133426
28624,679,1805200,3,11,58,54,105,43134105
28625,346,1805100,1,11,58,54,451,43134451
28626,2589,1805300,1,11,58,57,40,43137040
28627,1848,1805300,1,11,58,58,888,43138888
28628,973,1805300,1,11,58,59,861,43139861
28629,958,1805200,2,11,59,0,819,43140819
28630,162,1805200,1,11,59,0,981,43140981
28631,100,1805200,1,11,59,1,81,43141081
28632,10,1805200,1,11,59,1,91,43141091
28633,83,1805200,1,11,59,1,174,43141174
28634,222,1805200,1,11,59,1,396,43141396
28635,808,1805200,1,11,59,2,204,43142204
28636,1342,1805200,1,11,59,3,546,43143546
28637,1148,1805200,2,11,59,4,694,43144694
28638,0,1805200,3,11,59,4,694,43144694
28639,0,1805200,1,11,59,4,694,43144694
28640,1,1805200,2,11,59,4,695,43144695
28641,0,1805200,1,11,59,4,695,43144695
28642,0,1805200,9,11,59,4,695,43144695
28643,33,1805200,1,11,59,4,728,43144728
28644,5,1805300,1,11,59,4,733,43144733
28645,1132,1805200,1,11,59,5,865,43145865
28646,1991,1805300,1,11,59,7,856,43147856
28647,461,1805200,1,11,59,8,317,43148317
28648,2573,1805300,1,11,59,10,890,43150890
28649,1514,1805300,1,11,59,12,404,43152404
28650,3696,1805200,1,11,59,16,100,43156100
28651,73,1805200,1,11,59,16,173,43156173
28652,777,1805200,1,11,59,16,950,43156950
28653,862,1805200,1,11,59,17,812,43157812
28654,506,1805200,1,11,59,18,318,43158318
28655,765,1805200,2,11,59,19,83,43159083
28656,265,1805300,1,11,59,19,348,43159348
28657,375,1805100,1,11,59,19,723,43159723
28658,678,1805200,1,11,59,20,401,43160401
28659,1803,1805200,1,11,59,22,204,43162204
28660,868,1805200,1,11,59,23,72,43163072
28661,50,1805200,1,11,59,23,122,43163122
28662,764,1805200,1,11,59,23,886,43163886
28663,715,1805300,8,11,59,24,601,43164601
28665,34,1805300,1,11,59,24,635,43164635
28666,675,1805300,1,11,59,25,310,43165310
28667,1366,1805200,1,11,59,26,676,43166676
28668,3250,1805300,1,11,59,29,926,43169926
28669,3162,1805200,1,11,59,33,88,43173088
28670,2338,1805100,1,11,59,35,426,43175426
28671,1700,1805300,2,11,59,37,126,43177126
28672,65,1805200,1,11,59,37,191,43177191
28673,633,1805200,1,11,59,37,824,43177824
28674,274,1805200,6,11,59,38,98,43178098
28675,3207,1805300,1,11,59,41,305,43181305
28676,845,1805200,2,11,59,42,150,43182150
28677,2844,1805200,5,11,59,44,994,43184994
28678,4034,1805200,1,11,59,49,28,43189028
28679,351,1805200,1,11,59,49,379,43189379
28680,1778,1805300,6,11,59,51,157,43191157
28681,1854,1805300,1,11,59,53,11,43193011
28682,7098,1805300,2,12,0,0,109,43200109
28683,22,1805300,2,12,0,0,131,43200131
28684,0,1805300,2,12,0,0,131,43200131
28685,102,1805400,2,12,0,0,233,43200233
28686,0,1805400,1,12,0,0,233,43200233
28687,0,1805400,1,12,0,0,233,43200233
28688,1,1805400,1,12,0,0,234,43200234
28689,0,1805400,1,12,0,0,234,43200234
28690,2,1805400,1,12,0,0,236,43200236
28691,10,1805400,1,12,0,0,246,43200246
28692,0,1805400,1,12,0,0,246,43200246
28693,0,1805400,1,12,0,0,246,43200246
28694,1,1805400,1,12,0,0,247,43200247
28695,0,1805400,3,12,0,0,247,43200247
28696,0,1805400,1,12,0,0,247,43200247
28697,0,1805400,1,12,0,0,247,43200247
28698,1,1805400,1,12,0,0,248,43200248
28699,70,1805300,1,12,0,0,318,43200318
28700,172,1805300,1,12,0,0,490,43200490
28701,65,1805400,1,12,0,0,555,43200555
28702,143,1805300,2,12,0,0,698,43200698
28703,13,1805300,1,12,0,0,711,43200711
28704,13,1805300,4,12,0,0,724,43200724
28706,1286,1805300,1,12,0,2,10,43202010
28707,0,1805300,1,12,0,2,10,43202010
28708,91,1805400,1,12,0,2,101,43202101
28709,273,1805200,4,12,0,2,374,43202374
28710,194,1805200,1,12,0,2,568,43202568
28711,36,1805300,1,12,0,2,604,43202604
28712,194,1805300,1,12,0,2,798,43202798
28713,11,1805400,3,12,0,2,809,43202809
28714,1447,1805400,1,12,0,4,256,43204256
28715,0,1805400,2,12,0,4,256,43204256
28716,0,1805400,1,12,0,4,256,43204256
28717,877,1805500,2,12,0,5,133,43205133
28718,9,1805500,2,12,0,5,142,43205142
28719,137,1805500,1,12,0,5,279,43205279
28720,306,1805400,4,12,0,5,585,43205585
28721,38,1805400,1,12,0,5,623,43205623
28722,2302,1805400,1,12,0,7,925,43207925
28723,352,1805600,1,12,0,8,277,43208277
28724,73,1805600,1,12,0,8,350,43208350
28725,0,1805600,1,12,0,8,350,43208350
28726,0,1805600,1,12,0,8,350,43208350
28727,1,1805600,1,12,0,8,351,43208351
28728,0,1805600,1,12,0,8,351,43208351
28729,0,1805600,1,12,0,8,351,43208351
28730,0,1805600,1,12,0,8,351,43208351
28731,2144,1805600,11,12,0,10,495,43210495
28732,1227,1805700,2,12,0,11,722,43211722
28733,109,1805600,3,12,0,11,831,43211831
28734,1,1805600,1,12,0,11,832,43211832
28735,154,1805600,1,12,0,11,986,43211986
28736,484,1805400,1,12,0,12,470,43212470
28737,1796,1805600,3,12,0,14,266,43214266
28739,1950,1805700,1,12,0,16,216,43216216
28740,399,1805800,1,12,0,16,615,43216615
28741,901,1805600,2,12,0,17,516,43217516
28742,84,1805800,1,12,0,17,600,43217600
28743,0,1805800,1,12,0,17,600,43217600
28744,0,1805800,1,12,0,17,600,43217600
28745,0,1805800,1,12,0,17,600,43217600
28746,0,1805800,1,12,0,17,600,43217600
28747,0,1805800,1,12,0,17,600,43217600
28748,0,1805800,1,12,0,17,600,43217600
28749,1,1805800,1,12,0,17,601,43217601
28750,0,1805800,1,12,0,17,601,43217601
28751,1592,1805700,1,12,0,19,193,43219193
28752,68,1805700,2,12,0,19,261,43219261
28754,351,1805600,2,12,0,19,612,43219612
28755,349,1805800,1,12,0,19,961,43219961
28756,1449,1805700,3,12,0,21,410,43221410
28757,0,1805700,2,12,0,21,410,43221410
28758,612,1805800,1,12,0,22,22,43222022
28759,2034,1805800,1,12,0,24,56,43224056
28760,1052,1805800,1,12,0,25,108,43225108
28761,444,1805800,1,12,0,25,552,43225552
28762,0,1805800,2,12,0,25,552,43225552
28763,1121,1805800,1,12,0,26,673,43226673
28764,34,1805800,1,12,0,26,707,43226707
28765,1361,1805800,1,12,0,28,68,43228068
28766,32,1805900,1,12,0,28,100,43228100
28767,1,1805900,1,12,0,28,101,43228101
28768,0,1805900,1,12,0,28,101,43228101
28769,141,1805900,1,12,0,28,242,43228242
28770,587,1805700,1,12,0,28,829,43228829
28771,107,1805800,1,12,0,28,936,43228936
28772,3060,1805800,1,12,0,31,996,43231996
28773,1442,1805800,2,12,0,33,438,43233438
28774,2259,1805800,3,12,0,35,697,43235697
28775,5725,1805800,1,12,0,41,422,43241422
28776,171,1805800,1,12,0,41,593,43241593
28777,22,1805800,1,12,0,41,615,43241615
28778,1480,1805900,1,12,0,43,95,43243095
28779,5,1805900,1,12,0,43,100,43243100
28780,0,1805900,1,12,0,43,100,43243100
28781,1,1805900,1,12,0,43,101,43243101
28782,0,1805900,1,12,0,43,101,43243101
28783,0,1805900,1,12,0,43,101,43243101
28784,278,1805800,1,12,0,43,379,43243379
28785,802,1805800,1,12,0,44,181,43244181
28786,2494,1805800,1,12,0,46,675,43246675
28787,2331,1805800,1,12,0,49,6,43249006
28788,95,1805800,1,12,0,49,101,43249101
28789,696,1805800,1,12,0,49,797,43249797
28790,620,1805800,1,12,0,50,417,43250417
28791,82,1805800,1,12,0,50,499,43250499
28792,584,1805800,1,12,0,51,83,43251083
28793,692,1805800,1,12,0,51,775,43251775
28794,145,1805700,1,12,0,51,920,43251920
28795,2384,1805800,1,12,0,54,304,43254304
28796,2506,1805800,1,12,0,56,810,43256810
28797,0,1805800,1,12,0,56,810,43256810
28798,3338,1805800,1,12,1,0,148,43260148
28799,477,1805700,2,12,1,0,625,43260625
28800,232,1805700,11,12,1,0,857,43260857
28801,921,1805800,1,12,1,1,778,43261778
28802,73,1805800,1,12,1,1,851,43261851
28803,50,1805800,2,12,1,1,901,43261901
28804,0,1805800,1,12,1,1,901,43261901
28805,0,1805800,1,12,1,1,901,43261901
28806,1,1805800,1,12,1,1,902,43261902
28807,854,1805700,1,12,1,2,756,43262756
28808,1108,1805900,2,12,1,3,864,43263864
28809,1,1805900,3,12,1,3,865,43263865
28810,6,1805800,1,12,1,3,871,43263871
28811,36,1805900,1,12,1,3,907,43263907
28812,0,1805900,1,12,1,3,907,43263907
28813,3506,1805900,1,12,1,7,413,43267413
28814,1254,1805900,1,12,1,8,667,43268667
28815,58,1806000,1,12,1,8,725,43268725
28816,0,1806000,1,12,1,8,725,43268725
28817,184,1806000,1,12,1,8,909,43268909
28818,423,1806000,2,12,1,9,332,43269332
28819,0,1806000,2,12,1,9,332,43269332
28820,559,1806000,1,12,1,9,891,43269891
28821,1097,1806000,2,12,1,10,988,43270988
28822,160,1806000,2,12,1,11,148,43271148
28823,156,1806000,1,12,1,11,304,43271304
28824,466,1806000,1,12,1,11,770,43271770
28825,1531,1806000,1,12,1,13,301,43273301
28826,988,1806000,1,12,1,14,289,43274289
28827,557,1806000,1,12,1,14,846,43274846
28828,49,1806100,8,12,1,14,895,43274895
28830,25,1806000,1,12,1,14,920,43274920
28831,352,1806200,3,12,1,15,272,43275272
28832,167,1806100,1,12,1,15,439,43275439
28833,1349,1806000,1,12,1,16,788,43276788
28834,3147,1806100,2,12,1,19,935,43279935
28835,806,1806200,1,12,1,20,741,43280741
28836,648,1806200,1,12,1,21,389,43281389
28837,316,1806200,1,12,1,21,705,43281705
28838,219,1806100,1,12,1,21,924,43281924
28839,38,1806100,1,12,1,21,962,43281962
28840,278,1806100,1,12,1,22,240,43282240
28841,1,1806100,2,12,1,22,241,43282241
28842,1699,1806100,1,12,1,23,940,43283940
28843,817,1806000,2,12,1,24,757,43284757
28844,1298,1806200,4,12,1,26,55,43286055
28845,1527,1806100,1,12,1,27,582,43287582
28846,1188,1806200,5,12,1,28,770,43288770
28847,256,1806100,1,12,1,29,26,43289026
28848,0,1806100,1,12,1,29,26,43289026
28849,839,1806100,1,12,1,29,865,43289865
28850,722,1806100,5,12,1,30,587,43290587
28852,344,1806000,1,12,1,30,931,43290931
28853,1142,1806000,1,12,1,32,73,43292073
28854,46,1806000,1,12,1,32,119,43292119
28855,219,1805900,1,12,1,32,338,43292338
28856,1918,1805900,1,12,1,34,256,43294256
28857,2473,1806000,20,12,1,36,729,43296729
28858,2585,1805900,1,12,1,39,314,43299314
28859,740,1805900,1,12,1,40,54,43300054
28860,538,1805900,8,12,1,40,592,43300592
28861,77,1805800,5,12,1,40,669,43300669
28862,332,1805900,1,12,1,41,1,43301001
28863,8336,1805800,1,12,1,49,337,43309337
28864,4913,1805800,1,12,1,54,250,43314250
28865,4954,1805800,1,12,1,59,204,43319204
28866,3844,1805800,1,12,2,3,48,43323048
28867,3759,1805900,1,12,2,6,807,43326807
28868,1921,1805900,2,12,2,8,728,43328728
28869,1001,1805900,2,12,2,9,729,43329729
28870,1941,1805900,1,12,2,11,670,43331670
28871,2802,1805900,1,12,2,14,472,43334472
28872,339,1805800,3,12,2,14,811,43334811
28873,1347,1805700,1,12,2,16,158,43336158
28874,672,1805800,2,12,2,16,830,43336830
28875,72,1805800,2,12,2,16,902,43336902
28876,96,1805900,1,12,2,16,998,43336998
28877,16,1805900,1,12,2,17,14,43337014
28878,148,1805900,2,12,2,17,162,43337162
28879,20,1805900,1,12,2,17,182,43337182
28880,60,1805900,1,12,2,17,242,43337242
28881,80,1805900,1,12,2,17,322,43337322
28882,80,1806000,2,12,2,17,402,43337402
28883,5,1805800,1,12,2,17,407,43337407
28884,6325,1806000,1,12,2,23,732,43343732
28885,2778,1805900,1,12,2,26,510,43346510
28886,5562,1805900,2,12,2,32,72,43352072
28887,4616,1805800,1,12,2,36,688,43356688
28888,328,1805800,2,12,2,37,16,43357016
28889,1399,1805800,1,12,2,38,415,43358415
28890,111,1805900,2,12,2,38,526,43358526
28891,1259,1805900,2,12,2,39,785,43359785
28892,1,1805900,1,12,2,39,786,43359786
28893,409,1805900,1,12,2,40,195,43360195
28894,1037,1805900,1,12,2,41,232,43361232
28895,4472,1805800,1,12,2,45,704,43365704
28896,410,1805800,1,12,2,46,114,43366114
28897,1605,1805900,1,12,2,47,719,43367719
28898,1,1806000,1,12,2,47,720,43367720
28899,0,1806000,1,12,2,47,720,43367720
28900,7581,1805900,1,12,2,55,301,43375301
28901,1917,1805900,2,12,2,57,218,43377218
28902,2428,1806000,2,12,2,59,646,43379646
28903,1079,1805900,1,12,3,0,725,43380725
28904,359,1806000,1,12,3,1,84,43381084
28905,220,1805900,1,12,3,1,304,43381304
28906,975,1806000,6,12,3,2,279,43382279
28907,2379,1806000,1,12,3,4,658,43384658
28908,8062,1805900,1,12,3,12,720,43392720
28909,1980,1806000,2,12,3,14,700,43394700
28910,6484,1805900,1,12,3,21,184,43401184
28911,382,1805900,1,12,3,21,566,43401566
28912,642,1805800,4,12,3,22,208,43402208
28913,1,1805800,6,12,3,22,209,43402209
28914,3105,1805900,2,12,3,25,314,43405314
28915,8896,1805900,5,12,3,34,210,43414210
28916,51,1805900,1,12,3,34,261,43414261
28917,137,1805800,5,12,3,34,398,43414398
28918,1530,1805800,1,12,3,35,928,43415928
28919,2686,1805900,1,12,3,38,614,43418614
28920,0,1805900,1,12,3,38,614,43418614
28921,0,1805900,1,12,3,38,614,43418614
28922,0,1805900,1,12,3,38,614,43418614
28924,12,1806200,2,12,3,38,626,43418626
28925,20,1806200,1,12,3,38,646,43418646
28926,11,1806200,1,12,3,38,657,43418657
28927,12,1806200,5,12,3,38,669,43418669
28928,28,1806300,5,12,3,38,697,43418697
28929,1,1806300,17,12,3,38,698,43418698
28930,2,1806300,1,12,3,38,700,43418700
28931,4,1806400,5,12,3,38,704,43418704
28932,2,1806400,3,12,3,38,706,43418706
28933,1,1806400,1,12,3,38,707,43418707
28934,12,1806400,10,12,3,38,719,43418719
28935,37,1806500,1,12,3,38,756,43418756
28936,24,1806400,5,12,3,38,780,43418780
28938,40,1806400,3,12,3,38,820,43418820
28939,11,1806400,3,12,3,38,831,43418831
28940,2,1806400,1,12,3,38,833,43418833
28941,30,1806300,1,12,3,38,863,43418863
28942,56,1806300,1,12,3,38,919,43418919
28943,42,1806500,1,12,3,38,961,43418961
28944,81,1806300,1,12,3,39,42,43419042
28945,403,1806500,1,12,3,39,445,43419445
28946,584,1806300,1,12,3,40,29,43420029
28947,715,1806500,1,12,3,40,744,43420744
28948,0,1806500,1,12,3,40,744,43420744
28949,1,1806500,1,12,3,40,745,43420745
28950,0,1806500,5,12,3,40,745,43420745
28951,0,1806500,3,12,3,40,745,43420745
28952,105,1806600,11,12,3,40,850,43420850
28953,0,1806600,1,12,3,40,850,43420850
28954,0,1806600,7,12,3,40,850,43420850
28955,0,1806600,1,12,3,40,850,43420850
28956,0,1806600,1,12,3,40,850,43420850
28957,46,1806700,4,12,3,40,896,43420896
28958,36,1806700,2,12,3,40,932,43420932
28959,83,1806700,1,12,3,41,15,43421015
28960,22,1806700,2,12,3,41,37,43421037
28961,49,1806700,1,12,3,41,86,43421086
28962,27,1806700,1,12,3,41,113,43421113
28963,10,1806700,1,12,3,41,123,43421123
28964,57,1806700,1,12,3,41,180,43421180
28965,228,1806700,2,12,3,41,408,43421408
28966,1068,1806700,5,12,3,42,476,43422476
28967,650,1806700,3,12,3,43,126,43423126
28968,0,1806700,3,12,3,43,126,43423126
28970,3,1806900,1,12,3,43,129,43423129
28971,1,1806900,1,12,3,43,130,43423130
28973,0,1806900,1,12,3,43,130,43423130
28974,4,1806900,1,12,3,43,134,43423134
28975,43,1806900,3,12,3,43,177,43423177
28976,24,1806900,2,12,3,43,201,43423201
28977,149,1806800,1,12,3,43,350,43423350
28978,258,1806800,1,12,3,43,608,43423608
28979,85,1806800,5,12,3,43,693,43423693
28980,50,1806800,5,12,3,43,743,43423743
28981,129,1806800,1,12,3,43,872,43423872
28982,144,1806800,1,12,3,44,16,43424016
28983,706,1806900,1,12,3,44,722,43424722
28984,871,1806900,1,12,3,45,593,43425593
28985,225,1806900,1,12,3,45,818,43425818
28986,331,1806800,6,12,3,46,149,43426149
28987,0,1806800,6,12,3,46,149,43426149
28988,0,1806800,6,12,3,46,149,43426149
28990,3,1806600,1,12,3,46,152,43426152
28991,2,1806600,1,12,3,46,154,43426154
28992,0,1806600,1,12,3,46,154,43426154
28993,28,1806500,3,12,3,46,182,43426182
28994,4,1806500,1,12,3,46,186,43426186
28995,143,1806500,3,12,3,46,329,43426329
28996,225,1806500,2,12,3,46,554,43426554
28997,280,1806500,1,12,3,46,834,43426834
28998,20,1806300,5,12,3,46,854,43426854
28999,30,1806500,1,12,3,46,884,43426884
29000,594,1806500,1,12,3,47,478,43427478
29001,1235,1806400,1,12,3,48,713,43428713
29002,299,1806400,1,12,3,49,12,43429012
29003,436,1806500,1,12,3,49,448,43429448
29004,292,1806400,1,12,3,49,740,43429740
29005,97,1806400,1,12,3,49,837,43429837
29006,87,1806400,1,12,3,49,924,43429924
29007,240,1806400,1,12,3,50,164,43430164
29008,410,1806400,1,12,3,50,574,43430574
29009,559,1806400,1,12,3,51,133,43431133
29010,2,1806400,1,12,3,51,135,43431135
29011,1237,1806300,1,12,3,52,372,43432372
29012,576,1806500,1,12,3,52,948,43432948
29013,1611,1806300,1,12,3,54,559,43434559
29014,824,1806300,5,12,3,55,383,43435383
29016,5,1806100,7,12,3,55,388,43435388
29017,31,1806000,5,12,3,55,419,43435419
29018,31,1805900,3,12,3,55,450,43435450
29019,51,1806000,1,12,3,55,501,43435501
29020,8,1805800,1,12,3,55,509,43435509
29021,116,1806000,1,12,3,55,625,43435625
29022,45,1806000,3,12,3,55,670,43435670
29023,27,1806000,1,12,3,55,697,43435697
29024,23,1806000,3,12,3,55,720,43435720
29025,31,1806100,1,12,3,55,751,43435751
29026,41,1806000,2,12,3,55,792,43435792
29027,20,1806100,1,12,3,55,812,43435812
29028,12,1806100,1,12,3,55,824,43435824
29029,40,1806100,1,12,3,55,864,43435864
29030,12,1806100,1,12,3,55,876,43435876
29031,8,1806100,1,12,3,55,884,43435884
29032,56,1806100,1,12,3,55,940,43435940
29033,20,1806100,1,12,3,55,960,43435960
29034,40,1806100,1,12,3,56,0,43436000
29035,108,1806100,1,12,3,56,108,43436108
29036,18,1806100,1,12,3,56,126,43436126
29037,3,1806100,1,12,3,56,129,43436129
29038,43,1806100,1,12,3,56,172,43436172
29039,77,1806100,1,12,3,56,249,43436249
29040,128,1806100,1,12,3,56,377,43436377
29041,1055,1806000,1,12,3,57,432,43437432
29042,3533,1806100,1,12,4,0,965,43440965
29043,619,1806200,3,12,4,1,584,43441584
29044,2146,1806200,3,12,4,3,730,43443730
29045,48,1806100,2,12,4,3,778,43443778
29046,3,1806000,5,12,4,3,781,43443781
29047,2,1805900,2,12,4,3,783,43443783
29048,98,1805800,5,12,4,3,881,43443881
29049,342,1805800,1,12,4,4,223,43444223
29050,0,1805800,1,12,4,4,223,43444223
29051,1753,1805800,1,12,4,5,976,43445976
29052,826,1805900,4,12,4,6,802,43446802
29053,2872,1805900,1,12,4,9,674,43449674
29054,2276,1805800,1,12,4,11,950,43451950
29055,2091,1805900,1,12,4,14,41,43454041
29056,4946,1805900,1,12,4,18,987,43458987
29057,2383,1805900,1,12,4,21,370,43461370
29058,1120,1805900,1,12,4,22,490,43462490
29059,1670,1805900,1,12,4,24,160,43464160
29060,448,1805800,2,12,4,24,608,43464608
29061,1,1805800,5,12,4,24,609,43464609
29062,2974,1805800,1,12,4,27,583,43467583
29063,2762,1805700,1,12,4,30,345,43470345
29064,35,1805800,1,12,4,30,380,43470380
29065,235,1805800,1,12,4,30,615,43470615
29066,2581,1805800,1,12,4,33,196,43473196
29067,2560,1805700,1,12,4,35,756,43475756
29068,44,1805800,1,12,4,35,800,43475800
29069,1002,1805800,1,12,4,36,802,43476802
29070,3125,1805800,2,12,4,39,927,43479927
29071,6795,1805900,3,12,4,46,722,43486722
29072,1960,1805900,2,12,4,48,682,43488682
29073,4881,1805800,1,12,4,53,563,43493563
29074,1014,1805900,3,12,4,54,577,43494577
29075,10156,1805900,1,12,5,4,733,43504733
29076,464,1805800,2,12,5,5,197,43505197
29077,0,1805800,4,12,5,5,197,43505197
29078,21,1805900,1,12,5,5,218,43505218
29079,177,1805700,3,12,5,5,395,43505395
29080,494,1805800,1,12,5,5,889,43505889
29081,81,1805800,1,12,5,5,970,43505970
29082,1793,1805800,1,12,5,7,763,43507763
29083,1035,1805800,1,12,5,8,798,43508798
29084,0,1805800,2,12,5,8,798,43508798
29085,667,1805900,1,12,5,9,465,43509465
29086,1221,1805900,1,12,5,10,686,43510686
29087,2109,1805800,1,12,5,12,795,43512795
29088,1026,1805900,1,12,5,13,821,43513821
29089,7480,1805700,1,12,5,21,301,43521301
29090,2401,1805900,2,12,5,23,702,43523702
29091,588,1805700,1,12,5,24,290,43524290
29092,751,1805800,1,12,5,25,41,43525041
29093,619,1805700,5,12,5,25,660,43525660
29094,825,1805900,2,12,5,26,485,43526485
29095,1439,1805800,2,12,5,27,924,43527924
29096,168,1805800,1,12,5,28,92,43528092
29097,3171,1805800,1,12,5,31,263,43531263
29098,1280,1805900,1,12,5,32,543,43532543
29099,1,1805900,1,12,5,32,544,43532544
29100,0,1805800,1,12,5,32,544,43532544
29101,877,1805700,1,12,5,33,421,43533421
29102,2510,1805800,2,12,5,35,931,43535931
29103,378,1805800,1,12,5,36,309,43536309
29104,2234,1805800,2,12,5,38,543,43538543
29105,0,1805800,1,12,5,38,543,43538543
29106,312,1805700,9,12,5,38,855,43538855
29108,3,1805600,1,12,5,38,858,43538858
29109,1000,1805600,1,12,5,39,858,43539858
29110,3229,1805600,1,12,5,43,87,43543087
29111,511,1805700,1,12,5,43,598,43543598
29112,345,1805700,1,12,5,43,943,43543943
29113,1709,1805600,1,12,5,45,652,43545652
29114,92,1805600,4,12,5,45,744,43545744
29116,1422,1805500,5,12,5,47,166,43547166
29117,0,1805600,1,12,5,47,166,43547166
29118,737,1805500,1,12,5,47,903,43547903
29119,3120,1805500,5,12,5,51,23,43551023
29120,1144,1805400,2,12,5,52,167,43552167
29121,0,1805400,1,12,5,52,167,43552167
29122,0,1805400,4,12,5,52,167,43552167
29123,1001,1805400,1,12,5,53,168,43553168
29124,242,1805500,2,12,5,53,410,43553410
29125,787,1805300,4,12,5,54,197,43554197
29126,0,1805300,1,12,5,54,197,43554197
29127,0,1805300,5,12,5,54,197,43554197
29128,0,1805300,8,12,5,54,197,43554197
29129,186,1805200,5,12,5,54,383,43554383
29130,0,1805200,9,12,5,54,383,43554383
29131,148,1805300,1,12,5,54,531,43554531
29132,39,1805100,1,12,5,54,570,43554570
29133,3,1805300,1,12,5,54,573,43554573
29134,37,1805100,2,12,5,54,610,43554610
29135,14,1805100,1,12,5,54,624,43554624
29136,10,1805100,2,12,5,54,634,43554634
29137,83,1805100,4,12,5,54,717,43554717
29138,1115,1805100,1,12,5,55,832,43555832
29139,148,1805100,5,12,5,55,980,43555980
29140,1,1805100,14,12,5,55,981,43555981
29141,116,1805000,2,12,5,56,97,43556097
29142,32,1805000,7,12,5,56,129,43556129
29143,29,1805000,2,12,5,56,158,43556158
29144,813,1805000,2,12,5,56,971,43556971
29145,14,1805000,2,12,5,56,985,43556985
29146,102,1805100,1,12,5,57,87,43557087
29147,281,1805000,1,12,5,57,368,43557368
29148,105,1805000,1,12,5,57,473,43557473
29149,9,1805000,1,12,5,57,482,43557482
29150,7,1805000,1,12,5,57,489,43557489
29151,1,1805000,1,12,5,57,490,43557490
29152,2110,1805000,1,12,5,59,600,43559600
29153,26,1805000,1,12,5,59,626,43559626
29154,222,1805000,7,12,5,59,848,43559848
29155,1,1805000,24,12,5,59,849,43559849
29156,2,1804900,2,12,5,59,851,43559851
29157,135,1804900,1,12,5,59,986,43559986
29158,27,1804900,1,12,6,0,13,43560013
29159,18,1804900,1,12,6,0,31,43560031
29160,0,1804900,2,12,6,0,31,43560031
29161,38,1804900,1,12,6,0,69,43560069
29162,1,1805000,4,12,6,0,70,43560070
29163,42,1805000,3,12,6,0,112,43560112
29164,30,1805000,1,12,6,0,142,43560142
29165,18,1805000,4,12,6,0,160,43560160
29166,51,1805000,1,12,6,0,211,43560211
29167,0,1805000,1,12,6,0,211,43560211
29168,20,1805000,4,12,6,0,231,43560231
29169,14,1805000,3,12,6,0,245,43560245
29170,54,1805000,1,12,6,0,299,43560299
29171,56,1805000,2,12,6,0,355,43560355
29172,20,1805000,2,12,6,0,375,43560375
29173,175,1805000,1,12,6,0,550,43560550
29174,85,1805000,1,12,6,0,635,43560635
29176,796,1805000,1,12,6,1,431,43561431
29177,42,1805000,1,12,6,1,473,43561473
29178,136,1805000,4,12,6,1,609,43561609
29179,719,1805000,1,12,6,2,328,43562328
29180,134,1805000,1,12,6,2,462,43562462
29181,212,1805000,4,12,6,2,674,43562674
29182,316,1805100,2,12,6,2,990,43562990
29183,336,1805100,2,12,6,3,326,43563326
29184,917,1805200,1,12,6,4,243,43564243
29185,14,1805100,1,12,6,4,257,43564257
29186,1069,1805200,1,12,6,5,326,43565326
29187,189,1805400,2,12,6,5,515,43565515
29188,438,1805400,2,12,6,5,953,43565953
29189,272,1805400,1,12,6,6,225,43566225
29190,38,1805400,3,12,6,6,263,43566263
29191,55,1805500,1,12,6,6,318,43566318
29192,438,1805300,1,12,6,6,756,43566756
29193,643,1805400,1,12,6,7,399,43567399
29194,312,1805400,1,12,6,7,711,43567711
29195,1089,1805500,1,12,6,8,800,43568800
29196,1049,1805500,1,12,6,9,849,43569849
29197,446,1805400,1,12,6,10,295,43570295
29198,1750,1805400,1,12,6,12,45,43572045
29199,3657,1805400,1,12,6,15,702,43575702
29200,115,1805400,1,12,6,15,817,43575817
29201,787,1805400,1,12,6,16,604,43576604
29202,512,1805400,2,12,6,17,116,43577116
29203,998,1805500,1,12,6,18,114,43578114
29204,332,1805500,1,12,6,18,446,43578446
29205,277,1805500,1,12,6,18,723,43578723
29206,1967,1805500,1,12,6,20,690,43580690
29207,491,1805400,1,12,6,21,181,43581181
29208,659,1805400,1,12,6,21,840,43581840
29209,3128,1805500,4,12,6,24,968,43584968
29210,172,1805600,1,12,6,25,140,43585140
29211,32,1805700,1,12,6,25,172,43585172
29212,177,1805600,1,12,6,25,349,43585349
29214,332,1805500,1,12,6,25,681,43585681
29215,423,1805500,2,12,6,26,104,43586104
29216,636,1805500,1,12,6,26,740,43586740
29217,196,1805600,1,12,6,26,936,43586936
29218,3938,1805500,2,12,6,30,874,43590874
29219,998,1805600,1,12,6,31,872,43591872
29220,1051,1805500,7,12,6,32,923,43592923
29222,3,1805400,31,12,6,32,926,43592926
29223,1,1805300,3,12,6,32,927,43592927
29224,76,1805400,1,12,6,33,3,43593003
29225,90,1805400,3,12,6,33,93,43593093
29227,288,1805500,1,12,6,33,381,43593381
29228,1401,1805500,1,12,6,34,782,43594782
29229,4538,1805500,4,12,6,39,320,43599320
29230,1661,1805700,5,12,6,40,981,43600981
29231,820,1805500,11,12,6,41,801,43601801
29233,2,1805400,1,12,6,41,803,43601803
29234,1498,1805300,14,12,6,43,301,43603301
29235,608,1805200,1,12,6,43,909,43603909
29236,9083,1805300,1,12,6,52,992,43612992
29237,474,1805300,2,12,6,53,466,43613466
29238,1872,1805300,5,12,6,55,338,43615338
29239,2603,1805400,1,12,6,57,941,43617941
29240,937,1805300,2,12,6,58,878,43618878
29241,2235,1805300,1,12,7,1,113,43621113
29242,333,1805300,1,12,7,1,446,43621446
29243,249,1805300,1,12,7,1,695,43621695
29244,486,1805400,1,12,7,2,181,43622181
29245,804,1805400,1,12,7,2,985,43622985
29246,4027,1805300,1,12,7,7,12,43627012
29247,2,1805300,3,12,7,7,14,43627014
29248,181,1805300,1,12,7,7,195,43627195
29249,1222,1805200,2,12,7,8,417,43628417
29250,4910,1805400,1,12,7,13,327,43633327
29251,665,1805400,1,12,7,13,992,43633992
29252,207,1805400,1,12,7,14,199,43634199
29253,0,1805400,8,12,7,14,199,43634199
29254,0,1805400,1,12,7,14,199,43634199
29255,1,1805400,1,12,7,14,200,43634200
29256,0,1805400,8,12,7,14,200,43634200
29257,0,1805400,4,12,7,14,200,43634200
29258,0,1805400,5,12,7,14,200,43634200
29259,74,1805600,6,12,7,14,274,43634274
29260,2111,1805600,5,12,7,16,385,43636385
29261,4075,1805500,3,12,7,20,460,43640460
29262,1200,1805700,2,12,7,21,660,43641660
29263,207,1805700,5,12,7,21,867,43641867
29264,158,1805500,1,12,7,22,25,43642025
29265,632,1805500,1,12,7,22,657,43642657
29266,239,1805500,1,12,7,22,896,43642896
29267,2893,1805700,1,12,7,25,789,43645789
29268,861,1805700,2,12,7,26,650,43646650
29269,4988,1805700,2,12,7,31,638,43651638
29270,5391,1805700,2,12,7,37,29,43657029
29271,847,1805700,1,12,7,37,876,43657876
29272,1081,1805600,1,12,7,38,957,43658957
29273,0,1805600,1,12,7,38,957,43658957
29274,133,1805700,1,12,7,39,90,43659090
29275,5215,1805700,2,12,7,44,305,43664305
29276,2236,1805700,2,12,7,46,541,43666541
29277,4133,1805700,2,12,7,50,674,43670674
29278,714,1805500,10,12,7,51,388,43671388
29279,1,1805500,1,12,7,51,389,43671389
29280,232,1805500,3,12,7,51,621,43671621
29281,1,1805400,1,12,7,51,622,43671622
29282,507,1805500,1,12,7,52,129,43672129
29283,229,1805500,1,12,7,52,358,43672358
29284,1483,1805400,1,12,7,53,841,43673841
29285,278,1805400,1,12,7,54,119,43674119
29286,1635,1805300,1,12,7,55,754,43675754
29287,5378,1805300,9,12,8,1,132,43681132
29288,292,1805300,1,12,8,1,424,43681424
29289,114,1805200,1,12,8,1,538,43681538
29290,150,1805200,1,12,8,1,688,43681688
29291,0,1805200,21,12,8,1,688,43681688
29292,1,1805200,4,12,8,1,689,43681689
29293,0,1805200,5,12,8,1,689,43681689
29294,0,1805200,2,12,8,1,689,43681689
29295,27,1805200,1,12,8,1,716,43681716
29296,675,1805100,1,12,8,2,391,43682391
29297,0,1805100,3,12,8,2,391,43682391
29298,0,1805100,1,12,8,2,391,43682391
29299,0,1805100,2,12,8,2,391,43682391
29300,1,1805100,1,12,8,2,392,43682392
29301,0,1805100,1,12,8,2,392,43682392
29302,0,1805100,1,12,8,2,392,43682392
29303,1,1805100,1,12,8,2,393,43682393
29304,1551,1805100,1,12,8,3,944,43683944
29305,1120,1805000,4,12,8,5,64,43685064
29306,0,1805000,3,12,8,5,64,43685064
29307,63,1804900,1,12,8,5,127,43685127
29308,52,1805100,9,12,8,5,179,43685179
29309,1,1805100,6,12,8,5,180,43685180
29310,1,1805100,10,12,8,5,181,43685181
29311,136,1804900,4,12,8,5,317,43685317
29312,80,1805100,1,12,8,5,397,43685397
29313,124,1805100,1,12,8,5,521,43685521
29314,1999,1805000,2,12,8,7,520,43687520
29315,61,1805000,1,12,8,7,581,43687581
29316,2,1805000,9,12,8,7,583,43687583
29317,0,1805000,1,12,8,7,583,43687583
29318,1,1805000,1,12,8,7,584,43687584
29319,0,1805000,1,12,8,7,584,43687584
29320,0,1805000,11,12,8,7,584,43687584
29321,675,1805000,1,12,8,8,259,43688259
29322,66,1805000,1,12,8,8,325,43688325
29323,99,1805000,1,12,8,8,424,43688424
29324,388,1804900,1,12,8,8,812,43688812
29325,1,1804900,1,12,8,8,813,43688813
29326,0,1804900,1,12,8,8,813,43688813
29327,271,1804900,1,12,8,9,84,43689084
29328,11,1804900,1,12,8,9,95,43689095
29329,29,1804900,1,12,8,9,124,43689124
29330,196,1804900,2,12,8,9,320,43689320
29331,72,1804800,5,12,8,9,392,43689392
29332,1,1804800,7,12,8,9,393,43689393
29333,0,1804800,1,12,8,9,393,43689393
29334,0,1804800,1,12,8,9,393,43689393
29335,0,1804800,1,12,8,9,393,43689393
29336,0,1804800,20,12,8,9,393,43689393
29337,1,1804800,1,12,8,9,394,43689394
29338,0,1804800,1,12,8,9,394,43689394
29339,0,1804800,1,12,8,9,394,43689394
29340,0,1804800,5,12,8,9,394,43689394
29341,1,1804700,12,12,8,9,395,43689395
29342,1,1804700,4,12,8,9,396,43689396
29344,43,1804700,1,12,8,9,439,43689439
29345,43,1804600,2,12,8,9,482,43689482
29346,29,1804600,2,12,8,9,511,43689511
29347,17,1804600,2,12,8,9,528,43689528
29348,27,1804600,1,12,8,9,555,43689555
29349,4,1804600,1,12,8,9,559,43689559
29350,65,1804600,1,12,8,9,624,43689624
29351,24,1804600,1,12,8,9,648,43689648
29352,51,1804600,1,12,8,9,699,43689699
29353,5,1804600,1,12,8,9,704,43689704
29354,4,1804600,4,12,8,9,708,43689708
29355,18,1804600,1,12,8,9,726,43689726
29356,23,1804600,2,12,8,9,749,43689749
29357,26,1804600,1,12,8,9,775,43689775
29359,11,1804500,1,12,8,9,786,43689786
29360,56,1804700,1,12,8,9,842,43689842
29361,11,1804600,2,12,8,9,853,43689853
29362,45,1804500,1,12,8,9,898,43689898
29363,30,1804500,1,12,8,9,928,43689928
29364,0,1804500,2,12,8,9,928,43689928
29365,20,1804500,20,12,8,9,948,43689948
29366,101,1804500,1,12,8,10,49,43690049
29367,41,1804500,1,12,8,10,90,43690090
29368,13,1804500,1,12,8,10,103,43690103
29369,51,1804500,2,12,8,10,154,43690154
29370,202,1804500,1,12,8,10,356,43690356
29371,157,1804500,1,12,8,10,513,43690513
29372,112,1804500,1,12,8,10,625,43690625
29373,14,1804500,2,12,8,10,639,43690639
29375,77,1804500,2,12,8,10,716,43690716
29376,81,1804500,3,12,8,10,797,43690797
29377,111,1804600,1,12,8,10,908,43690908
29378,7,1804700,2,12,8,10,915,43690915
29379,127,1804500,2,12,8,11,42,43691042
29380,0,1804500,1,12,8,11,42,43691042
29381,1,1804400,1,12,8,11,43,43691043
29382,648,1804400,1,12,8,11,691,43691691
29383,53,1804600,1,12,8,11,744,43691744
29384,17,1804400,1,12,8,11,761,43691761
29385,54,1804400,1,12,8,11,815,43691815
29386,100,1804400,4,12,8,11,915,43691915
29387,14,1804500,2,12,8,11,929,43691929
29388,357,1804500,1,12,8,12,286,43692286
29389,216,1804600,5,12,8,12,502,43692502
29390,0,1804600,5,12,8,12,502,43692502
29391,0,1804600,5,12,8,12,502,43692502
29393,185,1804800,8,12,8,12,687,43692687
29394,25,1804800,1,12,8,12,712,43692712
29396,18,1804600,1,12,8,12,730,43692730
29397,73,1804600,2,12,8,12,803,43692803
29398,101,1804700,1,12,8,12,904,43692904
29399,20,1804700,1,12,8,12,924,43692924
29400,117,1804600,2,12,8,13,41,43693041
29401,55,1804600,2,12,8,13,96,43693096
29402,203,1804800,1,12,8,13,299,43693299
29403,218,1804800,7,12,8,13,517,43693517
29404,40,1804800,3,12,8,13,557,43693557
29405,622,1804900,1,12,8,14,179,43694179
29406,387,1804900,1,12,8,14,566,43694566
29407,300,1804900,4,12,8,14,866,43694866
29408,1,1804900,2,12,8,14,867,43694867
29409,88,1805000,1,12,8,14,955,43694955
29410,367,1805000,1,12,8,15,322,43695322
29411,400,1805000,1,12,8,15,722,43695722
29412,199,1805000,8,12,8,15,921,43695921
29413,2,1805100,2,12,8,15,923,43695923
29414,272,1805200,1,12,8,16,195,43696195
29415,475,1805100,1,12,8,16,670,43696670
29416,2022,1805100,3,12,8,18,692,43698692
29417,1024,1805100,1,12,8,19,716,43699716
29418,833,1805000,1,12,8,20,549,43700549
29419,264,1805100,1,12,8,20,813,43700813
29420,365,1805100,1,12,8,21,178,43701178
29421,208,1805000,1,12,8,21,386,43701386
29422,8,1805000,2,12,8,21,394,43701394
29423,176,1805000,1,12,8,21,570,43701570
29424,16,1804900,1,12,8,21,586,43701586
29425,495,1804900,1,12,8,22,81,43702081
29426,710,1805100,2,12,8,22,791,43702791
29427,211,1805100,5,12,8,23,2,43703002
29428,369,1805100,1,12,8,23,371,43703371
29429,220,1805100,1,12,8,23,591,43703591
29430,305,1805000,1,12,8,23,896,43703896
29431,135,1805100,1,12,8,24,31,43704031
29432,88,1805100,1,12,8,24,119,43704119
29433,531,1805000,1,12,8,24,650,43704650
29434,1490,1805200,1,12,8,26,140,43706140
29435,283,1805200,1,12,8,26,423,43706423
29436,711,1805200,1,12,8,27,134,43707134
29437,222,1805100,1,12,8,27,356,43707356
29438,551,1805100,2,12,8,27,907,43707907
29439,336,1805100,1,12,8,28,243,43708243
29440,862,1805200,1,12,8,29,105,43709105
29441,923,1805100,1,12,8,30,28,43710028
29442,243,1805100,1,12,8,30,271,43710271
29443,96,1805000,1,12,8,30,367,43710367
29444,1458,1805000,5,12,8,31,825,43711825
29445,53,1805000,1,12,8,31,878,43711878
29446,1936,1805000,1,12,8,33,814,43713814
29447,3063,1805000,1,12,8,36,877,43716877
29448,1757,1805000,1,12,8,38,634,43718634
29449,0,1805000,8,12,8,38,634,43718634
29450,281,1805000,1,12,8,38,915,43718915
29451,861,1805100,2,12,8,39,776,43719776
29452,5,1805100,1,12,8,39,781,43719781
29453,614,1805000,1,12,8,40,395,43720395
29454,1466,1805000,5,12,8,41,861,43721861
29455,231,1805000,1,12,8,42,92,43722092
29456,48,1805000,1,12,8,42,140,43722140
29457,2044,1805000,1,12,8,44,184,43724184
29458,16,1805000,1,12,8,44,200,43724200
29459,229,1805000,1,12,8,44,429,43724429
29460,563,1805000,1,12,8,44,992,43724992
29461,749,1805000,1,12,8,45,741,43725741
29462,7975,1805000,3,12,8,53,716,43733716
29463,273,1805000,1,12,8,53,989,43733989
29464,1705,1805000,2,12,8,55,694,43735694
29465,1860,1804900,6,12,8,57,554,43737554
29466,897,1804900,5,12,8,58,451,43738451
29467,0,1804900,1,12,8,58,451,43738451
29468,375,1804800,1,12,8,58,826,43738826
29469,10,1804800,1,12,8,58,836,43738836
29470,117,1804800,1,12,8,58,953,43738953
29471,202,1804900,1,12,8,59,155,43739155
29472,26,1804800,2,12,8,59,181,43739181
29473,303,1804800,2,12,8,59,484,43739484
29474,1,1804800,2,12,8,59,485,43739485
29475,300,1804700,1,12,8,59,785,43739785
29476,29,1804700,2,12,8,59,814,43739814
29477,1,1804700,1,12,8,59,815,43739815
29478,647,1804800,3,12,9,0,462,43740462
29479,1,1804700,3,12,9,0,463,43740463
29480,174,1804800,1,12,9,0,637,43740637
29481,32,1804700,2,12,9,0,669,43740669
29482,46,1804600,1,12,9,0,715,43740715
29483,150,1804800,7,12,9,0,865,43740865
29484,0,1804800,7,12,9,0,865,43740865
29485,0,1804800,7,12,9,0,865,43740865
29487,22,1805100,1,12,9,0,887,43740887
29488,0,1805100,2,12,9,0,887,43740887
29489,21,1805100,2,12,9,0,908,43740908
29490,0,1805100,2,12,9,0,908,43740908
29491,8,1805100,1,12,9,0,916,43740916
29492,6,1805100,1,12,9,0,922,43740922
29493,9,1805200,2,12,9,0,931,43740931
29494,1,1805000,1,12,9,0,932,43740932
29495,25,1805100,5,12,9,0,957,43740957
29496,16,1805100,5,12,9,0,973,43740973
29497,1,1805100,1,12,9,0,974,43740974
29498,1,1805100,1,12,9,0,975,43740975
29499,0,1805100,1,12,9,0,975,43740975
29500,111,1805100,1,12,9,1,86,43741086
29501,58,1805000,1,12,9,1,144,43741144
29502,0,1805000,1,12,9,1,144,43741144
29503,24,1804900,2,12,9,1,168,43741168
29504,67,1804900,2,12,9,1,235,43741235
29505,26,1804900,2,12,9,1,261,43741261
29506,18,1804900,1,12,9,1,279,43741279
29507,22,1804900,1,12,9,1,301,43741301
29508,284,1805000,1,12,9,1,585,43741585
29509,0,1805000,1,12,9,1,585,43741585
29510,1,1805000,2,12,9,1,586,43741586
29511,10,1804900,1,12,9,1,596,43741596
29512,0,1804900,1,12,9,1,596,43741596
29513,12,1804900,2,12,9,1,608,43741608
29514,8,1804900,2,12,9,1,616,43741616
29515,71,1804800,1,12,9,1,687,43741687
29516,33,1804900,1,12,9,1,720,43741720
29517,524,1805100,1,12,9,2,244,43742244
29518,151,1805000,1,12,9,2,395,43742395
29519,55,1805000,1,12,9,2,450,43742450
29520,664,1805000,1,12,9,3,114,43743114
29521,34,1805000,1,12,9,3,148,43743148
29522,278,1805000,1,12,9,3,426,43743426
29523,75,1805000,1,12,9,3,501,43743501
29524,173,1805000,2,12,9,3,674,43743674
29525,1042,1805000,1,12,9,4,716,43744716
29526,1526,1805000,1,12,9,6,242,43746242
29527,80,1805000,1,12,9,6,322,43746322
29528,1004,1805000,3,12,9,7,326,43747326
29529,469,1805000,1,12,9,7,795,43747795
29530,3022,1805000,1,12,9,10,817,43750817
29531,570,1805000,1,12,9,11,387,43751387
29532,2524,1805000,1,12,9,13,911,43753911
29533,1327,1805000,1,12,9,15,238,43755238
29534,0,1805000,2,12,9,15,238,43755238
29535,0,1805000,1,12,9,15,238,43755238
29536,165,1805000,1,12,9,15,403,43755403
29537,23,1805000,1,12,9,15,426,43755426
29538,175,1805000,1,12,9,15,601,43755601
29539,1983,1804900,1,12,9,17,584,43757584
29540,413,1805000,2,12,9,17,997,43757997
29541,578,1805000,2,12,9,18,575,43758575
29543,30,1805200,1,12,9,18,605,43758605
29544,0,1805200,2,12,9,18,605,43758605
29545,0,1805200,4,12,9,18,605,43758605
29546,0,1805200,1,12,9,18,605,43758605
29547,0,1805200,1,12,9,18,605,43758605
29548,11,1805200,3,12,9,18,616,43758616
29549,58,1805200,1,12,9,18,674,43758674
29550,474,1805100,2,12,9,19,148,43759148
29551,2978,1805100,1,12,9,22,126,43762126
29552,2456,1805100,1,12,9,24,582,43764582
29553,1076,1805100,1,12,9,25,658,43765658
29554,572,1805100,1,12,9,26,230,43766230
29555,0,1805100,1,12,9,26,230,43766230
29556,416,1805200,1,12,9,26,646,43766646
29557,1127,1805100,1,12,9,27,773,43767773
29558,394,1805200,1,12,9,28,167,43768167
29559,425,1805100,1,12,9,28,592,43768592
29560,1806,1805200,1,12,9,30,398,43770398
29561,915,1805200,2,12,9,31,313,43771313
29562,560,1805100,1,12,9,31,873,43771873
29563,151,1805100,2,12,9,32,24,43772024
29564,0,1805100,1,12,9,32,24,43772024
29565,1382,1805100,2,12,9,33,406,43773406
29566,685,1805200,1,12,9,34,91,43774091
29567,1068,1805100,1,12,9,35,159,43775159
29568,1171,1805100,1,12,9,36,330,43776330
29569,0,1805100,8,12,9,36,330,43776330
29570,0,1805100,1,12,9,36,330,43776330
29571,0,1805100,1,12,9,36,330,43776330
29572,0,1805100,7,12,9,36,330,43776330
29573,1,1805100,1,12,9,36,331,43776331
29574,0,1805100,1,12,9,36,331,43776331
29575,0,1805100,4,12,9,36,331,43776331
29576,40,1805000,2,12,9,36,371,43776371
29577,0,1804900,1,12,9,36,371,43776371
29578,0,1804900,1,12,9,36,371,43776371
29579,0,1804900,2,12,9,36,371,43776371
29580,1543,1804900,1,12,9,37,914,43777914
29581,268,1804900,1,12,9,38,182,43778182
29582,3090,1804900,1,12,9,41,272,43781272
29583,0,1804900,1,12,9,41,272,43781272
29584,535,1804900,1,12,9,41,807,43781807
29585,2086,1804900,1,12,9,43,893,43783893
29586,2820,1804900,1,12,9,46,713,43786713
29587,121,1804900,1,12,9,46,834,43786834
29589,2235,1805000,7,12,9,49,69,43789069
29590,137,1804900,1,12,9,49,206,43789206
29591,1812,1805000,1,12,9,51,18,43791018
29592,699,1804900,1,12,9,51,717,43791717
29593,92,1804900,1,12,9,51,809,43791809
29594,1441,1804900,1,12,9,53,250,43793250
29595,1565,1804900,1,12,9,54,815,43794815
29596,292,1805000,6,12,9,55,107,43795107
29597,236,1805000,3,12,9,55,343,43795343
29598,1157,1805000,1,12,9,56,500,43796500
29599,298,1805000,1,12,9,56,798,43796798
29600,487,1805100,3,12,9,57,285,43797285
29601,730,1805000,1,12,9,58,15,43798015
29602,914,1805100,3,12,9,58,929,43798929
29603,81,1805000,3,12,9,59,10,43799010
29604,1929,1805200,3,12,10,0,939,43800939
29605,429,1805100,1,12,10,1,368,43801368
29606,1496,1805100,1,12,10,2,864,43802864
29607,418,1805200,1,12,10,3,282,43803282
29608,29,1805000,4,12,10,3,311,43803311
29609,110,1805000,2,12,10,3,421,43803421
29610,875,1805200,3,12,10,4,296,43804296
29611,182,1805100,1,12,10,4,478,43804478
29612,1066,1805000,4,12,10,5,544,43805544
29613,149,1805000,1,12,10,5,693,43805693
29614,168,1805000,4,12,10,5,861,43805861
29615,96,1805000,1,12,10,5,957,43805957
29616,346,1805000,5,12,10,6,303,43806303
29617,131,1804900,2,12,10,6,434,43806434
29618,0,1804900,2,12,10,6,434,43806434
29619,116,1804900,1,12,10,6,550,43806550
29620,64,1804900,1,12,10,6,614,43806614
29621,88,1804900,1,12,10,6,702,43806702
29622,12,1804900,1,12,10,6,714,43806714
29623,68,1804900,1,12,10,6,782,43806782
29624,48,1804900,1,12,10,6,830,43806830
29625,1797,1804900,2,12,10,8,627,43808627
29626,1425,1804900,1,12,10,10,52,43810052
29627,418,1805000,1,12,10,10,470,43810470
29628,108,1805000,1,12,10,10,578,43810578
29629,1338,1805000,1,12,10,11,916,43811916
29630,399,1805000,2,12,10,12,315,43812315
29631,696,1805000,2,12,10,13,11,43813011
29632,2906,1805000,1,12,10,15,917,43815917
29633,473,1805000,1,12,10,16,390,43816390
29634,52,1805000,1,12,10,16,442,43816442
29635,208,1805000,1,12,10,16,650,43816650
29636,62,1805000,1,12,10,16,712,43816712
29637,1740,1805100,1,12,10,18,452,43818452
29638,210,1805000,1,12,10,18,662,43818662
29639,117,1805000,3,12,10,18,779,43818779
29640,410,1805000,1,12,10,19,189,43819189
29641,357,1805000,2,12,10,19,546,43819546
29642,1675,1805000,1,12,10,21,221,43821221
29643,154,1805000,1,12,10,21,375,43821375
29644,410,1805000,1,12,10,21,785,43821785
29645,216,1805000,1,12,10,22,1,43822001
29646,1408,1805000,1,12,10,23,409,43823409
29647,377,1805000,1,12,10,23,786,43823786
29648,344,1805000,1,12,10,24,130,43824130
29649,39,1805100,7,12,10,24,169,43824169
29650,2,1805200,1,12,10,24,171,43824171
29651,0,1805200,2,12,10,24,171,43824171
29652,0,1805200,1,12,10,24,171,43824171
29653,0,1805200,1,12,10,24,171,43824171
29654,0,1805200,6,12,10,24,171,43824171
29655,0,1805300,1,12,10,24,171,43824171
29656,11,1805300,5,12,10,24,182,43824182
29657,1,1805300,1,12,10,24,183,43824183
29658,0,1805300,6,12,10,24,183,43824183
29659,0,1805300,1,12,10,24,183,43824183
29660,193,1805300,1,12,10,24,376,43824376
29661,124,1805300,1,12,10,24,500,43824500
29662,124,1805200,1,12,10,24,624,43824624
29663,127,1805200,1,12,10,24,751,43824751
29664,123,1805200,1,12,10,24,874,43824874
29665,125,1805200,1,12,10,24,999,43824999
29666,1603,1805200,1,12,10,26,602,43826602
29667,299,1805200,1,12,10,26,901,43826901
29668,319,1805400,1,12,10,27,220,43827220
29669,1690,1805200,5,12,10,28,910,43828910
29670,51,1805400,1,12,10,28,961,43828961
29671,1,1805400,3,12,10,28,962,43828962
29672,4122,1805300,5,12,10,33,84,43833084
29673,2645,1805300,1,12,10,35,729,43835729
29674,2139,1805200,2,12,10,37,868,43837868
29675,988,1805200,1,12,10,38,856,43838856
29676,2905,1805200,1,12,10,41,761,43841761
29677,887,1805200,2,12,10,42,648,43842648
29678,3148,1805200,1,12,10,45,796,43845796
29679,186,1805200,3,12,10,45,982,43845982
29680,72,1805200,1,12,10,46,54,43846054
29681,2542,1805100,1,12,10,48,596,43848596
29682,184,1805200,2,12,10,48,780,43848780
29683,1996,1805200,1,12,10,50,776,43850776
29684,1610,1805200,1,12,10,52,386,43852386
29685,1689,1805200,1,12,10,54,75,43854075
29686,616,1805200,1,12,10,54,691,43854691
29687,1620,1805200,1,12,10,56,311,43856311
29688,1043,1805200,1,12,10,57,354,43857354
29689,442,1805200,7,12,10,57,796,43857796
29690,1,1805200,3,12,10,57,797,43857797
29691,167,1805200,1,12,10,57,964,43857964
29692,1706,1805100,1,12,10,59,670,43859670
29693,2032,1805200,1,12,11,1,702,43861702
29694,0,1805200,1,12,11,1,702,43861702
29695,290,1805100,1,12,11,1,992,43861992
29696,410,1805100,1,12,11,2,402,43862402
29697,1279,1805100,1,12,11,3,681,43863681
29698,2362,1805100,1,12,11,6,43,43866043
29699,10,1805100,1,12,11,6,53,43866053
29700,34,1805100,1,12,11,6,87,43866087
29701,61,1805100,3,12,11,6,148,43866148
29702,526,1805100,1,12,11,6,674,43866674
29703,2952,1805100,1,12,11,9,626,43869626
29704,54,1805100,1,12,11,9,680,43869680
29705,3309,1805100,1,12,11,12,989,43872989
29706,1164,1805100,1,12,11,14,153,43874153
29707,241,1805100,2,12,11,14,394,43874394
29708,2582,1805100,1,12,11,16,976,43876976
29709,34,1805100,1,12,11,17,10,43877010
29710,53,1805100,1,12,11,17,63,43877063
29711,105,1805100,1,12,11,17,168,43877168
29712,2825,1805100,1,12,11,19,993,43879993
29713,52,1805100,1,12,11,20,45,43880045
29714,1579,1805100,3,12,11,21,624,43881624
29715,384,1805100,95,12,11,22,8,43882008
29716,0,1805100,3,12,11,22,8,43882008
29717,0,1805100,3,12,11,22,8,43882008
29718,0,1805100,2,12,11,22,8,43882008
29719,0,1805100,1,12,11,22,8,43882008
29720,0,1805100,1,12,11,22,8,43882008
29721,0,1805100,8,12,11,22,8,43882008
29722,0,1805100,1,12,11,22,8,43882008
29723,1,1805100,1,12,11,22,9,43882009
29724,0,1805100,3,12,11,22,9,43882009
29725,0,1805100,6,12,11,22,9,43882009
29726,0,1805100,1,12,11,22,9,43882009
29727,0,1805100,1,12,11,22,9,43882009
29728,0,1805100,2,12,11,22,9,43882009
29729,0,1805100,1,12,11,22,9,43882009
29730,0,1805100,1,12,11,22,9,43882009
29731,1,1805100,1,12,11,22,10,43882010
29732,49,1805100,9,12,11,22,59,43882059
29733,0,1805100,9,12,11,22,59,43882059
29734,74,1805100,1,12,11,22,133,43882133
29735,1861,1805100,1,12,11,23,994,43883994
29736,5448,1805200,8,12,11,29,442,43889442
29738,4,1805300,26,12,11,29,446,43889446
29739,729,1805300,1,12,11,30,175,43890175
29740,23,1805400,3,12,11,30,198,43890198
29741,0,1805400,25,12,11,30,198,43890198
29742,2,1805500,3,12,11,30,200,43890200
29743,838,1805500,4,12,11,31,38,43891038
29744,64,1805300,1,12,11,31,102,43891102
29745,14,1805300,1,12,11,31,116,43891116
29746,57,1805300,1,12,11,31,173,43891173
29747,1877,1805500,4,12,11,33,50,43893050
29748,0,1805500,2,12,11,33,50,43893050
29749,1,1805500,6,12,11,33,51,43893051
29750,0,1805500,2,12,11,33,51,43893051
29751,0,1805500,1,12,11,33,51,43893051
29752,0,1805500,7,12,11,33,51,43893051
29753,0,1805500,1,12,11,33,51,43893051
29754,0,1805500,1,12,11,33,51,43893051
29755,1624,1805500,5,12,11,34,675,43894675
29756,1427,1805500,1,12,11,36,102,43896102
29757,1607,1805500,4,12,11,37,709,43897709
29758,1977,1805500,1,12,11,39,686,43899686
29759,0,1805600,15,12,11,39,686,43899686
29760,395,1805700,1,12,11,40,81,43900081
29761,398,1805600,3,12,11,40,479,43900479
29763,20,1805700,2,12,11,40,499,43900499
29764,789,1805600,1,12,11,41,288,43901288
29765,447,1805700,1,12,11,41,735,43901735
29766,1310,1805600,1,12,11,43,45,43903045
29767,1541,1805500,1,12,11,44,586,43904586
29768,989,1805500,1,12,11,45,575,43905575
29769,1574,1805600,1,12,11,47,149,43907149
29770,909,1805600,1,12,11,48,58,43908058
29771,172,1805600,2,12,11,48,230,43908230
29772,643,1805600,1,12,11,48,873,43908873
29773,206,1805500,1,12,11,49,79,43909079
29774,189,1805500,1,12,11,49,268,43909268
29775,147,1805500,1,12,11,49,415,43909415
29776,0,1805500,2,12,11,49,415,43909415
29777,487,1805400,1,12,11,49,902,43909902
29778,641,1805500,1,12,11,50,543,43910543
29779,232,1805400,1,12,11,50,775,43910775
29780,222,1805400,1,12,11,50,997,43910997
29781,0,1805400,5,12,11,50,997,43910997
29782,0,1805400,1,12,11,50,997,43910997
29783,578,1805500,2,12,11,51,575,43911575
29784,274,1805400,4,12,11,51,849,43911849
29785,2943,1805400,1,12,11,54,792,43914792
29786,1102,1805400,4,12,11,55,894,43915894
29787,419,1805400,1,12,11,56,313,43916313
29788,236,1805300,4,12,11,56,549,43916549
29789,3296,1805400,1,12,11,59,845,43919845
29790,1920,1805400,1,12,12,1,765,43921765
29791,550,1805500,11,12,12,2,315,43922315
29792,153,1805400,1,12,12,2,468,43922468
29793,242,1805400,1,12,12,2,710,43922710
29794,132,1805300,1,12,12,2,842,43922842
29795,1782,1805400,2,12,12,4,624,43924624
29796,786,1805400,1,12,12,5,410,43925410
29797,0,1805400,1,12,12,5,410,43925410
29798,1629,1805300,2,12,12,7,39,43927039
29799,3202,1805300,1,12,12,10,241,43930241
29800,1285,1805300,1,12,12,11,526,43931526
29801,9042,1805200,2,12,12,20,568,43940568
29802,107,1805300,1,12,12,20,675,43940675
29803,340,1805100,1,12,12,21,15,43941015
29804,3724,1805300,1,12,12,24,739,43944739
29805,3417,1805200,1,12,12,28,156,43948156
29806,540,1805200,2,12,12,28,696,43948696
29807,861,1805200,1,12,12,29,557,43949557
29808,491,1805100,1,12,12,30,48,43950048
29809,1908,1805200,1,12,12,31,956,43951956
29810,133,1805100,1,12,12,32,89,43952089
29811,616,1805100,1,12,12,32,705,43952705
29812,653,1805100,1,12,12,33,358,43953358
29813,570,1805200,1,12,12,33,928,43953928
29814,540,1805200,1,12,12,34,468,43954468
29815,4238,1805100,8,12,12,38,706,43958706
29816,544,1805000,6,12,12,39,250,43959250
29817,0,1805000,7,12,12,39,250,43959250
29818,933,1805000,1,12,12,40,183,43960183
29819,2855,1805000,5,12,12,43,38,43963038
29820,133,1805000,5,12,12,43,171,43963171
29821,449,1805000,1,12,12,43,620,43963620
29822,784,1805000,2,12,12,44,404,43964404
29823,1962,1805000,1,12,12,46,366,43966366
29824,101,1805000,1,12,12,46,467,43966467
29825,434,1805000,1,12,12,46,901,43966901
29826,338,1804900,2,12,12,47,239,43967239
29827,1923,1805000,1,12,12,49,162,43969162
29828,646,1805000,1,12,12,49,808,43969808
29829,1926,1804900,2,12,12,51,734,43971734
29830,952,1804900,3,12,12,52,686,43972686
29831,510,1805000,1,12,12,53,196,43973196
29832,2444,1804900,2,12,12,55,640,43975640
29833,273,1804900,2,12,12,55,913,43975913
29834,1565,1805000,1,12,12,57,478,43977478
29835,1238,1804900,5,12,12,58,716,43978716
29837,1237,1804800,1,12,12,59,953,43979953
29838,252,1804800,1,12,13,0,205,43980205
29839,83,1804800,5,12,13,0,288,43980288
29840,624,1804900,1,12,13,0,912,43980912
29841,55,1804900,1,12,13,0,967,43980967
29842,19,1804900,1,12,13,0,986,43980986
29843,1081,1804900,1,12,13,2,67,43982067
29844,2051,1804800,1,12,13,4,118,43984118
29845,1155,1804900,3,12,13,5,273,43985273
29846,23,1804900,1,12,13,5,296,43985296
29847,240,1804900,1,12,13,5,536,43985536
29848,523,1804900,1,12,13,6,59,43986059
29849,2500,1804900,1,12,13,8,559,43988559
29850,1907,1804800,1,12,13,10,466,43990466
29851,4148,1804900,1,12,13,14,614,43994614
29852,561,1804900,5,12,13,15,175,43995175
29853,1839,1804900,1,12,13,17,14,43997014
29854,228,1804900,1,12,13,17,242,43997242
29855,1967,1804900,1,12,13,19,209,43999209
29856,9027,1804800,2,12,13,28,236,44008236
29857,2748,1804900,1,12,13,30,984,44010984
29858,1099,1804800,1,12,13,32,83,44012083
29859,0,1804800,1,12,13,32,83,44012083
29860,2136,1804900,2,12,13,34,219,44014219
29861,1150,1804900,2,12,13,35,369,44015369
29862,3194,1804800,6,12,13,38,563,44018563
29863,2666,1804800,1,12,13,41,229,44021229
29864,220,1804800,1,12,13,41,449,44021449
29865,1691,1804800,1,12,13,43,140,44023140
29866,5754,1804900,1,12,13,48,894,44028894
29867,0,1804900,1,12,13,48,894,44028894
29868,4393,1804800,1,12,13,53,287,44033287
29869,2072,1804800,2,12,13,55,359,44035359
29870,4582,1804800,2,12,13,59,941,44039941
29871,583,1804800,4,12,14,0,524,44040524
29872,648,1804800,1,12,14,1,172,44041172
29873,3998,1804700,1,12,14,5,170,44045170
29874,1,1804700,4,12,14,5,171,44045171
29875,476,1804700,4,12,14,5,647,44045647
29876,163,1804700,1,12,14,5,810,44045810
29877,509,1804600,1,12,14,6,319,44046319
29878,165,1804600,5,12,14,6,484,44046484
29879,58,1804600,3,12,14,6,542,44046542
29881,753,1804500,1,12,14,7,295,44047295
29882,366,1804600,1,12,14,7,661,44047661
29883,726,1804500,1,12,14,8,387,44048387
29884,3478,1804500,1,12,14,11,865,44051865
29885,613,1804500,1,12,14,12,478,44052478
29886,1192,1804600,5,12,14,13,670,44053670
29887,1489,1804600,1,12,14,15,159,44055159
29888,510,1804500,2,12,14,15,669,44055669
29889,667,1804500,1,12,14,16,336,44056336
29890,1201,1804500,1,12,14,17,537,44057537
29891,97,1804500,1,12,14,17,634,44057634
29892,44,1804600,1,12,14,17,678,44057678
29893,2571,1804500,1,12,14,20,249,44060249
29894,1398,1804600,2,12,14,21,647,44061647
29895,24,1804500,1,12,14,21,671,44061671
29896,159,1804600,1,12,14,21,830,44061830
29897,2465,1804600,1,12,14,24,295,44064295
29898,1639,1804600,1,12,14,25,934,44065934
29899,507,1804600,1,12,14,26,441,44066441
29900,291,1804500,1,12,14,26,732,44066732
29901,930,1804500,1,12,14,27,662,44067662
29902,1411,1804600,1,12,14,29,73,44069073
29903,107,1804600,1,12,14,29,180,44069180
29904,535,1804600,1,12,14,29,715,44069715
29905,1351,1804600,1,12,14,31,66,44071066
29906,937,1804700,1,12,14,32,3,44072003
29907,204,1804500,1,12,14,32,207,44072207
29908,1362,1804600,1,12,14,33,569,44073569
29909,69,1804600,1,12,14,33,638,44073638
29910,1022,1804600,1,12,14,34,660,44074660
29911,80,1804500,1,12,14,34,740,44074740
29912,1901,1804600,1,12,14,36,641,44076641
29913,1055,1804700,1,12,14,37,696,44077696
29914,1952,1804600,2,12,14,39,648,44079648
29915,105,1804600,1,12,14,39,753,44079753
29916,469,1804500,1,12,14,40,222,44080222
29917,997,1804500,12,12,14,41,219,44081219
29919,58,1804400,2,12,14,41,277,44081277
29920,6,1804400,2,12,14,41,283,44081283
29921,0,1804400,2,12,14,41,283,44081283
29922,0,1804400,2,12,14,41,283,44081283
29923,58,1804400,1,12,14,41,341,44081341
29924,44,1804400,1,12,14,41,385,44081385
29925,13,1804400,1,12,14,41,398,44081398
29926,141,1804400,3,12,14,41,539,44081539
29928,22,1804300,1,12,14,41,561,44081561
29929,49,1804300,1,12,14,41,610,44081610
29930,5,1804300,1,12,14,41,615,44081615
29931,60,1804300,1,12,14,41,675,44081675
29932,6,1804300,5,12,14,41,681,44081681
29933,45,1804300,1,12,14,41,726,44081726
29934,7,1804400,2,12,14,41,733,44081733
29935,19,1804300,1,12,14,41,752,44081752
29936,35,1804300,1,12,14,41,787,44081787
29937,19,1804300,1,12,14,41,806,44081806
29938,87,1804400,1,12,14,41,893,44081893
29939,127,1804300,2,12,14,42,20,44082020
29940,31,1804300,2,12,14,42,51,44082051
29941,449,1804300,1,12,14,42,500,44082500
29942,168,1804300,1,12,14,42,668,44082668
29943,203,1804300,2,12,14,42,871,44082871
29944,125,1804300,1,12,14,42,996,44082996
29945,109,1804400,1,12,14,43,105,44083105
29946,36,1804400,1,12,14,43,141,44083141
29947,31,1804300,2,12,14,43,172,44083172
29948,177,1804400,1,12,14,43,349,44083349
29949,353,1804500,1,12,14,43,702,44083702
29950,27,1804400,2,12,14,43,729,44083729
29951,514,1804500,1,12,14,44,243,44084243
29952,342,1804400,1,12,14,44,585,44084585
29953,453,1804400,1,12,14,45,38,44085038
29954,37,1804400,1,12,14,45,75,44085075
29955,479,1804400,1,12,14,45,554,44085554
29956,211,1804400,1,12,14,45,765,44085765
29957,1781,1804600,1,12,14,47,546,44087546
29958,697,1804400,2,12,14,48,243,44088243
29959,4353,1804400,1,12,14,52,596,44092596
29960,632,1804400,2,12,14,53,228,44093228
29961,412,1804400,1,12,14,53,640,44093640
29962,967,1804500,1,12,14,54,607,44094607
29963,0,1804500,4,12,14,54,607,44094607
29964,1,1804500,1,12,14,54,608,44094608
29965,31,1804500,1,12,14,54,639,44094639
29966,15,1804400,2,12,14,54,654,44094654
29967,1480,1804400,1,12,14,56,134,44096134
29968,197,1804500,4,12,14,56,331,44096331
29969,2766,1804400,1,12,14,59,97,44099097
29970,261,1804400,1,12,14,59,358,44099358
29971,150,1804500,2,12,14,59,508,44099508
29972,152,1804400,5,12,14,59,660,44099660
29974,93,1804400,1,12,14,59,753,44099753
29975,582,1804400,2,12,15,0,335,44100335
29976,308,1804400,1,12,15,0,643,44100643
29977,110,1804300,1,12,15,0,753,44100753
29978,29,1804300,1,12,15,0,782,44100782
29979,176,1804500,1,12,15,0,958,44100958
29980,125,1804300,1,12,15,1,83,44101083
29981,58,1804400,2,12,15,1,141,44101141
29982,105,1804300,3,12,15,1,246,44101246
29983,204,1804200,2,12,15,1,450,44101450
29984,29,1804200,2,12,15,1,479,44101479
29985,5,1804200,5,12,15,1,484,44101484
29986,75,1804200,1,12,15,1,559,44101559
29987,29,1804200,4,12,15,1,588,44101588
29988,1,1804200,3,12,15,1,589,44101589
29989,41,1804200,1,12,15,1,630,44101630
29990,13,1804100,1,12,15,1,643,44101643
29991,53,1804100,1,12,15,1,696,44101696
29992,18,1804100,1,12,15,1,714,44101714
29993,27,1804100,1,12,15,1,741,44101741
29994,16,1804100,1,12,15,1,757,44101757
29995,58,1804100,1,12,15,1,815,44101815
29996,17,1804200,2,12,15,1,832,44101832
29997,74,1804100,1,12,15,1,906,44101906
29998,2,1804100,1,12,15,1,908,44101908
29999,88,1804100,1,12,15,1,996,44101996
30000,13,1804100,1,12,15,2,9,44102009
30001,12,1804100,1,12,15,2,21,44102021
30002,40,1804100,1,12,15,2,61,44102061
30003,11,1804100,1,12,15,2,72,44102072
30004,1,1804100,1,12,15,2,73,44102073
30005,5,1804100,1,12,15,2,78,44102078
30006,0,1804100,1,12,15,2,78,44102078
30007,2,1804100,1,12,15,2,80,44102080
30008,27,1804100,1,12,15,2,107,44102107
30009,0,1804000,1,12,15,2,107,44102107
30010,155,1804000,2,12,15,2,262,44102262
30011,7,1804000,1,12,15,2,269,44102269
30012,72,1804000,1,12,15,2,341,44102341
30013,14,1804000,1,12,15,2,355,44102355
30014,10,1804000,2,12,15,2,365,44102365
30015,5,1804000,1,12,15,2,370,44102370
30016,25,1804000,1,12,15,2,395,44102395
30017,14,1804000,1,12,15,2,409,44102409
30018,8,1804000,1,12,15,2,417,44102417
30019,15,1804000,1,12,15,2,432,44102432
30020,7,1804200,1,12,15,2,439,44102439
30021,57,1804000,2,12,15,2,496,44102496
30022,48,1804000,2,12,15,2,544,44102544
30023,66,1804100,2,12,15,2,610,44102610
30024,128,1804200,2,12,15,2,738,44102738
30025,9,1804000,1,12,15,2,747,44102747
30026,440,1804100,1,12,15,3,187,44103187
30027,0,1804200,2,12,15,3,187,44103187
30028,10,1804100,1,12,15,3,197,44103197
30029,52,1804100,1,12,15,3,249,44103249
30030,386,1804200,1,12,15,3,635,44103635
30031,144,1804200,1,12,15,3,779,44103779
30032,1,1804300,1,12,15,3,780,44103780
30033,2,1804200,2,12,15,3,782,44103782
30034,247,1804400,1,12,15,4,29,44104029
30035,43,1804400,1,12,15,4,72,44104072
30036,638,1804200,3,12,15,4,710,44104710
30037,91,1804200,3,12,15,4,801,44104801
30039,119,1804300,1,12,15,4,920,44104920
30040,1,1804300,1,12,15,4,921,44104921
30041,93,1804400,1,12,15,5,14,44105014
30042,22,1804200,1,12,15,5,36,44105036
30043,750,1804400,1,12,15,5,786,44105786
30044,846,1804300,1,12,15,6,632,44106632
30045,136,1804200,1,12,15,6,768,44106768
30046,547,1804200,3,12,15,7,315,44107315
30047,1353,1804200,1,12,15,8,668,44108668
30048,2549,1804200,2,12,15,11,217,44111217
30049,1428,1804200,1,12,15,12,645,44112645
30050,451,1804200,1,12,15,13,96,44113096
30051,91,1804100,6,12,15,13,187,44113187
30053,707,1804000,1,12,15,13,894,44113894
30054,57,1804000,1,12,15,13,951,44113951
30055,601,1804000,1,12,15,14,552,44114552
30056,989,1804100,2,12,15,15,541,44115541
30057,246,1804100,1,12,15,15,787,44115787
30058,2,1804100,1,12,15,15,789,44115789
30059,22,1804100,3,12,15,15,811,44115811
30060,8,1804100,1,12,15,15,819,44115819
30061,595,1804100,1,12,15,16,414,44116414
30062,362,1804000,1,12,15,16,776,44116776
30063,739,1804100,1,12,15,17,515,44117515
30064,772,1804100,2,12,15,18,287,44118287
30065,1480,1804000,1,12,15,19,767,44119767
30066,446,1804000,1,12,15,20,213,44120213
30067,578,1804000,1,12,15,20,791,44120791
30068,1,1804000,1,12,15,20,792,44120792
30069,7,1804000,10,12,15,20,799,44120799
30070,0,1804000,1,12,15,20,799,44120799
30071,0,1804000,1,12,15,20,799,44120799
30072,0,1804000,10,12,15,20,799,44120799
30073,916,1803900,1,12,15,21,715,44121715
30074,35,1804000,1,12,15,21,750,44121750
30075,64,1803900,1,12,15,21,814,44121814
30076,9,1803900,1,12,15,21,823,44121823
30077,128,1803900,1,12,15,21,951,44121951
30078,191,1803900,1,12,15,22,142,44122142
30079,361,1803900,1,12,15,22,503,44122503
30080,43,1803900,1,12,15,22,546,44122546
30081,57,1804000,1,12,15,22,603,44122603
30082,219,1803900,4,12,15,22,822,44122822
30083,0,1803900,1,12,15,22,822,44122822
30084,9,1803900,1,12,15,22,831,44122831
30085,30,1803900,1,12,15,22,861,44122861
30086,418,1804000,4,12,15,23,279,44123279
30087,184,1803900,1,12,15,23,463,44123463
30088,24,1804000,1,12,15,23,487,44123487
30089,791,1803900,3,12,15,24,278,44124278
30090,248,1804000,5,12,15,24,526,44124526
30091,438,1803900,1,12,15,24,964,44124964
30092,34,1803900,1,12,15,24,998,44124998
30093,423,1803900,2,12,15,25,421,44125421
30094,308,1803900,1,12,15,25,729,44125729
30095,137,1804000,1,12,15,25,866,44125866
30096,240,1803900,1,12,15,26,106,44126106
30097,321,1803900,1,12,15,26,427,44126427
30098,73,1803900,3,12,15,26,500,44126500
30099,0,1803900,3,12,15,26,500,44126500
30100,110,1803900,1,12,15,26,610,44126610
30101,353,1803900,3,12,15,26,963,44126963
30103,27,1803800,3,12,15,26,990,44126990
30104,1,1803700,1,12,15,26,991,44126991
30105,10,1803700,2,12,15,27,1,44127001
30106,22,1803700,1,12,15,27,23,44127023
30107,87,1803700,1,12,15,27,110,44127110
30108,22,1803700,2,12,15,27,132,44127132
30109,2,1803700,3,12,15,27,134,44127134
30110,3,1803700,1,12,15,27,137,44127137
30111,1,1803700,1,12,15,27,138,44127138
30112,0,1803700,1,12,15,27,138,44127138
30113,0,1803700,1,12,15,27,138,44127138
30114,0,1803700,2,12,15,27,138,44127138
30115,0,1803700,1,12,15,27,138,44127138
30116,1,1803700,1,12,15,27,139,44127139
30117,0,1803700,1,12,15,27,139,44127139
30118,59,1803700,6,12,15,27,198,44127198
30120,3,1803600,2,12,15,27,201,44127201
30121,1,1803600,6,12,15,27,202,44127202
30122,3,1803700,1,12,15,27,205,44127205
30123,9,1803600,4,12,15,27,214,44127214
30124,210,1803600,1,12,15,27,424,44127424
30125,65,1803600,3,12,15,27,489,44127489
30126,7,1803500,1,12,15,27,496,44127496
30127,140,1803500,1,12,15,27,636,44127636
30128,21,1803500,1,12,15,27,657,44127657
30129,5,1803600,4,12,15,27,662,44127662
30130,5,1803500,32,12,15,27,667,44127667
30131,8,1803500,1,12,15,27,675,44127675
30132,104,1803500,2,12,15,27,779,44127779
30133,1,1803500,1,12,15,27,780,44127780
30134,14,1803600,1,12,15,27,794,44127794
30135,25,1803700,1,12,15,27,819,44127819
30136,25,1803600,1,12,15,27,844,44127844
30137,25,1803700,1,12,15,27,869,44127869
30138,25,1803500,1,12,15,27,894,44127894
30139,0,1803700,1,12,15,27,894,44127894
30140,104,1803500,2,12,15,27,998,44127998
30141,2,1803700,1,12,15,28,0,44128000
30142,40,1803500,1,12,15,28,40,44128040
30143,122,1803500,1,12,15,28,162,44128162
30144,307,1803500,1,12,15,28,469,44128469
30145,32,1803500,2,12,15,28,501,44128501
30146,227,1803500,2,12,15,28,728,44128728
30147,86,1803500,1,12,15,28,814,44128814
30148,111,1803500,2,12,15,28,925,44128925
30149,173,1803600,1,12,15,29,98,44129098
30150,6,1803500,2,12,15,29,104,44129104
30151,172,1803500,2,12,15,29,276,44129276
30152,201,1803500,2,12,15,29,477,44129477
30153,234,1803500,1,12,15,29,711,44129711
30154,21,1803500,1,12,15,29,732,44129732
30155,34,1803400,1,12,15,29,766,44129766
30156,110,1803400,1,12,15,29,876,44129876
30157,81,1803400,1,12,15,29,957,44129957
30158,27,1803400,4,12,15,29,984,44129984
30159,7,1803400,1,12,15,29,991,44129991
30160,66,1803500,1,12,15,30,57,44130057
30161,36,1803500,1,12,15,30,93,44130093
30162,3,1803600,2,12,15,30,96,44130096
30163,162,1803700,1,12,15,30,258,44130258
30164,397,1803700,1,12,15,30,655,44130655
30165,453,1803700,1,12,15,31,108,44131108
30166,58,1803700,4,12,15,31,166,44131166
30167,8,1803700,2,12,15,31,174,44131174
30168,243,1803700,1,12,15,31,417,44131417
30169,300,1803600,1,12,15,31,717,44131717
30170,433,1803600,3,12,15,32,150,44132150
30171,25,1803600,2,12,15,32,175,44132175
30172,36,1803600,4,12,15,32,211,44132211
30174,1005,1803600,1,12,15,33,216,44133216
30175,1006,1803600,4,12,15,34,222,44134222
30176,159,1803600,1,12,15,34,381,44134381
30177,27,1803700,1,12,15,34,408,44134408
30178,253,1803600,1,12,15,34,661,44134661
30179,1090,1803700,2,12,15,35,751,44135751
30181,2,1803600,18,12,15,35,753,44135753
30182,1107,1803700,1,12,15,36,860,44136860
30183,171,1803700,1,12,15,37,31,44137031
30184,18,1803700,3,12,15,37,49,44137049
30186,1,1803600,18,12,15,37,50,44137050
30187,32,1803600,2,12,15,37,82,44137082
30188,94,1803700,4,12,15,37,176,44137176
30189,116,1803600,4,12,15,37,292,44137292
30190,1134,1803600,1,12,15,38,426,44138426
30191,18,1803700,1,12,15,38,444,44138444
30192,119,1803700,1,12,15,38,563,44138563
30193,74,1803600,2,12,15,38,637,44138637
30194,30,1803600,1,12,15,38,667,44138667
30195,165,1803600,1,12,15,38,832,44138832
30196,443,1803600,1,12,15,39,275,44139275
30197,165,1803600,1,12,15,39,440,44139440
30198,1725,1803500,2,12,15,41,165,44141165
30199,814,1803600,3,12,15,41,979,44141979
30200,130,1803500,1,12,15,42,109,44142109
30201,444,1803600,1,12,15,42,553,44142553
30202,351,1803600,1,12,15,42,904,44142904
30203,635,1803500,1,12,15,43,539,44143539
30204,0,1803500,4,12,15,43,539,44143539
30205,175,1803400,1,12,15,43,714,44143714
30206,428,1803500,1,12,15,44,142,44144142
30207,275,1803400,1,12,15,44,417,44144417
30208,24,1803500,4,12,15,44,441,44144441
30209,0,1803500,5,12,15,44,441,44144441
30210,1,1803500,1,12,15,44,442,44144442
30211,16,1803400,2,12,15,44,458,44144458
30212,1252,1803500,1,12,15,45,710,44145710
30214,1068,1803500,1,12,15,46,778,44146778
30215,194,1803400,1,12,15,46,972,44146972
30216,192,1803500,1,12,15,47,164,44147164
30217,1400,1803500,1,12,15,48,564,44148564
30218,101,1803400,1,12,15,48,665,44148665
30219,418,1803500,5,12,15,49,83,44149083
30220,77,1803400,1,12,15,49,160,44149160
30221,128,1803500,1,12,15,49,288,44149288
30222,1389,1803400,1,12,15,50,677,44150677
30223,121,1803400,4,12,15,50,798,44150798
30224,73,1803500,2,12,15,50,871,44150871
30225,1181,1803500,1,12,15,52,52,44152052
30226,1067,1803500,1,12,15,53,119,44153119
30227,222,1803500,1,12,15,53,341,44153341
30228,205,1803500,1,12,15,53,546,44153546
30229,2988,1803500,5,12,15,56,534,44156534
30230,1012,1803500,1,12,15,57,546,44157546
30231,890,1803500,1,12,15,58,436,44158436
30232,1834,1803500,2,12,16,0,270,44160270
30233,182,1803500,1,12,16,0,452,44160452
30234,565,1803600,1,12,16,1,17,44161017
30235,91,1803500,1,12,16,1,108,44161108
30236,367,1803500,4,12,16,1,475,44161475
30238,43,1803500,1,12,16,1,518,44161518
30239,236,1803500,1,12,16,1,754,44161754
30240,591,1803500,2,12,16,2,345,44162345
30241,145,1803500,2,12,16,2,490,44162490
30242,461,1803500,1,12,16,2,951,44162951
30243,33,1803500,2,12,16,2,984,44162984
30244,508,1803500,2,12,16,3,492,44163492
30245,174,1803600,1,12,16,3,666,44163666
30246,1,1803600,13,12,16,3,667,44163667
30247,169,1803600,1,12,16,3,836,44163836
30248,302,1803500,1,12,16,4,138,44164138
30249,335,1803700,1,12,16,4,473,44164473
30250,122,1803600,2,12,16,4,595,44164595
30251,219,1803700,1,12,16,4,814,44164814
30252,855,1803700,1,12,16,5,669,44165669
30253,927,1803700,1,12,16,6,596,44166596
30254,4,1803700,2,12,16,6,600,44166600
30255,737,1803700,2,12,16,7,337,44167337
30256,761,1803800,2,12,16,8,98,44168098
30257,0,1803800,5,12,16,8,98,44168098
30258,151,1803900,1,12,16,8,249,44168249
30259,830,1803800,5,12,16,9,79,44169079
30260,0,1803800,5,12,16,9,79,44169079
30262,7,1803700,2,12,16,9,86,44169086
30263,42,1803800,3,12,16,9,128,44169128
30264,99,1803800,3,12,16,9,227,44169227
30265,213,1803800,1,12,16,9,440,44169440
30266,200,1803800,1,12,16,9,640,44169640
30267,505,1803800,2,12,16,10,145,44170145
30268,348,1803900,5,12,16,10,493,44170493
30269,606,1803800,1,12,16,11,99,44171099
30270,1,1803800,1,12,16,11,100,44171100
30271,0,1803800,1,12,16,11,100,44171100
30272,2292,1803800,1,12,16,13,392,44173392
30273,107,1803900,1,12,16,13,499,44173499
30274,98,1803800,1,12,16,13,597,44173597
30275,448,1803800,1,12,16,14,45,44174045
30276,396,1803900,7,12,16,14,441,44174441
30277,67,1803900,1,12,16,14,508,44174508
30278,223,1803900,1,12,16,14,731,44174731
30279,645,1803900,3,12,16,15,376,44175376
30280,117,1803900,1,12,16,15,493,44175493
30281,41,1803900,1,12,16,15,534,44175534
30282,1023,1803800,1,12,16,16,557,44176557
30283,449,1803900,3,12,16,17,6,44177006
30284,158,1803900,1,12,16,17,164,44177164
30285,164,1803900,2,12,16,17,328,44177328
30286,825,1804000,1,12,16,18,153,44178153
30287,1,1804000,30,12,16,18,154,44178154
30288,2,1804100,1,12,16,18,156,44178156
30289,0,1804100,1,12,16,18,156,44178156
30290,897,1804100,1,12,16,19,53,44179053
30291,741,1803900,1,12,16,19,794,44179794
30292,7,1804000,1,12,16,19,801,44179801
30293,2426,1803900,1,12,16,22,227,44182227
30294,492,1804000,1,12,16,22,719,44182719
30295,416,1803900,1,12,16,23,135,44183135
30296,3087,1803900,3,12,16,26,222,44186222
30297,44,1803800,2,12,16,26,266,44186266
30298,1652,1803800,5,12,16,27,918,44187918
30299,262,1803800,1,12,16,28,180,44188180
30300,686,1803700,1,12,16,28,866,44188866
30301,1062,1803800,2,12,16,29,928,44189928
30302,1901,1803800,2,12,16,31,829,44191829
30303,268,1803700,1,12,16,32,97,44192097
30304,982,1803700,1,12,16,33,79,44193079
30305,521,1803800,1,12,16,33,600,44193600
30306,1342,1803800,1,12,16,34,942,44194942
30307,184,1803700,1,12,16,35,126,44195126
30308,1559,1803700,1,12,16,36,685,44196685
30309,1011,1803700,1,12,16,37,696,44197696
30310,901,1803600,1,12,16,38,597,44198597
30311,859,1803600,1,12,16,39,456,44199456
30312,1211,1803600,2,12,16,40,667,44200667
30313,782,1803700,2,12,16,41,449,44201449
30314,309,1803600,1,12,16,41,758,44201758
30315,361,1803700,4,12,16,42,119,44202119
30316,2348,1803600,1,12,16,44,467,44204467
30317,1107,1803600,1,12,16,45,574,44205574
30318,619,1803700,2,12,16,46,193,44206193
30319,2087,1803600,1,12,16,48,280,44208280
30320,422,1803600,1,12,16,48,702,44208702
30321,245,1803600,4,12,16,48,947,44208947
30323,403,1803600,2,12,16,49,350,44209350
30324,1209,1803600,6,12,16,50,559,44210559
30326,620,1803600,1,12,16,51,179,44211179
30328,896,1803600,1,12,16,52,75,44212075
30329,542,1803600,1,12,16,52,617,44212617
30330,2751,1803500,1,12,16,55,368,44215368
30331,2371,1803600,2,12,16,57,739,44217739
30333,150,1803600,1,12,16,57,889,44217889
30334,606,1803600,1,12,16,58,495,44218495
30335,2510,1803700,3,12,17,1,5,44221005
30336,134,1803700,1,12,17,1,139,44221139
30337,145,1803700,1,12,17,1,284,44221284
30338,24,1803700,1,12,17,1,308,44221308
30339,26,1803700,1,12,17,1,334,44221334
30340,38,1803700,1,12,17,1,372,44221372
30341,25,1803600,1,12,17,1,397,44221397
30342,5,1803600,1,12,17,1,402,44221402
30343,11,1803600,1,12,17,1,413,44221413
30344,14,1803500,6,12,17,1,427,44221427
30345,8,1803500,1,12,17,1,435,44221435
30346,12,1803700,2,12,17,1,447,44221447
30347,11,1803600,1,12,17,1,458,44221458
30348,12,1803700,1,12,17,1,470,44221470
30349,15,1803500,1,12,17,1,485,44221485
30350,27,1803500,1,12,17,1,512,44221512
30351,10,1803700,2,12,17,1,522,44221522
30352,22,1803500,1,12,17,1,544,44221544
30353,29,1803500,1,12,17,1,573,44221573
30354,26,1803500,1,12,17,1,599,44221599
30355,28,1803500,1,12,17,1,627,44221627
30356,23,1803500,1,12,17,1,650,44221650
30357,34,1803500,1,12,17,1,684,44221684
30358,555,1803400,1,12,17,2,239,44222239
30359,159,1803400,2,12,17,2,398,44222398
30360,2,1803400,2,12,17,2,400,44222400
30361,2,1803400,2,12,17,2,402,44222402
30362,2909,1803500,1,12,17,5,311,44225311
30363,328,1803400,4,12,17,5,639,44225639
30364,0,1803400,4,12,17,5,639,44225639
30366,115,1803200,5,12,17,5,754,44225754
30367,41,1803200,1,12,17,5,795,44225795
30368,6,1803300,2,12,17,5,801,44225801
30370,24,1803200,2,12,17,5,825,44225825
30371,4,1803200,1,12,17,5,829,44225829
30372,10,1803200,1,12,17,5,839,44225839
30373,4,1803300,1,12,17,5,843,44225843
30374,98,1803200,2,12,17,5,941,44225941
30375,92,1803200,1,12,17,6,33,44226033
30376,59,1803400,1,12,17,6,92,44226092
30377,82,1803200,1,12,17,6,174,44226174
30378,8,1803200,1,12,17,6,182,44226182
30379,6,1803200,1,12,17,6,188,44226188
30380,2,1803200,1,12,17,6,190,44226190
30381,23,1803200,1,12,17,6,213,44226213
30382,7,1803200,1,12,17,6,220,44226220
30383,29,1803400,1,12,17,6,249,44226249
30384,210,1803200,1,12,17,6,459,44226459
30385,615,1803300,1,12,17,7,74,44227074
30386,5,1803200,1,12,17,7,79,44227079
30387,3,1803200,1,12,17,7,82,44227082
30388,35,1803200,1,12,17,7,117,44227117
30389,45,1803300,1,12,17,7,162,44227162
30390,783,1803100,1,12,17,7,945,44227945
30391,109,1803100,1,12,17,8,54,44228054
30392,59,1803100,1,12,17,8,113,44228113
30393,427,1803300,2,12,17,8,540,44228540
30394,421,1803200,1,12,17,8,961,44228961
30395,99,1803300,4,12,17,9,60,44229060
30396,7,1803300,1,12,17,9,67,44229067
30397,339,1803400,1,12,17,9,406,44229406
30398,27,1803300,1,12,17,9,433,44229433
30399,649,1803300,1,12,17,10,82,44230082
30400,1289,1803300,2,12,17,11,371,44231371
30401,1184,1803300,1,12,17,12,555,44232555
30402,689,1803200,1,12,17,13,244,44233244
30403,824,1803200,1,12,17,14,68,44234068
30404,248,1803200,1,12,17,14,316,44234316
30405,393,1803300,1,12,17,14,709,44234709
30406,799,1803300,3,12,17,15,508,44235508
30407,123,1803300,1,12,17,15,631,44235631
30408,118,1803300,1,12,17,15,749,44235749
30409,551,1803400,5,12,17,16,300,44236300
30410,1333,1803200,2,12,17,17,633,44237633
30411,897,1803300,1,12,17,18,530,44238530
30412,138,1803300,1,12,17,18,668,44238668
30413,1493,1803200,2,12,17,20,161,44240161
30414,968,1803300,1,12,17,21,129,44241129
30416,1144,1803300,1,12,17,22,273,44242273
30417,11,1803200,1,12,17,22,284,44242284
30418,1247,1803300,2,12,17,23,531,44243531
30419,420,1803300,1,12,17,23,951,44243951
30420,4506,1803300,1,12,17,28,457,44248457
30421,66,1803300,1,12,17,28,523,44248523
30422,733,1803300,2,12,17,29,256,44249256
30423,3415,1803300,4,12,17,32,671,44252671
30424,57,1803400,7,12,17,32,728,44252728
30426,1153,1803400,1,12,17,33,881,44253881
30427,1075,1803400,1,12,17,34,956,44254956
30428,4403,1803400,1,12,17,39,359,44259359
30429,244,1803500,1,12,17,39,603,44259603
30430,244,1803500,1,12,17,39,847,44259847
30431,1519,1803500,1,12,17,41,366,44261366
30432,433,1803500,3,12,17,41,799,44261799
30433,898,1803600,5,12,17,42,697,44262697
30434,259,1803600,1,12,17,42,956,44262956
30435,269,1803700,1,12,17,43,225,44263225
30436,1054,1803600,1,12,17,44,279,44264279
30437,305,1803700,13,12,17,44,584,44264584
30438,962,1803700,1,12,17,45,546,44265546
30439,24,1803700,4,12,17,45,570,44265570
30440,361,1803700,1,12,17,45,931,44265931
30441,68,1803600,1,12,17,45,999,44265999
30442,834,1803500,5,12,17,46,833,44266833
30443,7201,1803700,1,12,17,54,34,44274034
30444,202,1803700,1,12,17,54,236,44274236
30445,789,1803600,3,12,17,55,25,44275025
30446,1610,1803700,3,12,17,56,635,44276635
30447,2620,1803600,5,12,17,59,255,44279255
30448,1,1803600,2,12,17,59,256,44279256
30449,1480,1803700,3,12,18,0,736,44280736
30450,3,1803700,1,12,18,0,739,44280739
30451,633,1803700,7,12,18,1,372,44281372
30452,308,1803600,1,12,18,1,680,44281680
30453,13,1803600,1,12,18,1,693,44281693
30454,918,1803600,1,12,18,2,611,44282611
30455,4678,1803700,2,12,18,7,289,44287289
30456,2485,1803800,1,12,18,9,774,44289774
30457,85,1803800,14,12,18,9,859,44289859
30458,8,1803800,2,12,18,9,867,44289867
30459,394,1803800,4,12,18,10,261,44290261
30460,828,1803900,1,12,18,11,89,44291089
30461,871,1803900,2,12,18,11,960,44291960
30462,728,1803900,1,12,18,12,688,44292688
30463,712,1803900,2,12,18,13,400,44293400
30464,471,1803900,1,12,18,13,871,44293871
30465,325,1803800,1,12,18,14,196,44294196
30466,455,1803900,1,12,18,14,651,44294651
30467,164,1803900,2,12,18,14,815,44294815
30468,1236,1803800,1,12,18,16,51,44296051
30469,3204,1803900,1,12,18,19,255,44299255
30470,231,1803900,1,12,18,19,486,44299486
30471,1577,1803800,1,12,18,21,63,44301063
30472,939,1803900,2,12,18,22,2,44302002
30473,3374,1804000,1,12,18,25,376,44305376
30474,1395,1804000,2,12,18,26,771,44306771
30475,231,1804000,5,12,18,27,2,44307002
30476,0,1804000,3,12,18,27,2,44307002
30477,717,1804000,1,12,18,27,719,44307719
30478,133,1804000,1,12,18,27,852,44307852
30479,1612,1804000,1,12,18,29,464,44309464
30480,215,1804000,3,12,18,29,679,44309679
30481,137,1804000,1,12,18,29,816,44309816
30482,58,1804100,2,12,18,29,874,44309874
30483,255,1804100,1,12,18,30,129,44310129
30484,1374,1804100,1,12,18,31,503,44311503
30485,806,1804100,2,12,18,32,309,44312309
30486,1045,1804100,1,12,18,33,354,44313354
30487,15,1804100,1,12,18,33,369,44313369
30488,2240,1804100,1,12,18,35,609,44315609
30489,387,1804100,6,12,18,35,996,44315996
30490,674,1804100,1,12,18,36,670,44316670
30491,144,1804200,1,12,18,36,814,44316814
30492,132,1804100,1,12,18,36,946,44316946
30493,52,1804200,1,12,18,36,998,44316998
30494,107,1804200,1,12,18,37,105,44317105
30495,1092,1804100,1,12,18,38,197,44318197
30496,2569,1804200,1,12,18,40,766,44320766
30497,1045,1804200,1,12,18,41,811,44321811
30498,1139,1804200,4,12,18,42,950,44322950
30499,2041,1804200,6,12,18,44,991,44324991
30501,3,1804300,30,12,18,44,994,44324994
30502,3,1804400,2,12,18,44,997,44324997
30503,161,1804300,2,12,18,45,158,44325158
30504,24,1804300,1,12,18,45,182,44325182
30505,2,1804300,1,12,18,45,184,44325184
30507,1006,1804300,2,12,18,46,190,44326190
30508,1108,1804200,3,12,18,47,298,44327298
30509,86,1804200,5,12,18,47,384,44327384
30510,285,1804100,5,12,18,47,669,44327669
30511,0,1804100,8,12,18,47,669,44327669
30512,53,1804100,1,12,18,47,722,44327722
30513,24,1804000,1,12,18,47,746,44327746
30514,486,1804100,1,12,18,48,232,44328232
30515,1804,1804000,5,12,18,50,36,44330036
30516,17,1804000,2,12,18,50,53,44330053
30517,623,1804000,3,12,18,50,676,44330676
30518,2030,1804000,1,12,18,52,706,44332706
30519,29,1803900,3,12,18,52,735,44332735
30520,307,1803900,1,12,18,53,42,44333042
30521,167,1804000,1,12,18,53,209,44333209
30522,969,1804000,1,12,18,54,178,44334178
30523,94,1804000,1,12,18,54,272,44334272
30524,786,1804000,1,12,18,55,58,44335058
30525,382,1804000,1,12,18,55,440,44335440
30526,6,1804000,1,12,18,55,446,44335446
30527,2914,1804000,3,12,18,58,360,44338360
30529,2677,1803900,1,12,19,1,37,44341037
30530,507,1803900,1,12,19,1,544,44341544
30531,25,1803900,1,12,19,1,569,44341569
30532,1,1803900,4,12,19,1,570,44341570
30533,81,1803800,1,12,19,1,651,44341651
30534,57,1803800,1,12,19,1,708,44341708
30535,3,1803800,1,12,19,1,711,44341711
30536,149,1803800,1,12,19,1,860,44341860
30537,35,1803800,1,12,19,1,895,44341895
30538,1058,1803800,1,12,19,2,953,44342953
30539,5572,1803800,2,12,19,8,525,44348525
30540,860,1804000,2,12,19,9,385,44349385
30541,3401,1803900,1,12,19,12,786,44352786
30542,4323,1803800,1,12,19,17,109,44357109
30543,4515,1803900,1,12,19,21,624,44361624
30544,3172,1803800,1,12,19,24,796,44364796
30545,2813,1803900,1,12,19,27,609,44367609
30546,1582,1803900,1,12,19,29,191,44369191
30547,757,1803800,1,12,19,29,948,44369948
30548,177,1803900,1,12,19,30,125,44370125
30549,173,1803800,1,12,19,30,298,44370298
30550,1583,1803900,2,12,19,31,881,44371881
30551,1777,1803900,1,12,19,33,658,44373658
30552,9281,1803900,1,12,19,42,939,44382939
30553,733,1803900,2,12,19,43,672,44383672
30554,2059,1804000,1,12,19,45,731,44385731
30555,1445,1804000,9,12,19,47,176,44387176
30556,89,1804100,2,12,19,47,265,44387265
30557,7783,1804100,2,12,19,55,48,44395048
30558,2958,1804200,9,12,19,58,6,44398006
30559,345,1804200,1,12,19,58,351,44398351
30560,1769,1804300,7,12,20,0,120,44400120
30561,279,1804100,3,12,20,0,399,44400399
30562,35,1804100,1,12,20,0,434,44400434
30563,18,1804200,1,12,20,0,452,44400452
30564,8,1804100,1,12,20,0,460,44400460
30565,28,1804300,1,12,20,0,488,44400488
30566,7,1804300,1,12,20,0,495,44400495
30567,6,1804300,1,12,20,0,501,44400501
30568,11,1804100,1,12,20,0,512,44400512
30569,11,1804100,1,12,20,0,523,44400523
30570,27,1804300,1,12,20,0,550,44400550
30571,163,1804100,1,12,20,0,713,44400713
30572,1803,1804200,1,12,20,2,516,44402516
30573,531,1804100,2,12,20,3,47,44403047
30574,17,1804000,1,12,20,3,64,44403064
30575,4,1804100,1,12,20,3,68,44403068
30576,484,1804100,1,12,20,3,552,44403552
30577,206,1804000,1,12,20,3,758,44403758
30578,2643,1804000,1,12,20,6,401,44406401
30579,138,1804200,1,12,20,6,539,44406539
30580,1378,1804300,1,12,20,7,917,44407917
30581,1121,1804300,3,12,20,9,38,44409038
30582,1679,1804400,1,12,20,10,717,44410717
30583,2516,1804400,1,12,20,13,233,44413233
30584,87,1804300,1,12,20,13,320,44413320
30585,1949,1804300,2,12,20,15,269,44415269
30586,410,1804400,5,12,20,15,679,44415679
30587,21,1804400,1,12,20,15,700,44415700
30588,293,1804400,4,12,20,15,993,44415993
30589,170,1804300,1,12,20,16,163,44416163
30590,401,1804300,1,12,20,16,564,44416564
30591,1623,1804400,1,12,20,18,187,44418187
30592,1097,1804400,2,12,20,19,284,44419284
30593,766,1804400,2,12,20,20,50,44420050
30594,809,1804400,2,12,20,20,859,44420859
30595,217,1804400,1,12,20,21,76,44421076
30596,0,1804400,1,12,20,21,76,44421076
30597,1357,1804400,1,12,20,22,433,44422433
30598,28,1804300,3,12,20,22,461,44422461
30599,2036,1804300,1,12,20,24,497,44424497
30600,138,1804200,2,12,20,24,635,44424635
30601,64,1804300,1,12,20,24,699,44424699
30602,116,1804300,1,12,20,24,815,44424815
30603,4136,1804200,3,12,20,28,951,44428951
30604,0,1804200,3,12,20,28,951,44428951
30606,2,1804200,5,12,20,28,953,44428953
30607,0,1804200,1,12,20,28,953,44428953
30608,0,1804200,1,12,20,28,953,44428953
30609,256,1804300,2,12,20,29,209,44429209
30610,1005,1804300,1,12,20,30,214,44430214
30611,16,1804300,1,12,20,30,230,44430230
30612,38,1804300,1,12,20,30,268,44430268
30613,6872,1804200,2,12,20,37,140,44437140
30614,194,1804300,1,12,20,37,334,44437334
30615,3653,1804200,1,12,20,40,987,44440987
30616,390,1804200,2,12,20,41,377,44441377
30617,594,1804200,1,12,20,41,971,44441971
30618,2007,1804200,2,12,20,43,978,44443978
30619,136,1804200,4,12,20,44,114,44444114
30620,1540,1804200,1,12,20,45,654,44445654
30621,1249,1804300,1,12,20,46,903,44446903
30622,1,1804300,24,12,20,46,904,44446904
30623,7,1804400,5,12,20,46,911,44446911
30624,15,1804400,1,12,20,46,926,44446926
30625,190,1804300,8,12,20,47,116,44447116
30626,3398,1804400,2,12,20,50,514,44450514
30627,1305,1804400,2,12,20,51,819,44451819
30629,4115,1804300,3,12,20,55,934,44455934
30630,1436,1804400,1,12,20,57,370,44457370
30631,346,1804300,3,12,20,57,716,44457716
30632,4594,1804300,1,12,21,2,310,44462310
30633,0,1804300,1,12,21,2,310,44462310
30634,68,1804300,1,12,21,2,378,44462378
30635,255,1804200,1,12,21,2,633,44462633
30636,46,1804200,1,12,21,2,679,44462679
30637,121,1804200,1,12,21,2,800,44462800
30638,25,1804200,1,12,21,2,825,44462825
30639,112,1804200,1,12,21,2,937,44462937
30640,28,1804200,4,12,21,2,965,44462965
30641,1,1804200,2,12,21,2,966,44462966
30642,15,1804100,4,12,21,2,981,44462981
30643,353,1804300,1,12,21,3,334,44463334
30644,176,1804100,1,12,21,3,510,44463510
30645,3356,1804100,1,12,21,6,866,44466866
30646,3981,1804200,1,12,21,10,847,44470847
30647,1922,1804300,2,12,21,12,769,44472769
30648,6022,1804400,14,12,21,18,791,44478791
30649,365,1804400,1,12,21,19,156,44479156
30650,1999,1804400,2,12,21,21,155,44481155
30652,2,1804300,1,12,21,21,157,44481157
30653,0,1804300,12,12,21,21,157,44481157
30654,0,1804300,1,12,21,21,157,44481157
30655,134,1804400,1,12,21,21,291,44481291
30656,3575,1804300,1,12,21,24,866,44484866
30657,562,1804400,1,12,21,25,428,44485428
30658,1038,1804400,1,12,21,26,466,44486466
30659,627,1804200,1,12,21,27,93,44487093
30660,449,1804400,1,12,21,27,542,44487542
30661,3836,1804400,2,12,21,31,378,44491378
30662,451,1804400,1,12,21,31,829,44491829
30663,864,1804400,2,12,21,32,693,44492693
30664,547,1804400,2,12,21,33,240,44493240
30665,6652,1804300,1,12,21,39,892,44499892
30666,398,1804400,2,12,21,40,290,44500290
30667,774,1804400,1,12,21,41,64,44501064
30668,2292,1804300,1,12,21,43,356,44503356
30669,10427,1804300,1,12,21,53,783,44513783
30670,1887,1804300,1,12,21,55,670,44515670
30671,4404,1804200,3,12,22,0,74,44520074
30672,949,1804200,1,12,22,1,23,44521023
30673,2200,1804200,2,12,22,3,223,44523223
30674,1,1804200,1,12,22,3,224,44523224
30675,0,1804200,1,12,22,3,224,44523224
30676,0,1804200,1,12,22,3,224,44523224
30677,1065,1804200,3,12,22,4,289,44524289
30678,1766,1804200,3,12,22,6,55,44526055
30679,1536,1804200,3,12,22,7,591,44527591
30680,1666,1804300,3,12,22,9,257,44529257
30681,1989,1804300,3,12,22,11,246,44531246
30682,2350,1804300,3,12,22,13,596,44533596
30683,2387,1804200,1,12,22,15,983,44535983
30684,488,1804300,1,12,22,16,471,44536471
30685,5252,1804200,1,12,22,21,723,44541723
30686,4664,1804200,2,12,22,26,387,44546387
30687,647,1804200,1,12,22,27,34,44547034
30688,27,1804200,3,12,22,27,61,44547061
30689,2601,1804100,1,12,22,29,662,44549662
30690,2095,1804100,2,12,22,31,757,44551757
30691,293,1804200,2,12,22,32,50,44552050
30692,2343,1804100,5,12,22,34,393,44554393
30693,1,1804100,4,12,22,34,394,44554394
30694,1,1804100,1,12,22,34,395,44554395
30695,5665,1804000,1,12,22,40,60,44560060
30696,544,1804000,1,12,22,40,604,44560604
30697,1177,1804000,1,12,22,41,781,44561781
30698,0,1804000,1,12,22,41,781,44561781
30699,0,1804000,6,12,22,41,781,44561781
30700,1,1803900,6,12,22,41,782,44561782
30701,1,1803900,2,12,22,41,783,44561783
30702,1,1803900,1,12,22,41,784,44561784
30703,0,1803900,1,12,22,41,784,44561784
30704,66,1803800,5,12,22,41,850,44561850
30705,6,1803900,1,12,22,41,856,44561856
30706,105,1803800,3,12,22,41,961,44561961
30707,92,1803800,5,12,22,42,53,44562053
30708,122,1803900,1,12,22,42,175,44562175
30709,1,1803700,2,12,22,42,176,44562176
30710,258,1803900,1,12,22,42,434,44562434
30711,2136,1803900,1,12,22,44,570,44564570
30712,76,1803700,1,12,22,44,646,44564646
30713,954,1803800,1,12,22,45,600,44565600
30714,721,1803700,1,12,22,46,321,44566321
30715,2261,1803800,1,12,22,48,582,44568582
30716,4368,1803800,1,12,22,52,950,44572950
30718,1058,1803700,3,12,22,54,8,44574008
30719,89,1803700,1,12,22,54,97,44574097
30720,255,1803700,1,12,22,54,352,44574352
30721,741,1803800,1,12,22,55,93,44575093
30722,21,1803800,3,12,22,55,114,44575114
30723,3298,1803600,1,12,22,58,412,44578412
30724,1874,1803700,1,12,23,0,286,44580286
30725,22,1803600,1,12,23,0,308,44580308
30726,2336,1803600,11,12,23,2,644,44582644
30727,1,1803500,5,12,23,2,645,44582645
30728,305,1803600,1,12,23,2,950,44582950
30729,65,1803600,1,12,23,3,15,44583015
30730,1609,1803600,1,12,23,4,624,44584624
30731,1121,1803600,1,12,23,5,745,44585745
30732,1025,1803700,6,12,23,6,770,44586770
30733,625,1803700,1,12,23,7,395,44587395
30734,2663,1803700,1,12,23,10,58,44590058
30735,1265,1803700,2,12,23,11,323,44591323
30736,3453,1803700,1,12,23,14,776,44594776
30738,0,1803600,1,12,23,14,776,44594776
30739,290,1803700,1,12,23,15,66,44595066
30740,410,1803700,1,12,23,15,476,44595476
30741,5403,1803600,1,12,23,20,879,44600879
30742,3747,1803600,5,12,23,24,626,44604626
30743,262,1803600,2,12,23,24,888,44604888
30744,688,1803600,1,12,23,25,576,44605576
30745,1192,1803600,3,12,23,26,768,44606768
30746,69,1803600,1,12,23,26,837,44606837
30747,4066,1803700,1,12,23,30,903,44610903
30748,68,1803700,1,12,23,30,971,44610971
30749,2019,1803800,1,12,23,32,990,44612990
30750,5005,1803700,2,12,23,37,995,44617995
30751,1659,1803700,2,12,23,39,654,44619654
30752,575,1803800,4,12,23,40,229,44620229
30753,1,1803800,1,12,23,40,230,44620230
30754,1653,1803700,2,12,23,41,883,44621883
30755,1249,1803700,4,12,23,43,132,44623132
30757,181,1803600,2,12,23,43,313,44623313
30758,420,1803500,6,12,23,43,733,44623733
30759,4178,1803500,2,12,23,47,911,44627911
30760,372,1803600,3,12,23,48,283,44628283
30761,67,1803600,1,12,23,48,350,44628350
30762,243,1803500,20,12,23,48,593,44628593
30763,154,1803400,3,12,23,48,747,44628747
30764,309,1803400,1,12,23,49,56,44629056
30765,695,1803500,1,12,23,49,751,44629751
30766,155,1803400,1,12,23,49,906,44629906
30767,3636,1803500,1,12,23,53,542,44633542
30768,2877,1803500,1,12,23,56,419,44636419
30769,1360,1803500,1,12,23,57,779,44637779
30770,0,1803500,1,12,23,57,779,44637779
30771,758,1803500,1,12,23,58,537,44638537
30772,187,1803500,1,12,23,58,724,44638724
30773,913,1803500,1,12,23,59,637,44639637
30774,673,1803500,1,12,24,0,310,44640310
30775,40,1803500,1,12,24,0,350,44640350
30776,745,1803500,1,12,24,1,95,44641095
30777,871,1803500,1,12,24,1,966,44641966
30778,825,1803500,1,12,24,2,791,44642791
30779,776,1803500,1,12,24,3,567,44643567
30780,816,1803500,1,12,24,4,383,44644383
30781,776,1803500,1,12,24,5,159,44645159
30782,760,1803500,1,12,24,5,919,44645919
30783,784,1803500,1,12,24,6,703,44646703
30784,427,1803400,5,12,24,7,130,44647130
30785,285,1803500,1,12,24,7,415,44647415
30786,345,1803500,1,12,24,7,760,44647760
30787,343,1803500,1,12,24,8,103,44648103
30788,728,1803500,1,12,24,8,831,44648831
30789,627,1803500,1,12,24,9,458,44649458
30790,134,1803500,1,12,24,9,592,44649592
30791,3850,1803500,1,12,24,13,442,44653442
30792,694,1803500,1,12,24,14,136,44654136
30793,806,1803500,10,12,24,14,942,44654942
30794,135,1803600,1,12,24,15,77,44655077
30795,1,1803600,1,12,24,15,78,44655078
30796,0,1803600,4,12,24,15,78,44655078
30797,0,1803600,2,12,24,15,78,44655078
30798,363,1803600,1,12,24,15,441,44655441
30799,1963,1803600,3,12,24,17,404,44657404
30800,695,1803600,1,12,24,18,99,44658099
30801,1751,1803600,1,12,24,19,850,44659850
30802,975,1803600,1,12,24,20,825,44660825
30803,310,1803600,1,12,24,21,135,44661135
30804,6858,1803600,1,12,24,27,993,44667993
30805,1110,1803600,1,12,24,29,103,44669103
30806,973,1803500,4,12,24,30,76,44670076
30808,947,1803400,4,12,24,31,23,44671023
30809,218,1803300,2,12,24,31,241,44671241
30810,300,1803300,2,12,24,31,541,44671541
30811,20,1803400,1,12,24,31,561,44671561
30812,208,1803400,1,12,24,31,769,44671769
30813,105,1803300,2,12,24,31,874,44671874
30814,32,1803400,1,12,24,31,906,44671906
30815,6,1803400,1,12,24,31,912,44671912
30816,226,1803300,2,12,24,32,138,44672138
30817,153,1803400,1,12,24,32,291,44672291
30818,148,1803300,2,12,24,32,439,44672439
30819,195,1803400,1,12,24,32,634,44672634
30820,4,1803400,1,12,24,32,638,44672638
30821,49,1803300,2,12,24,32,687,44672687
30822,155,1803300,2,12,24,32,842,44672842
30823,335,1803300,2,12,24,33,177,44673177
30824,523,1803300,2,12,24,33,700,44673700
30825,50,1803400,6,12,24,33,750,44673750
30826,1,1803400,3,12,24,33,751,44673751
30827,0,1803400,4,12,24,33,751,44673751
30828,0,1803400,1,12,24,33,751,44673751
30829,52,1803600,5,12,24,33,803,44673803
30830,150,1803500,1,12,24,33,953,44673953
30831,318,1803400,2,12,24,34,271,44674271
30832,501,1803500,1,12,24,34,772,44674772
30833,543,1803400,2,12,24,35,315,44675315
30834,671,1803500,1,12,24,35,986,44675986
30835,510,1803500,1,12,24,36,496,44676496
30836,470,1803400,1,12,24,36,966,44676966
30837,2898,1803500,1,12,24,39,864,44679864
30838,3310,1803600,2,12,24,43,174,44683174
30839,393,1803600,1,12,24,43,567,44683567
30840,688,1803700,1,12,24,44,255,44684255
30841,1248,1803700,1,12,24,45,503,44685503
30842,976,1803700,1,12,24,46,479,44686479
30843,214,1803600,2,12,24,46,693,44686693
30844,1300,1803600,3,12,24,47,993,44687993
30845,0,1803600,2,12,24,47,993,44687993
30846,1459,1803600,4,12,24,49,452,44689452
30847,424,1803700,1,12,24,49,876,44689876
30848,330,1803700,1,12,24,50,206,44690206
30849,43,1803700,1,12,24,50,249,44690249
30850,114,1803700,1,12,24,50,363,44690363
30851,0,1803700,1,12,24,50,363,44690363
30852,1,1803700,1,12,24,50,364,44690364
30853,0,1803700,1,12,24,50,364,44690364
30854,1244,1803600,2,12,24,51,608,44691608
30856,394,1803500,3,12,24,52,2,44692002
30857,126,1803500,1,12,24,52,128,44692128
30858,1375,1803500,1,12,24,53,503,44693503
30859,1022,1803500,1,12,24,54,525,44694525
30860,197,1803500,1,12,24,54,722,44694722
30861,177,1803500,15,12,24,54,899,44694899
30862,0,1803500,1,12,24,54,899,44694899
30863,1,1803500,11,12,24,54,900,44694900
30864,0,1803500,1,12,24,54,900,44694900
30865,0,1803500,2,12,24,54,900,44694900
30866,60,1803500,3,12,24,54,960,44694960
30867,538,1803600,10,12,24,55,498,44695498
30868,608,1803500,1,12,24,56,106,44696106
30869,715,1803500,1,12,24,56,821,44696821
30870,3135,1803500,1,12,24,59,956,44699956
30871,857,1803500,1,12,25,0,813,44700813
30872,297,1803400,1,12,25,1,110,44701110
30873,116,1803400,1,12,25,1,226,44701226
30874,40,1803400,1,12,25,1,266,44701266
30875,6,1803400,1,12,25,1,272,44701272
30876,18,1803400,1,12,25,1,290,44701290
30877,13,1803400,2,12,25,1,303,44701303
30878,95,1803400,2,12,25,1,398,44701398
30879,85,1803300,1,12,25,1,483,44701483
30880,200,1803400,1,12,25,1,683,44701683
30881,9,1803400,2,12,25,1,692,44701692
30882,4,1803400,1,12,25,1,696,44701696
30883,65,1803300,1,12,25,1,761,44701761
30884,11,1803300,2,12,25,1,772,44701772
30885,159,1803500,1,12,25,1,931,44701931
30886,89,1803500,1,12,25,2,20,44702020
30887,6,1803300,1,12,25,2,26,44702026
30888,904,1803500,2,12,25,2,930,44702930
30889,101,1803500,1,12,25,3,31,44703031
30890,700,1803400,1,12,25,3,731,44703731
30891,963,1803400,1,12,25,4,694,44704694
30893,974,1803500,1,12,25,5,668,44705668
30894,271,1803500,1,12,25,5,939,44705939
30895,864,1803500,1,12,25,6,803,44706803
30896,273,1803400,1,12,25,7,76,44707076
30897,1564,1803500,1,12,25,8,640,44708640
30898,1531,1803500,1,12,25,10,171,44710171
30899,2922,1803500,1,12,25,13,93,44713093
30900,88,1803600,4,12,25,13,181,44713181
30902,2085,1803700,1,12,25,15,266,44715266
30903,299,1803700,1,12,25,15,565,44715565
30904,0,1803700,2,12,25,15,565,44715565
30905,1795,1803800,1,12,25,17,360,44717360
30906,73,1803700,4,12,25,17,433,44717433
30908,249,1803800,1,12,25,17,682,44717682
30909,1321,1803800,3,12,25,19,3,44719003
30910,1791,1803700,2,12,25,20,794,44720794
30911,6732,1803700,5,12,25,27,526,44727526
30912,440,1803800,3,12,25,27,966,44727966
30914,129,1803800,1,12,25,28,95,44728095
30915,1655,1803700,3,12,25,29,750,44729750
30916,5449,1803600,1,12,25,35,199,44735199
30917,279,1803600,1,12,25,35,478,44735478
30918,615,1803700,1,12,25,36,93,44736093
30919,1056,1803700,1,12,25,37,149,44737149
30920,406,1803600,1,12,25,37,555,44737555
30921,15,1803600,2,12,25,37,570,44737570
30923,35,1803400,3,12,25,37,605,44737605
30924,574,1803500,1,12,25,38,179,44738179
30925,1311,1803500,1,12,25,39,490,44739490
30926,698,1803500,1,12,25,40,188,44740188
30927,833,1803500,1,12,25,41,21,44741021
30928,4017,1803500,1,12,25,45,38,44745038
30929,2641,1803400,1,12,25,47,679,44747679
30930,864,1803400,5,12,25,48,543,44748543
30931,1262,1803500,1,12,25,49,805,44749805
30932,1468,1803400,1,12,25,51,273,44751273
30933,1713,1803500,10,12,25,52,986,44752986
30934,490,1803400,1,12,25,53,476,44753476
30935,846,1803400,1,12,25,54,322,44754322
30936,5229,1803500,1,12,25,59,551,44759551
30937,662,1803400,1,12,26,0,213,44760213
30938,41,1803500,1,12,26,0,254,44760254
30939,69,1803400,1,12,26,0,323,44760323
30941,620,1803400,1,12,26,0,943,44760943
30942,364,1803400,1,12,26,1,307,44761307
30943,316,1803300,2,12,26,1,623,44761623
30944,142,1803400,1,12,26,1,765,44761765
30945,72,1803300,1,12,26,1,837,44761837
30946,2610,1803300,2,12,26,4,447,44764447
30947,0,1803300,13,12,26,4,447,44764447
30948,1,1803300,1,12,26,4,448,44764448
30949,0,1803200,4,12,26,4,448,44764448
30950,236,1803200,1,12,26,4,684,44764684
30951,23,1803200,2,12,26,4,707,44764707
30952,448,1803300,1,12,26,5,155,44765155
30953,843,1803200,2,12,26,5,998,44765998
30954,862,1803200,1,12,26,6,860,44766860
30955,134,1803200,5,12,26,6,994,44766994
30956,74,1803200,1,12,26,7,68,44767068
30957,1626,1803200,1,12,26,8,694,44768694
30958,1324,1803200,1,12,26,10,18,44770018
30959,1498,1803200,1,12,26,11,516,44771516
30960,1423,1803200,1,12,26,12,939,44772939
30961,395,1803100,2,12,26,13,334,44773334
30962,0,1803100,1,12,26,13,334,44773334
30963,0,1803100,2,12,26,13,334,44773334
30964,0,1803100,2,12,26,13,334,44773334
30965,1,1803100,1,12,26,13,335,44773335
30966,0,1803100,14,12,26,13,335,44773335
30967,0,1803100,1,12,26,13,335,44773335
30968,0,1803100,10,12,26,13,335,44773335
30969,35,1803100,1,12,26,13,370,44773370
30970,11,1803000,1,12,26,13,381,44773381
30971,20,1803000,2,12,26,13,401,44773401
30972,2,1803000,2,12,26,13,403,44773403
30973,1,1803000,2,12,26,13,404,44773404
30974,3,1803000,1,12,26,13,407,44773407
30975,77,1803000,6,12,26,13,484,44773484
30976,0,1803000,1,12,26,13,484,44773484
30977,0,1803000,1,12,26,13,484,44773484
30978,0,1803000,6,12,26,13,484,44773484
30979,1,1803000,1,12,26,13,485,44773485
30980,0,1803000,1,12,26,13,485,44773485
30981,1,1803000,1,12,26,13,486,44773486
30982,22,1802900,1,12,26,13,508,44773508
30983,9,1802900,1,12,26,13,517,44773517
30984,21,1802900,1,12,26,13,538,44773538
30985,1,1802900,1,12,26,13,539,44773539
30986,0,1802900,17,12,26,13,539,44773539
30987,43,1802800,2,12,26,13,582,44773582
30988,1,1802800,1,12,26,13,583,44773583
30989,0,1802800,2,12,26,13,583,44773583
30990,0,1802800,2,12,26,13,583,44773583
30991,13,1802800,1,12,26,13,596,44773596
30992,7,1802800,1,12,26,13,603,44773603
30993,5,1802800,1,12,26,13,608,44773608
30994,12,1802900,1,12,26,13,620,44773620
30995,14,1802800,1,12,26,13,634,44773634
30996,4,1802800,1,12,26,13,638,44773638
30997,12,1802800,1,12,26,13,650,44773650
30998,1,1802800,1,12,26,13,651,44773651
30999,18,1802800,4,12,26,13,669,44773669
31000,28,1802800,1,12,26,13,697,44773697
31001,77,1802800,1,12,26,13,774,44773774
31002,76,1802800,12,12,26,13,850,44773850
31003,6,1802800,1,12,26,13,856,44773856
31004,4,1802900,1,12,26,13,860,44773860
31005,101,1802900,1,12,26,13,961,44773961
31006,23,1802800,2,12,26,13,984,44773984
31007,44,1802800,2,12,26,14,28,44774028
31008,1,1802800,1,12,26,14,29,44774029
31009,34,1802800,2,12,26,14,63,44774063
31010,228,1802800,1,12,26,14,291,44774291
31011,0,1802800,2,12,26,14,291,44774291
31012,1,1802800,1,12,26,14,292,44774292
31013,1,1802800,2,12,26,14,293,44774293
31014,30,1802800,1,12,26,14,323,44774323
31015,4,1802800,1,12,26,14,327,44774327
31016,131,1802800,1,12,26,14,458,44774458
31017,19,1802800,1,12,26,14,477,44774477
31018,24,1802800,1,12,26,14,501,44774501
31019,140,1802800,1,12,26,14,641,44774641
31020,30,1802900,1,12,26,14,671,44774671
31021,217,1802800,1,12,26,14,888,44774888
31022,201,1802900,1,12,26,15,89,44775089
31023,172,1802900,1,12,26,15,261,44775261
31025,197,1802900,1,12,26,15,458,44775458
31026,478,1802800,1,12,26,15,936,44775936
31027,50,1803000,1,12,26,15,986,44775986
31028,59,1802800,1,12,26,16,45,44776045
31029,169,1803000,1,12,26,16,214,44776214
31030,640,1802900,1,12,26,16,854,44776854
31032,534,1803000,1,12,26,17,388,44777388
31033,51,1802800,5,12,26,17,439,44777439
31034,1069,1802900,1,12,26,18,508,44778508
31035,23,1802800,2,12,26,18,531,44778531
31036,536,1802800,1,12,26,19,67,44779067
31037,953,1802700,1,12,26,20,20,44780020
31038,56,1802800,5,12,26,20,76,44780076
31039,63,1802700,2,12,26,20,139,44780139
31040,494,1802700,2,12,26,20,633,44780633
31041,0,1802700,1,12,26,20,633,44780633
31042,0,1802700,1,12,26,20,633,44780633
31043,0,1802700,2,12,26,20,633,44780633
31044,1,1802700,1,12,26,20,634,44780634
31045,13,1802700,1,12,26,20,647,44780647
31046,0,1802700,6,12,26,20,647,44780647
31047,1,1802700,1,12,26,20,648,44780648
31048,41,1802600,2,12,26,20,689,44780689
31049,0,1802600,1,12,26,20,689,44780689
31050,43,1802600,2,12,26,20,732,44780732
31051,389,1802700,1,12,26,21,121,44781121
31052,1113,1802700,2,12,26,22,234,44782234
31053,579,1802700,1,12,26,22,813,44782813
31054,103,1802700,1,12,26,22,916,44782916
31055,619,1802600,1,12,26,23,535,44783535
31056,236,1802600,1,12,26,23,771,44783771
31057,954,1802700,1,12,26,24,725,44784725
31058,913,1802700,1,12,26,25,638,44785638
31059,106,1802800,3,12,26,25,744,44785744
31060,1129,1802900,1,12,26,26,873,44786873
31061,17,1802800,1,12,26,26,890,44786890
31062,1117,1802700,1,12,26,28,7,44788007
31063,881,1802700,4,12,26,28,888,44788888
31064,330,1802700,1,12,26,29,218,44789218
31065,428,1802700,2,12,26,29,646,44789646
31066,3272,1802800,1,12,26,32,918,44792918
31067,798,1802800,1,12,26,33,716,44793716
31068,579,1802800,2,12,26,34,295,44794295
31069,178,1802700,6,12,26,34,473,44794473
31070,102,1802600,5,12,26,34,575,44794575
31071,1,1802600,4,12,26,34,576,44794576
31072,0,1802600,5,12,26,34,576,44794576
31073,0,1802600,5,12,26,34,576,44794576
31074,0,1802600,7,12,26,34,576,44794576
31075,0,1802600,2,12,26,34,576,44794576
31076,0,1802600,1,12,26,34,576,44794576
31077,0,1802600,2,12,26,34,576,44794576
31078,1,1802500,1,12,26,34,577,44794577
31079,1,1802500,1,12,26,34,578,44794578
31080,52,1802500,2,12,26,34,630,44794630
31081,38,1802600,1,12,26,34,668,44794668
31082,14,1802500,1,12,26,34,682,44794682
31083,6,1802600,1,12,26,34,688,44794688
31084,1,1802600,4,12,26,34,689,44794689
31085,26,1802500,2,12,26,34,715,44794715
31086,297,1802600,1,12,26,35,12,44795012
31087,110,1802600,1,12,26,35,122,44795122
31088,304,1802600,1,12,26,35,426,44795426
31089,3,1802600,1,12,26,35,429,44795429
31090,190,1802600,1,12,26,35,619,44795619
31091,567,1802600,1,12,26,36,186,44796186
31092,1,1802600,1,12,26,36,187,44796187
31093,26,1802500,14,12,26,36,213,44796213
31094,287,1802600,2,12,26,36,500,44796500
31095,89,1802600,1,12,26,36,589,44796589
31096,201,1802500,2,12,26,36,790,44796790
31097,146,1802500,2,12,26,36,936,44796936
31098,167,1802500,3,12,26,37,103,44797103
31100,314,1802400,2,12,26,37,417,44797417
31101,91,1802400,5,12,26,37,508,44797508
31102,189,1802400,1,12,26,37,697,44797697
31103,48,1802400,2,12,26,37,745,44797745
31104,14,1802300,2,12,26,37,759,44797759
31105,37,1802300,1,12,26,37,796,44797796
31106,78,1802300,1,12,26,37,874,44797874
31107,10,1802500,1,12,26,37,884,44797884
31108,35,1802300,1,12,26,37,919,44797919
31109,2,1802300,2,12,26,37,921,44797921
31110,178,1802300,1,12,26,38,99,44798099
31111,60,1802300,1,12,26,38,159,44798159
31112,0,1802300,1,12,26,38,159,44798159
31113,3,1802300,1,12,26,38,162,44798162
31114,59,1802300,1,12,26,38,221,44798221
31115,4,1802400,1,12,26,38,225,44798225
31116,69,1802300,2,12,26,38,294,44798294
31117,4,1802300,1,12,26,38,298,44798298
31118,308,1802300,1,12,26,38,606,44798606
31119,78,1802300,1,12,26,38,684,44798684
31120,34,1802300,1,12,26,38,718,44798718
31121,34,1802300,1,12,26,38,752,44798752
31122,42,1802300,1,12,26,38,794,44798794
31123,36,1802300,1,12,26,38,830,44798830
31124,44,1802300,1,12,26,38,874,44798874
31125,1060,1802300,1,12,26,39,934,44799934
31126,6,1802300,1,12,26,39,940,44799940
31127,140,1802400,2,12,26,40,80,44800080
31128,36,1802300,1,12,26,40,116,44800116
31129,68,1802300,1,12,26,40,184,44800184
31130,59,1802300,5,12,26,40,243,44800243
31131,457,1802300,1,12,26,40,700,44800700
31132,112,1802300,2,12,26,40,812,44800812
31133,108,1802300,2,12,26,40,920,44800920
31134,385,1802200,1,12,26,41,305,44801305
31135,72,1802200,4,12,26,41,377,44801377
31136,52,1802400,1,12,26,41,429,44801429
31137,74,1802300,1,12,26,41,503,44801503
31138,12,1802300,1,12,26,41,515,44801515
31140,0,1802200,1,12,26,41,515,44801515
31141,25,1802200,1,12,26,41,540,44801540
31142,153,1802300,1,12,26,41,693,44801693
31143,642,1802300,1,12,26,42,335,44802335
31144,37,1802300,1,12,26,42,372,44802372
31145,9,1802300,1,12,26,42,381,44802381
31146,225,1802300,2,12,26,42,606,44802606
31147,661,1802400,2,12,26,43,267,44803267
31148,171,1802300,1,12,26,43,438,44803438
31149,52,1802300,1,12,26,43,490,44803490
31150,22,1802400,1,12,26,43,512,44803512
31151,0,1802400,2,12,26,43,512,44803512
31152,327,1802500,1,12,26,43,839,44803839
31153,386,1802400,1,12,26,44,225,44804225
31154,34,1802500,1,12,26,44,259,44804259
31155,337,1802400,1,12,26,44,596,44804596
31156,182,1802400,1,12,26,44,778,44804778
31157,413,1802400,4,12,26,45,191,44805191
31159,422,1802400,5,12,26,45,613,44805613
31160,395,1802500,1,12,26,46,8,44806008
31161,454,1802600,2,12,26,46,462,44806462
31162,94,1802500,1,12,26,46,556,44806556
31163,356,1802500,1,12,26,46,912,44806912
31164,1238,1802500,2,12,26,48,150,44808150
31165,851,1802600,1,12,26,49,1,44809001
31166,293,1802500,1,12,26,49,294,44809294
31167,30,1802600,1,12,26,49,324,44809324
31168,207,1802600,1,12,26,49,531,44809531
31169,452,1802600,1,12,26,49,983,44809983
31170,226,1802500,1,12,26,50,209,44810209
31171,455,1802500,4,12,26,50,664,44810664
31172,6,1802600,1,12,26,50,670,44810670
31173,120,1802600,1,12,26,50,790,44810790
31175,1586,1802600,1,12,26,52,376,44812376
31176,120,1802600,1,12,26,52,496,44812496
31177,68,1802600,1,12,26,52,564,44812564
31178,71,1802700,1,12,26,52,635,44812635
31179,1139,1802700,3,12,26,53,774,44813774
31180,71,1802700,1,12,26,53,845,44813845
31181,69,1802600,1,12,26,53,914,44813914
31182,981,1802700,1,12,26,54,895,44814895
31183,915,1802800,1,12,26,55,810,44815810
31184,141,1802700,1,12,26,55,951,44815951
31185,80,1802700,1,12,26,56,31,44816031
31186,1607,1802700,1,12,26,57,638,44817638
31187,155,1802800,6,12,26,57,793,44817793
31188,623,1803000,1,12,26,58,416,44818416
31189,77,1803000,1,12,26,58,493,44818493
31190,1515,1802900,3,12,27,0,8,44820008
31192,137,1802900,1,12,27,0,145,44820145
31193,615,1802800,1,12,27,0,760,44820760
31195,534,1802700,1,12,27,1,294,44821294
31196,157,1802700,2,12,27,1,451,44821451
31197,1,1802800,3,12,27,1,452,44821452
31198,183,1802600,1,12,27,1,635,44821635
31199,549,1802600,1,12,27,2,184,44822184
31200,1026,1802700,1,12,27,3,210,44823210
31201,298,1802700,3,12,27,3,508,44823508
31202,2004,1802700,14,12,27,5,512,44825512
31203,0,1802700,14,12,27,5,512,44825512
31205,930,1802700,3,12,27,6,442,44826442
31206,0,1802700,1,12,27,6,442,44826442
31207,634,1802700,1,12,27,7,76,44827076
31208,8,1802600,1,12,27,7,84,44827084
31209,2095,1802700,2,12,27,9,179,44829179
31210,656,1802700,1,12,27,9,835,44829835
31211,612,1802800,1,12,27,10,447,44830447
31212,1727,1802800,1,12,27,12,174,44832174
31213,817,1802700,3,12,27,12,991,44832991
31214,239,1802600,1,12,27,13,230,44833230
31215,714,1802800,1,12,27,13,944,44833944
31216,6,1802600,1,12,27,13,950,44833950
31217,475,1802600,7,12,27,14,425,44834425
31219,1983,1802600,1,12,27,16,408,44836408
31220,1618,1802700,1,12,27,18,26,44838026
31221,826,1802600,1,12,27,18,852,44838852
31222,1251,1802600,1,12,27,20,103,44840103
31223,766,1802700,1,12,27,20,869,44840869
31224,2353,1802700,1,12,27,23,222,44843222
31226,3085,1802600,2,12,27,26,307,44846307
31227,1245,1802600,1,12,27,27,552,44847552
31228,1664,1802500,5,12,27,29,216,44849216
31229,37,1802500,18,12,27,29,253,44849253
31230,1,1802500,1,12,27,29,254,44849254
31231,165,1802500,1,12,27,29,419,44849419
31232,30,1802400,1,12,27,29,449,44849449
31233,133,1802400,2,12,27,29,582,44849582
31234,35,1802400,2,12,27,29,617,44849617
31235,15,1802400,4,12,27,29,632,44849632
31236,437,1802500,1,12,27,30,69,44850069
31237,491,1802600,2,12,27,30,560,44850560
31238,358,1802600,1,12,27,30,918,44850918
31239,3494,1802400,2,12,27,34,412,44854412
31240,32,1802400,1,12,27,34,444,44854444
31241,910,1802500,1,12,27,35,354,44855354
31242,1456,1802500,1,12,27,36,810,44856810
31243,335,1802500,2,12,27,37,145,44857145
31244,444,1802500,2,12,27,37,589,44857589
31245,205,1802500,1,12,27,37,794,44857794
31246,1422,1802400,1,12,27,39,216,44859216
31247,2173,1802400,3,12,27,41,389,44861389
31248,615,1802500,2,12,27,42,4,44862004
31249,838,1802500,1,12,27,42,842,44862842
31250,856,1802400,1,12,27,43,698,44863698
31251,953,1802400,1,12,27,44,651,44864651
31252,55,1802500,3,12,27,44,706,44864706
31254,1901,1802400,1,12,27,46,607,44866607
31255,1890,1802400,1,12,27,48,497,44868497
31256,1454,1802500,1,12,27,49,951,44869951
31257,1183,1802500,5,12,27,51,134,44871134
31258,4551,1802500,1,12,27,55,685,44875685
31259,938,1802500,1,12,27,56,623,44876623
31260,874,1802400,8,12,27,57,497,44877497
31262,2469,1802400,1,12,27,59,966,44879966
31263,39,1802400,2,12,28,0,5,44880005
31264,109,1802400,2,12,28,0,114,44880114
31266,2315,1802300,1,12,28,2,429,44882429
31267,423,1802400,1,12,28,2,852,44882852
31268,1025,1802500,1,12,28,3,877,44883877
31269,858,1802500,1,12,28,4,735,44884735
31270,256,1802500,1,12,28,4,991,44884991
31271,255,1802300,4,12,28,5,246,44885246
31272,741,1802400,1,12,28,5,987,44885987
31273,1706,1802400,5,12,28,7,693,44887693
31275,2,1802300,4,12,28,7,695,44887695
31276,650,1802300,1,12,28,8,345,44888345
31277,343,1802300,1,12,28,8,688,44888688
31278,466,1802400,1,12,28,9,154,44889154
31279,191,1802300,1,12,28,9,345,44889345
31280,2874,1802300,1,12,28,12,219,44892219
31281,1415,1802300,2,12,28,13,634,44893634
31283,138,1802200,2,12,28,13,772,44893772
31284,1,1802200,1,12,28,13,773,44893773
31285,5,1802200,1,12,28,13,778,44893778
31286,36,1802200,1,12,28,13,814,44893814
31287,78,1802200,1,12,28,13,892,44893892
31288,98,1802200,2,12,28,13,990,44893990
31289,889,1802300,1,12,28,14,879,44894879
31290,1229,1802200,5,12,28,16,108,44896108
31291,1459,1802200,5,12,28,17,567,44897567
31292,33,1802200,1,12,28,17,600,44897600
31293,1,1802200,1,12,28,17,601,44897601
31294,2945,1802200,1,12,28,20,546,44900546
31295,80,1802300,5,12,28,20,626,44900626
31296,613,1802200,1,12,28,21,239,44901239
31297,111,1802200,1,12,28,21,350,44901350
31298,1663,1802200,1,12,28,23,13,44903013
31299,1437,1802300,1,12,28,24,450,44904450
31300,715,1802300,8,12,28,25,165,44905165
31301,340,1802300,1,12,28,25,505,44905505
31302,660,1802300,1,12,28,26,165,44906165
31303,527,1802300,1,12,28,26,692,44906692
31304,1272,1802400,4,12,28,27,964,44907964
31305,0,1802400,2,12,28,27,964,44907964
31306,12,1802300,1,12,28,27,976,44907976
31307,0,1802300,1,12,28,27,976,44907976
31308,576,1802300,3,12,28,28,552,44908552
31310,2773,1802300,2,12,28,31,325,44911325
31311,231,1802400,1,12,28,31,556,44911556
31312,1306,1802400,1,12,28,32,862,44912862
31313,148,1802300,1,12,28,33,10,44913010
31314,1049,1802300,3,12,28,34,59,44914059
31315,699,1802300,1,12,28,34,758,44914758
31316,147,1802300,1,12,28,34,905,44914905
31317,719,1802300,1,12,28,35,624,44915624
31318,1737,1802400,1,12,28,37,361,44917361
31319,2,1802400,1,12,28,37,363,44917363
31320,875,1802300,1,12,28,38,238,44918238
31321,2645,1802500,2,12,28,40,883,44920883
31322,415,1802400,1,12,28,41,298,44921298
31323,1033,1802500,9,12,28,42,331,44922331
31324,230,1802500,2,12,28,42,561,44922561
31325,162,1802500,1,12,28,42,723,44922723
31327,764,1802400,1,12,28,43,487,44923487
31328,72,1802400,2,12,28,43,559,44923559
31329,999,1802400,1,12,28,44,558,44924558
31330,7520,1802500,2,12,28,52,78,44932078
31331,2379,1802500,1,12,28,54,457,44934457
31332,18,1802400,1,12,28,54,475,44934475
31333,1650,1802400,1,12,28,56,125,44936125
31334,71,1802400,1,12,28,56,196,44936196
31335,275,1802400,1,12,28,56,471,44936471
31336,102,1802600,1,12,28,56,573,44936573
31337,214,1802500,1,12,28,56,787,44936787
31338,913,1802500,1,12,28,57,700,44937700
31339,474,1802500,1,12,28,58,174,44938174
31340,996,1802400,3,12,28,59,170,44939170
31341,1105,1802400,1,12,29,0,275,44940275
31342,235,1802600,1,12,29,0,510,44940510
31343,9,1802600,1,12,29,0,519,44940519
31344,81,1802400,4,12,29,0,600,44940600
31345,103,1802400,3,12,29,0,703,44940703
31347,158,1802500,1,12,29,0,861,44940861
31348,20,1802500,2,12,29,0,881,44940881
31349,14,1802500,2,12,29,0,895,44940895
31350,390,1802500,1,12,29,1,285,44941285
31351,451,1802300,5,12,29,1,736,44941736
31352,328,1802300,1,12,29,2,64,44942064
31353,349,1802400,1,12,29,2,413,44942413
31354,365,1802400,1,12,29,2,778,44942778
31355,781,1802300,8,12,29,3,559,44943559
31356,2769,1802200,1,12,29,6,328,44946328
31357,180,1802200,1,12,29,6,508,44946508
31358,177,1802200,1,12,29,6,685,44946685
31359,1223,1802200,9,12,29,7,908,44947908
31360,15,1802200,1,12,29,7,923,44947923
31361,622,1802200,1,12,29,8,545,44948545
31362,185,1802100,1,12,29,8,730,44948730
31363,119,1802100,1,12,29,8,849,44948849
31364,0,1802100,1,12,29,8,849,44948849
31365,249,1802100,1,12,29,9,98,44949098
31366,519,1802100,1,12,29,9,617,44949617
31367,179,1802100,1,12,29,9,796,44949796
31368,526,1802200,1,12,29,10,322,44950322
31369,317,1802100,19,12,29,10,639,44950639
31370,1,1802100,1,12,29,10,640,44950640
31371,0,1802100,1,12,29,10,640,44950640
31372,0,1802100,3,12,29,10,640,44950640
31373,43,1802000,1,12,29,10,683,44950683
31374,0,1802000,9,12,29,10,683,44950683
31375,12,1802000,21,12,29,10,695,44950695
31376,72,1801900,1,12,29,10,767,44950767
31377,4,1802000,1,12,29,10,771,44950771
31378,67,1801900,1,12,29,10,838,44950838
31379,43,1801900,1,12,29,10,881,44950881
31380,52,1801900,3,12,29,10,933,44950933
31381,26,1802000,1,12,29,10,959,44950959
31382,77,1801900,4,12,29,11,36,44951036
31383,25,1801900,1,12,29,11,61,44951061
31384,44,1801900,1,12,29,11,105,44951105
31385,0,1801900,1,12,29,11,105,44951105
31386,5,1801900,1,12,29,11,110,44951110
31387,1,1801900,1,12,29,11,111,44951111
31388,16,1801800,1,12,29,11,127,44951127
31389,5,1801800,1,12,29,11,132,44951132
31390,21,1801800,1,12,29,11,153,44951153
31391,74,1801800,2,12,29,11,227,44951227
31392,0,1801800,3,12,29,11,227,44951227
31393,22,1801800,1,12,29,11,249,44951249
31394,13,1801800,1,12,29,11,262,44951262
31395,7,1801800,1,12,29,11,269,44951269
31396,12,1801800,1,12,29,11,281,44951281
31397,51,1801800,2,12,29,11,332,44951332
31398,1,1801800,1,12,29,11,333,44951333
31399,2,1801800,2,12,29,11,335,44951335
31400,2,1801800,2,12,29,11,337,44951337
31401,146,1801800,1,12,29,11,483,44951483
31402,0,1801800,1,12,29,11,483,44951483
31403,2,1801800,1,12,29,11,485,44951485
31404,0,1801800,1,12,29,11,485,44951485
31405,0,1801800,1,12,29,11,485,44951485
31406,8,1801800,1,12,29,11,493,44951493
31407,8,1801800,1,12,29,11,501,44951501
31408,209,1801800,1,12,29,11,710,44951710
31409,30,1801800,6,12,29,11,740,44951740
31410,130,1801800,2,12,29,11,870,44951870
31411,75,1801900,1,12,29,11,945,44951945
31412,293,1801900,1,12,29,12,238,44952238
31413,5,1801800,1,12,29,12,243,44952243
31414,1,1801800,1,12,29,12,244,44952244
31415,520,1801900,1,12,29,12,764,44952764
31416,206,1801800,2,12,29,12,970,44952970
31417,298,1801900,2,12,29,13,268,44953268
31418,108,1801800,3,12,29,13,376,44953376
31420,115,1801700,2,12,29,13,491,44953491
31421,5,1801700,1,12,29,13,496,44953496
31422,39,1801600,2,12,29,13,535,44953535
31423,2,1801600,2,12,29,13,537,44953537
31424,0,1801600,2,12,29,13,537,44953537
31425,67,1801600,1,12,29,13,604,44953604
31426,229,1801800,1,12,29,13,833,44953833
31427,72,1801800,2,12,29,13,905,44953905
31428,39,1801700,1,12,29,13,944,44953944
31430,34,1801600,2,12,29,13,978,44953978
31431,76,1801600,2,12,29,14,54,44954054
31432,29,1801700,1,12,29,14,83,44954083
31433,44,1801700,1,12,29,14,127,44954127
31434,109,1801600,1,12,29,14,236,44954236
31435,6,1801600,1,12,29,14,242,44954242
31436,138,1801600,1,12,29,14,380,44954380
31437,207,1801600,1,12,29,14,587,44954587
31438,282,1801600,2,12,29,14,869,44954869
31439,224,1801700,1,12,29,15,93,44955093
31440,128,1801800,1,12,29,15,221,44955221
31441,103,1801800,1,12,29,15,324,44955324
31442,92,1801700,1,12,29,15,416,44955416
31443,132,1801800,1,12,29,15,548,44955548
31444,98,1801900,1,12,29,15,646,44955646
31445,55,1801800,1,12,29,15,701,44955701
31446,870,1801900,1,12,29,16,571,44956571
31447,352,1801800,1,12,29,16,923,44956923
31448,194,1801700,1,12,29,17,117,44957117
31449,859,1801800,1,12,29,17,976,44957976
31450,557,1801900,3,12,29,18,533,44958533
31451,1,1801900,1,12,29,18,534,44958534
31452,1289,1801900,1,12,29,19,823,44959823
31453,583,1802000,3,12,29,20,406,44960406
31455,701,1801900,2,12,29,21,107,44961107
31457,1683,1801900,2,12,29,22,790,44962790
31458,810,1801900,1,12,29,23,600,44963600
31459,578,1801900,2,12,29,24,178,44964178
31460,212,1802100,1,12,29,24,390,44964390
31461,416,1801900,2,12,29,24,806,44964806
31462,114,1801800,2,12,29,24,920,44964920
31463,714,1801900,1,12,29,25,634,44965634
31464,569,1801900,1,12,29,26,203,44966203
31465,590,1801900,1,12,29,26,793,44966793
31466,362,1802000,1,12,29,27,155,44967155
31467,1948,1801800,2,12,29,29,103,44969103
31468,430,1802000,1,12,29,29,533,44969533
31469,423,1801900,2,12,29,29,956,44969956
31470,228,1801800,2,12,29,30,184,44970184
31471,421,1801800,1,12,29,30,605,44970605
31472,392,1801800,2,12,29,30,997,44970997
31473,183,1801800,1,12,29,31,180,44971180
31474,3528,1801800,1,12,29,34,708,44974708
31475,6,1801800,1,12,29,34,714,44974714
31476,336,1801900,1,12,29,35,50,44975050
31477,994,1801800,1,12,29,36,44,44976044
31478,965,1802000,1,12,29,37,9,44977009
31479,477,1801800,1,12,29,37,486,44977486
31480,1920,1801900,1,12,29,39,406,44979406
31481,137,1801900,1,12,29,39,543,44979543
31482,842,1801900,2,12,29,40,385,44980385
31483,782,1801800,4,12,29,41,167,44981167
31484,218,1801800,2,12,29,41,385,44981385
31485,727,1801900,1,12,29,42,112,44982112
31486,658,1801800,1,12,29,42,770,44982770
31487,360,1801900,1,12,29,43,130,44983130
31488,1711,1801900,2,12,29,44,841,44984841
31489,3303,1801900,1,12,29,48,144,44988144
31490,1764,1801900,1,12,29,49,908,44989908
31491,2118,1801900,1,12,29,52,26,44992026
31492,104,1801800,1,12,29,52,130,44992130
31493,3,1801800,16,12,29,52,133,44992133
31495,1780,1801800,1,12,29,53,913,44993913
31496,2233,1801700,1,12,29,56,146,44996146
31497,12,1801700,1,12,29,56,158,44996158
31498,55,1801700,2,12,29,56,213,44996213
31499,1659,1801800,1,12,29,57,872,44997872
31500,86,1801700,2,12,29,57,958,44997958
31501,54,1801700,1,12,29,58,12,44998012
31502,133,1801800,3,12,29,58,145,44998145
31503,968,1801800,2,12,29,59,113,44999113
31504,50,1801700,1,12,29,59,163,44999163
31505,82,1801700,1,12,29,59,245,44999245
31506,1122,1801800,1,12,30,0,367,45000367
31507,61,1801800,1,12,30,0,428,45000428
31508,50,1801800,2,12,30,0,478,45000478
31509,21,1801700,1,12,30,0,499,45000499
31510,202,1801700,1,12,30,0,701,45000701
31511,19,1801700,1,12,30,0,720,45000720
31512,23,1801700,4,12,30,0,743,45000743
31513,19,1801600,1,12,30,0,762,45000762
31514,12,1801600,1,12,30,0,774,45000774
31515,10,1801600,1,12,30,0,784,45000784
31516,8,1801600,1,12,30,0,792,45000792
31517,7,1801600,1,12,30,0,799,45000799
31518,0,1801600,1,12,30,0,799,45000799
31519,9,1801600,1,12,30,0,808,45000808
31520,7,1801600,1,12,30,0,815,45000815
31521,9,1801600,1,12,30,0,824,45000824
31522,9,1801600,1,12,30,0,833,45000833
31523,8,1801600,1,12,30,0,841,45000841
31524,8,1801600,1,12,30,0,849,45000849
31525,7,1801600,1,12,30,0,856,45000856
31526,18,1801600,1,12,30,0,874,45000874
31527,2,1801700,1,12,30,0,876,45000876
31528,17,1801600,6,12,30,0,893,45000893
31529,6,1801600,1,12,30,0,899,45000899
31530,18,1801600,1,12,30,0,917,45000917
31531,17,1801600,1,12,30,0,934,45000934
31532,5,1801600,1,12,30,0,939,45000939
31533,0,1801600,1,12,30,0,939,45000939
31534,0,1801600,1,12,30,0,939,45000939
31535,0,1801600,1,12,30,0,939,45000939
31536,10,1801600,1,12,30,0,949,45000949
31537,14,1801600,1,12,30,0,963,45000963
31538,12,1801600,1,12,30,0,975,45000975
31539,23,1801600,1,12,30,0,998,45000998
31540,3,1801500,1,12,30,1,1,45001001
31541,41,1801600,1,12,30,1,42,45001042
31542,7,1801600,1,12,30,1,49,45001049
31543,15,1801500,1,12,30,1,64,45001064
31544,5,1801500,1,12,30,1,69,45001069
31545,20,1801500,1,12,30,1,89,45001089
31546,11,1801500,1,12,30,1,100,45001100
31547,0,1801500,2,12,30,1,100,45001100
31548,3,1801500,1,12,30,1,103,45001103
31549,0,1801500,1,12,30,1,103,45001103
31550,0,1801500,1,12,30,1,103,45001103
31551,0,1801500,1,12,30,1,103,45001103
31552,22,1801500,2,12,30,1,125,45001125
31553,17,1801500,1,12,30,1,142,45001142
31554,0,1801500,1,12,30,1,142,45001142
31555,11,1801500,1,12,30,1,153,45001153
31556,14,1801500,1,12,30,1,167,45001167
31557,11,1801500,1,12,30,1,178,45001178
31558,20,1801500,2,12,30,1,198,45001198
31559,20,1801500,1,12,30,1,218,45001218
31560,15,1801500,1,12,30,1,233,45001233
31561,17,1801500,1,12,30,1,250,45001250
31562,2,1801500,1,12,30,1,252,45001252
31563,6,1801600,1,12,30,1,258,45001258
31564,0,1801500,1,12,30,1,258,45001258
31565,19,1801500,1,12,30,1,277,45001277
31566,6,1801500,1,12,30,1,283,45001283
31567,18,1801500,1,12,30,1,301,45001301
31568,33,1801500,1,12,30,1,334,45001334
31569,5,1801400,8,12,30,1,339,45001339
31570,2,1801500,1,12,30,1,341,45001341
31572,36,1801400,1,12,30,1,377,45001377
31573,6,1801400,1,12,30,1,383,45001383
31574,22,1801600,2,12,30,1,405,45001405
31575,3,1801500,1,12,30,1,408,45001408
31576,8,1801500,1,12,30,1,416,45001416
31577,12,1801400,1,12,30,1,428,45001428
31578,25,1801400,1,12,30,1,453,45001453
31579,6,1801400,1,12,30,1,459,45001459
31580,50,1801400,1,12,30,1,509,45001509
31581,0,1801600,2,12,30,1,509,45001509
31582,1,1801600,1,12,30,1,510,45001510
31583,2,1801600,1,12,30,1,512,45001512
31584,1,1801500,1,12,30,1,513,45001513
31585,46,1801500,1,12,30,1,559,45001559
31586,1,1801600,1,12,30,1,560,45001560
31587,2,1801500,1,12,30,1,562,45001562
31588,7,1801500,4,12,30,1,569,45001569
31589,5,1801500,1,12,30,1,574,45001574
31590,34,1801500,1,12,30,1,608,45001608
31591,1,1801500,1,12,30,1,609,45001609
31592,0,1801600,1,12,30,1,609,45001609
31593,24,1801500,1,12,30,1,633,45001633
31594,1,1801600,1,12,30,1,634,45001634
31595,19,1801500,1,12,30,1,653,45001653
31596,38,1801700,2,12,30,1,691,45001691
31597,1,1801700,1,12,30,1,692,45001692
31598,17,1801700,1,12,30,1,709,45001709
31599,87,1801700,1,12,30,1,796,45001796
31600,44,1801800,3,12,30,1,840,45001840
31601,23,1801700,1,12,30,1,863,45001863
31602,25,1801700,1,12,30,1,888,45001888
31603,25,1801700,1,12,30,1,913,45001913
31604,81,1801800,1,12,30,1,994,45001994
31605,45,1801700,1,12,30,2,39,45002039
31606,564,1801800,1,12,30,2,603,45002603
31607,355,1801800,1,12,30,2,958,45002958
31608,12,1801800,1,12,30,2,970,45002970
31609,253,1801800,5,12,30,3,223,45003223
31610,66,1801800,1,12,30,3,289,45003289
31611,3,1801700,1,12,30,3,292,45003292
31612,455,1801700,2,12,30,3,747,45003747
31613,2670,1801700,1,12,30,6,417,45006417
31614,140,1801800,2,12,30,6,557,45006557
31615,640,1801700,1,12,30,7,197,45007197
31616,29,1801700,1,12,30,7,226,45007226
31617,0,1801600,1,12,30,7,226,45007226
31618,703,1801700,1,12,30,7,929,45007929
31619,414,1801700,1,12,30,8,343,45008343
31620,177,1801600,2,12,30,8,520,45008520
31621,857,1801500,1,12,30,9,377,45009377
31622,623,1801500,5,12,30,10,0,45010000
31623,119,1801500,3,12,30,10,119,45010119
31624,567,1801500,2,12,30,10,686,45010686
31625,397,1801500,1,12,30,11,83,45011083
31626,964,1801400,13,12,30,12,47,45012047
31628,1,1801300,3,12,30,12,48,45012048
31629,12,1801400,3,12,30,12,60,45012060
31631,59,1801300,1,12,30,12,119,45012119
31632,5,1801300,1,12,30,12,124,45012124
31633,6,1801300,4,12,30,12,130,45012130
31634,12,1801300,2,12,30,12,142,45012142
31635,14,1801300,1,12,30,12,156,45012156
31636,29,1801300,1,12,30,12,185,45012185
31637,64,1801300,1,12,30,12,249,45012249
31638,268,1801300,2,12,30,12,517,45012517
31639,31,1801300,1,12,30,12,548,45012548
31640,6,1801300,5,12,30,12,554,45012554
31642,13,1801200,1,12,30,12,567,45012567
31643,126,1801300,1,12,30,12,693,45012693
31644,9,1801300,1,12,30,12,702,45012702
31645,7,1801200,1,12,30,12,709,45012709
31646,139,1801200,1,12,30,12,848,45012848
31647,84,1801300,1,12,30,12,932,45012932
31648,13,1801300,1,12,30,12,945,45012945
31649,317,1801300,1,12,30,13,262,45013262
31650,17,1801300,1,12,30,13,279,45013279
31652,244,1801400,2,12,30,13,523,45013523
31653,72,1801400,1,12,30,13,595,45013595
31654,378,1801300,2,12,30,13,973,45013973
31655,31,1801500,3,12,30,14,4,45014004
31656,292,1801400,1,12,30,14,296,45014296
31657,286,1801400,1,12,30,14,582,45014582
31658,69,1801400,1,12,30,14,651,45014651
31659,105,1801400,2,12,30,14,756,45014756
31660,102,1801400,1,12,30,14,858,45014858
31661,241,1801400,1,12,30,15,99,45015099
31662,248,1801300,2,12,30,15,347,45015347
31663,2060,1801300,1,12,30,17,407,45017407
31664,12,1801300,1,12,30,17,419,45017419
31665,122,1801400,5,12,30,17,541,45017541
31666,54,1801300,1,12,30,17,595,45017595
31667,42,1801300,2,12,30,17,637,45017637
31668,549,1801400,1,12,30,18,186,45018186
31669,1,1801400,1,12,30,18,187,45018187
31670,39,1801300,1,12,30,18,226,45018226
31671,0,1801300,1,12,30,18,226,45018226
31672,294,1801300,1,12,30,18,520,45018520
31673,1359,1801300,1,12,30,19,879,45019879
31674,41,1801400,1,12,30,19,920,45019920
31675,228,1801300,1,12,30,20,148,45020148
31676,65,1801300,1,12,30,20,213,45020213
31677,200,1801300,1,12,30,20,413,45020413
31678,273,1801300,2,12,30,20,686,45020686
31679,363,1801200,2,12,30,21,49,45021049
31680,21,1801200,1,12,30,21,70,45021070
31681,49,1801200,1,12,30,21,119,45021119
31682,9,1801200,1,12,30,21,128,45021128
31683,38,1801200,3,12,30,21,166,45021166
31684,6,1801200,1,12,30,21,172,45021172
31685,86,1801300,2,12,30,21,258,45021258
31686,180,1801300,1,12,30,21,438,45021438
31687,101,1801300,1,12,30,21,539,45021539
31688,207,1801400,3,12,30,21,746,45021746
31689,646,1801500,1,12,30,22,392,45022392
31690,889,1801400,1,12,30,23,281,45023281
31691,721,1801400,1,12,30,24,2,45024002
31692,41,1801400,1,12,30,24,43,45024043
31693,157,1801500,1,12,30,24,200,45024200
31694,558,1801500,2,12,30,24,758,45024758
31695,98,1801500,3,12,30,24,856,45024856
31696,271,1801400,1,12,30,25,127,45025127
31697,320,1801400,1,12,30,25,447,45025447
31698,229,1801400,1,12,30,25,676,45025676
31699,689,1801400,3,12,30,26,365,45026365
31701,15,1801500,1,12,30,26,380,45026380
31702,4,1801400,1,12,30,26,384,45026384
31704,2688,1801400,1,12,30,29,72,45029072
31705,874,1801400,1,12,30,29,946,45029946
31706,85,1801300,2,12,30,30,31,45030031
31707,375,1801300,1,12,30,30,406,45030406
31708,1347,1801300,1,12,30,31,753,45031753
31709,179,1801300,2,12,30,31,932,45031932
31710,402,1801300,2,12,30,32,334,45032334
31711,431,1801400,2,12,30,32,765,45032765
31712,263,1801300,1,12,30,33,28,45033028
31713,940,1801400,2,12,30,33,968,45033968
31714,837,1801300,2,12,30,34,805,45034805
31715,551,1801400,2,12,30,35,356,45035356
31716,2391,1801400,1,12,30,37,747,45037747
31717,607,1801400,1,12,30,38,354,45038354
31718,572,1801400,1,12,30,38,926,45038926
31719,2741,1801400,1,12,30,41,667,45041667
31720,976,1801300,3,12,30,42,643,45042643
31721,239,1801300,3,12,30,42,882,45042882
31722,699,1801300,2,12,30,43,581,45043581
31724,2,1801200,1,12,30,43,583,45043583
31725,1416,1801400,3,12,30,44,999,45044999
31726,515,1801300,2,12,30,45,514,45045514
31727,221,1801400,1,12,30,45,735,45045735
31728,1979,1801400,1,12,30,47,714,45047714
31729,67,1801400,1,12,30,47,781,45047781
31730,240,1801500,2,12,30,48,21,45048021
31731,0,1801500,7,12,30,48,21,45048021
31732,0,1801500,1,12,30,48,21,45048021
31733,0,1801500,6,12,30,48,21,45048021
31734,767,1801500,1,12,30,48,788,45048788
31735,808,1801600,1,12,30,49,596,45049596
31736,43,1801600,1,12,30,49,639,45049639
31737,185,1801600,1,12,30,49,824,45049824
31738,22,1801700,1,12,30,49,846,45049846
31739,29,1801700,1,12,30,49,875,45049875
31740,466,1801500,1,12,30,50,341,45050341
31741,1680,1801600,1,12,30,52,21,45052021
31742,0,1801600,1,12,30,52,21,45052021
31744,753,1801700,1,12,30,52,774,45052774
31745,1361,1801600,1,12,30,54,135,45054135
31746,772,1801700,2,12,30,54,907,45054907
31747,212,1801800,1,12,30,55,119,45055119
31748,0,1801800,1,12,30,55,119,45055119
31749,0,1801800,1,12,30,55,119,45055119
31750,0,1801800,1,12,30,55,119,45055119
31751,165,1801700,4,12,30,55,284,45055284
31752,48,1801700,1,12,30,55,332,45055332
31753,38,1801900,1,12,30,55,370,45055370
31754,1042,1801900,10,12,30,56,412,45056412
31755,299,1801800,1,12,30,56,711,45056711
31756,918,1801900,1,12,30,57,629,45057629
31757,1376,1801900,1,12,30,59,5,45059005
31758,207,1801900,1,12,30,59,212,45059212
31759,197,1801900,4,12,30,59,409,45059409
31761,141,1802000,5,12,30,59,550,45059550
31762,64,1802000,1,12,30,59,614,45059614
31763,19,1802000,1,12,30,59,633,45059633
31764,1161,1802000,3,12,31,0,794,45060794
31765,110,1801900,1,12,31,0,904,45060904
31766,237,1802000,4,12,31,1,141,45061141
31767,449,1801800,2,12,31,1,590,45061590
31768,0,1801800,5,12,31,1,590,45061590
31769,212,1801900,1,12,31,1,802,45061802
31770,151,1801900,2,12,31,1,953,45061953
31771,586,1801900,2,12,31,2,539,45062539
31772,259,1801800,1,12,31,2,798,45062798
31773,1780,1801900,1,12,31,4,578,45064578
31774,2219,1801900,1,12,31,6,797,45066797
31775,40,1802000,1,12,31,6,837,45066837
31776,994,1801900,1,12,31,7,831,45067831
31777,2611,1801900,2,12,31,10,442,45070442
31778,1520,1801900,1,12,31,11,962,45071962
31779,960,1801900,1,12,31,12,922,45072922
31780,558,1802000,2,12,31,13,480,45073480
31781,68,1802000,3,12,31,13,548,45073548
31782,0,1802000,1,12,31,13,548,45073548
31783,0,1802000,1,12,31,13,548,45073548
31784,0,1802000,3,12,31,13,548,45073548
31785,0,1802000,2,12,31,13,548,45073548
31786,144,1802000,3,12,31,13,692,45073692
31788,886,1802000,1,12,31,14,578,45074578
31789,502,1802100,1,12,31,15,80,45075080
31790,0,1802100,6,12,31,15,80,45075080
31791,1,1802100,1,12,31,15,81,45075081
31792,0,1802100,1,12,31,15,81,45075081
31793,276,1802100,2,12,31,15,357,45075357
31794,607,1802000,1,12,31,15,964,45075964
31795,696,1802100,1,12,31,16,660,45076660
31796,245,1802000,1,12,31,16,905,45076905
31797,659,1802100,10,12,31,17,564,45077564
31798,1,1802100,1,12,31,17,565,45077565
31799,359,1802200,2,12,31,17,924,45077924
31801,162,1802300,1,12,31,18,86,45078086
31802,997,1802200,1,12,31,19,83,45079083
31803,53,1802300,2,12,31,19,136,45079136
31804,1186,1802200,1,12,31,20,322,45080322
31805,130,1802100,2,12,31,20,452,45080452
31806,7,1802200,1,12,31,20,459,45080459
31807,43,1802200,4,12,31,20,502,45080502
31808,1,1802200,1,12,31,20,503,45080503
31809,1843,1802100,1,12,31,22,346,45082346
31810,882,1802200,3,12,31,23,228,45083228
31812,269,1802300,1,12,31,23,497,45083497
31813,610,1802100,1,12,31,24,107,45084107
31814,975,1802200,1,12,31,25,82,45085082
31815,2808,1802100,2,12,31,27,890,45087890
31816,0,1802100,4,12,31,27,890,45087890
31817,2,1802000,1,12,31,27,892,45087892
31818,0,1802000,3,12,31,27,892,45087892
31819,205,1802000,1,12,31,28,97,45088097
31820,188,1802000,1,12,31,28,285,45088285
31821,79,1802000,1,12,31,28,364,45088364
31822,16,1802000,2,12,31,28,380,45088380
31823,29,1802000,1,12,31,28,409,45088409
31824,52,1802000,2,12,31,28,461,45088461
31825,147,1801900,2,12,31,28,608,45088608
31826,86,1802000,1,12,31,28,694,45088694
31828,10,1802000,1,12,31,28,704,45088704
31829,29,1802000,1,12,31,28,733,45088733
31830,1294,1802000,1,12,31,30,27,45090027
31831,523,1802000,1,12,31,30,550,45090550
31832,104,1802100,1,12,31,30,654,45090654
31833,873,1802100,3,12,31,31,527,45091527
31834,533,1802100,1,12,31,32,60,45092060
31835,1463,1802000,4,12,31,33,523,45093523
31836,2039,1802100,1,12,31,35,562,45095562
31837,2107,1802100,1,12,31,37,669,45097669
31838,673,1802000,1,12,31,38,342,45098342
31839,235,1802000,1,12,31,38,577,45098577
31840,1442,1802000,1,12,31,40,19,45100019
31841,5557,1801900,2,12,31,45,576,45105576
31842,1,1801900,5,12,31,45,577,45105577
31843,2667,1801900,1,12,31,48,244,45108244
31844,2304,1801800,1,12,31,50,548,45110548
31845,120,1801900,1,12,31,50,668,45110668
31846,1831,1801800,1,12,31,52,499,45112499
31847,516,1801900,1,12,31,53,15,45113015
31848,1658,1801800,1,12,31,54,673,45114673
31849,0,1801800,23,12,31,54,673,45114673
31850,3,1801700,3,12,31,54,676,45114676
31851,0,1801700,6,12,31,54,676,45114676
31852,0,1801700,2,12,31,54,676,45114676
31853,126,1801700,4,12,31,54,802,45114802
31854,1171,1801600,1,12,31,55,973,45115973
31855,0,1801600,1,12,31,55,973,45115973
31856,1,1801600,1,12,31,55,974,45115974
31857,25,1801600,6,12,31,55,999,45115999
31858,108,1801600,1,12,31,56,107,45116107
31859,10,1801600,2,12,31,56,117,45116117
31860,333,1801500,1,12,31,56,450,45116450
31861,1567,1801500,1,12,31,58,17,45118017
31862,0,1801500,4,12,31,58,17,45118017
31863,0,1801500,3,12,31,58,17,45118017
31864,52,1801500,1,12,31,58,69,45118069
31865,394,1801400,1,12,31,58,463,45118463
31866,1592,1801500,4,12,32,0,55,45120055
31867,0,1801500,1,12,32,0,55,45120055
31868,25,1801400,1,12,32,0,80,45120080
31869,59,1801500,1,12,32,0,139,45120139
31870,79,1801400,1,12,32,0,218,45120218
31871,0,1801400,9,12,32,0,218,45120218
31872,383,1801400,1,12,32,0,601,45120601
31873,22,1801300,2,12,32,0,623,45120623
31874,6,1801300,1,12,32,0,629,45120629
31875,1118,1801400,1,12,32,1,747,45121747
31876,539,1801300,5,12,32,2,286,45122286
31877,1090,1801300,1,12,32,3,376,45123376
31878,613,1801300,1,12,32,3,989,45123989
31879,1,1801300,5,12,32,3,990,45123990
31880,1,1801300,1,12,32,3,991,45123991
31881,0,1801300,1,12,32,3,991,45123991
31882,0,1801300,1,12,32,3,991,45123991
31883,128,1801400,3,12,32,4,119,45124119
31884,63,1801300,2,12,32,4,182,45124182
31885,89,1801400,1,12,32,4,271,45124271
31886,2581,1801400,1,12,32,6,852,45126852
31887,4412,1801400,1,12,32,11,264,45131264
31888,1700,1801300,8,12,32,12,964,45132964
31889,4468,1801300,1,12,32,17,432,45137432
31890,1654,1801300,5,12,32,19,86,45139086
31891,1534,1801300,1,12,32,20,620,45140620
31892,419,1801300,1,12,32,21,39,45141039
31893,606,1801200,2,12,32,21,645,45141645
31894,165,1801200,1,12,32,21,810,45141810
31895,462,1801200,1,12,32,22,272,45142272
31896,110,1801200,1,12,32,22,382,45142382
31897,985,1801300,4,12,32,23,367,45143367
31898,263,1801300,1,12,32,23,630,45143630
31899,17,1801300,1,12,32,23,647,45143647
31900,741,1801300,1,12,32,24,388,45144388
31901,368,1801300,1,12,32,24,756,45144756
31902,418,1801300,1,12,32,25,174,45145174
31903,550,1801400,6,12,32,25,724,45145724
31905,1,1801400,1,12,32,25,725,45145725
31906,0,1801400,1,12,32,25,725,45145725
31907,160,1801300,2,12,32,25,885,45145885
31908,57,1801300,1,12,32,25,942,45145942
31909,536,1801300,2,12,32,26,478,45146478
31910,788,1801500,1,12,32,27,266,45147266
31911,157,1801400,1,12,32,27,423,45147423
31912,103,1801300,1,12,32,27,526,45147526
31913,3146,1801400,1,12,32,30,672,45150672
31914,1249,1801300,5,12,32,31,921,45151921
31915,0,1801300,3,12,32,31,921,45151921
31916,54,1801300,2,12,32,31,975,45151975
31917,3778,1801300,2,12,32,35,753,45155753
31918,451,1801300,1,12,32,36,204,45156204
31919,2499,1801300,1,12,32,38,703,45158703
31920,55,1801200,1,12,32,38,758,45158758
31921,51,1801200,1,12,32,38,809,45158809
31922,294,1801300,2,12,32,39,103,45159103
31924,493,1801300,1,12,32,39,596,45159596
31925,676,1801400,1,12,32,40,272,45160272
31926,980,1801200,1,12,32,41,252,45161252
31927,0,1801200,15,12,32,41,252,45161252
31928,142,1801200,2,12,32,41,394,45161394
31929,147,1801200,1,12,32,41,541,45161541
31930,588,1801300,1,12,32,42,129,45162129
31931,145,1801200,1,12,32,42,274,45162274
31932,28,1801300,2,12,32,42,302,45162302
31933,1587,1801200,1,12,32,43,889,45163889
31934,205,1801200,5,12,32,44,94,45164094
31935,652,1801200,1,12,32,44,746,45164746
31936,1054,1801200,1,12,32,45,800,45165800
31937,1570,1801200,5,12,32,47,370,45167370
31938,1065,1801100,3,12,32,48,435,45168435
31939,80,1801100,6,12,32,48,515,45168515
31940,45,1801200,1,12,32,48,560,45168560
31941,81,1801100,3,12,32,48,641,45168641
31942,23,1801200,2,12,32,48,664,45168664
31943,192,1801100,3,12,32,48,856,45168856
31944,366,1801100,1,12,32,49,222,45169222
31945,0,1801100,2,12,32,49,222,45169222
31946,14,1801100,1,12,32,49,236,45169236
31947,0,1801100,1,12,32,49,236,45169236
31948,1,1801100,1,12,32,49,237,45169237
31949,0,1801100,1,12,32,49,237,45169237
31950,0,1801100,1,12,32,49,237,45169237
31951,1,1801100,2,12,32,49,238,45169238
31952,0,1801100,1,12,32,49,238,45169238
31953,9,1801100,1,12,32,49,247,45169247
31954,1,1801100,1,12,32,49,248,45169248
31955,16,1801100,1,12,32,49,264,45169264
31956,1,1801100,1,12,32,49,265,45169265
31957,4,1801100,1,12,32,49,269,45169269
31958,5,1801100,2,12,32,49,274,45169274
31959,1,1801100,2,12,32,49,275,45169275
31960,6,1801000,1,12,32,49,281,45169281
31961,89,1801000,1,12,32,49,370,45169370
31962,1,1801100,1,12,32,49,371,45169371
31963,8,1801100,1,12,32,49,379,45169379
31964,50,1801200,1,12,32,49,429,45169429
31965,3,1801100,1,12,32,49,432,45169432
31966,6,1801000,1,12,32,49,438,45169438
31967,58,1801000,2,12,32,49,496,45169496
31968,4,1801000,1,12,32,49,500,45169500
31969,4,1801200,1,12,32,49,504,45169504
31970,22,1801000,4,12,32,49,526,45169526
31971,54,1801000,1,12,32,49,580,45169580
31972,166,1801000,1,12,32,49,746,45169746
31973,131,1801000,1,12,32,49,877,45169877
31974,46,1801000,3,12,32,49,923,45169923
31975,73,1801000,1,12,32,49,996,45169996
31976,403,1801100,1,12,32,50,399,45170399
31977,180,1801000,1,12,32,50,579,45170579
31978,51,1801000,2,12,32,50,630,45170630
31979,29,1801000,3,12,32,50,659,45170659
31980,331,1801100,1,12,32,50,990,45170990
31981,375,1801100,1,12,32,51,365,45171365
31982,250,1801100,1,12,32,51,615,45171615
31983,316,1801000,1,12,32,51,931,45171931
31984,241,1801000,3,12,32,52,172,45172172
31985,1144,1801000,1,12,32,53,316,45173316
31986,224,1801000,1,12,32,53,540,45173540
31987,601,1801100,4,12,32,54,141,45174141
31988,169,1801000,3,12,32,54,310,45174310
31989,171,1801000,6,12,32,54,481,45174481
31990,489,1801000,1,12,32,54,970,45174970
31991,971,1801100,1,12,32,55,941,45175941
31992,289,1801000,1,12,32,56,230,45176230
31993,0,1801000,3,12,32,56,230,45176230
31994,0,1801000,1,12,32,56,230,45176230
31995,0,1801000,7,12,32,56,230,45176230
31996,1,1801000,1,12,32,56,231,45176231
31997,0,1801000,1,12,32,56,231,45176231
31998,160,1800900,4,12,32,56,391,45176391
31999,62,1800900,4,12,32,56,453,45176453
32000,21,1800900,1,12,32,56,474,45176474
32001,0,1800900,1,12,32,56,474,45176474
32002,119,1800900,1,12,32,56,593,45176593
32003,10,1800900,1,12,32,56,603,45176603
32004,179,1800900,1,12,32,56,782,45176782
32005,61,1800900,3,12,32,56,843,45176843
32006,18,1800900,1,12,32,56,861,45176861
32007,25,1800900,1,12,32,56,886,45176886
32008,592,1800900,1,12,32,57,478,45177478
32009,35,1800900,1,12,32,57,513,45177513
32010,102,1800900,2,12,32,57,615,45177615
32011,15,1800900,5,12,32,57,630,45177630
32012,0,1800900,1,12,32,57,630,45177630
32013,1,1800900,1,12,32,57,631,45177631
32014,446,1800800,1,12,32,58,77,45178077
32015,0,1800800,6,12,32,58,77,45178077
32016,0,1800800,1,12,32,58,77,45178077
32017,0,1800800,1,12,32,58,77,45178077
32018,0,1800800,8,12,32,58,77,45178077
32019,0,1800800,1,12,32,58,77,45178077
32020,1,1800800,1,12,32,58,78,45178078
32021,23,1800800,25,12,32,58,101,45178101
32022,125,1800800,1,12,32,58,226,45178226
32023,33,1800700,2,12,32,58,259,45178259
32024,44,1800700,1,12,32,58,303,45178303
32025,73,1800700,2,12,32,58,376,45178376
32026,2,1800700,2,12,32,58,378,45178378
32027,4,1800700,2,12,32,58,382,45178382
32028,1,1800700,1,12,32,58,383,45178383
32029,3,1800700,2,12,32,58,386,45178386
32030,22,1800800,1,12,32,58,408,45178408
32031,58,1800700,4,12,32,58,466,45178466
32032,26,1800700,1,12,32,58,492,45178492
32033,11,1800700,1,12,32,58,503,45178503
32034,13,1800700,1,12,32,58,516,45178516
32035,364,1800700,1,12,32,58,880,45178880
32036,315,1800700,1,12,32,59,195,45179195
32037,59,1800700,1,12,32,59,254,45179254
32038,38,1800800,5,12,32,59,292,45179292
32040,350,1800900,3,12,32,59,642,45179642
32041,26,1800800,1,12,32,59,668,45179668
32042,231,1800800,1,12,32,59,899,45179899
32043,297,1800700,2,12,33,0,196,45180196
32044,30,1800700,2,12,33,0,226,45180226
32045,1,1800700,1,12,33,0,227,45180227
32046,118,1800700,2,12,33,0,345,45180345
32047,81,1800700,6,12,33,0,426,45180426
32048,88,1800700,4,12,33,0,514,45180514
32049,16,1800700,2,12,33,0,530,45180530
32050,6,1800700,1,12,33,0,536,45180536
32051,40,1800700,3,12,33,0,576,45180576
32053,36,1800600,6,12,33,0,612,45180612
32054,0,1800600,2,12,33,0,612,45180612
32055,42,1800600,9,12,33,0,654,45180654
32056,2,1800700,2,12,33,0,656,45180656
32057,40,1800700,2,12,33,0,696,45180696
32058,20,1800600,2,12,33,0,716,45180716
32059,25,1800700,1,12,33,0,741,45180741
32060,42,1800700,5,12,33,0,783,45180783
32061,63,1800700,1,12,33,0,846,45180846
32062,147,1800800,1,12,33,0,993,45180993
32063,72,1800700,1,12,33,1,65,45181065
32064,12,1800700,1,12,33,1,77,45181077
32065,80,1800700,1,12,33,1,157,45181157
32067,283,1800600,1,12,33,1,440,45181440
32068,52,1800600,1,12,33,1,492,45181492
32069,64,1800600,1,12,33,1,556,45181556
32070,54,1800600,1,12,33,1,610,45181610
32071,251,1800700,1,12,33,1,861,45181861
32073,9,1800700,1,12,33,1,870,45181870
32074,77,1800600,2,12,33,1,947,45181947
32075,86,1800700,1,12,33,2,33,45182033
32076,138,1800700,1,12,33,2,171,45182171
32077,0,1800700,1,12,33,2,171,45182171
32078,172,1800700,1,12,33,2,343,45182343
32079,708,1800700,1,12,33,3,51,45183051
32080,452,1800600,2,12,33,3,503,45183503
32081,175,1800600,1,12,33,3,678,45183678
32082,255,1800800,2,12,33,3,933,45183933
32083,769,1800900,15,12,33,4,702,45184702
32084,1,1800900,7,12,33,4,703,45184703
32085,0,1800900,1,12,33,4,703,45184703
32086,0,1800900,3,12,33,4,703,45184703
32087,0,1800900,6,12,33,4,703,45184703
32088,88,1800900,1,12,33,4,791,45184791
32089,1,1800900,1,12,33,4,792,45184792
32090,153,1800900,6,12,33,4,945,45184945
32092,258,1800900,1,12,33,5,203,45185203
32093,978,1801000,9,12,33,6,181,45186181
32094,306,1801000,1,12,33,6,487,45186487
32095,10,1801100,3,12,33,6,497,45186497
32096,265,1801000,6,12,33,6,762,45186762
32097,1,1800900,1,12,33,6,763,45186763
32098,589,1800800,1,12,33,7,352,45187352
32099,74,1801000,2,12,33,7,426,45187426
32100,49,1800900,1,12,33,7,475,45187475
32101,1,1800800,1,12,33,7,476,45187476
32102,0,1800800,1,12,33,7,476,45187476
32103,755,1801000,1,12,33,8,231,45188231
32104,597,1801000,1,12,33,8,828,45188828
32105,238,1800800,1,12,33,9,66,45189066
32106,1951,1800800,1,12,33,11,17,45191017
32107,5,1801000,10,12,33,11,22,45191022
32108,6,1800900,2,12,33,11,28,45191028
32109,561,1800800,1,12,33,11,589,45191589
32110,244,1800800,1,12,33,11,833,45191833
32111,499,1800800,1,12,33,12,332,45192332
32112,1029,1800900,1,12,33,13,361,45193361
32113,138,1800900,1,12,33,13,499,45193499
32114,4765,1800800,1,12,33,18,264,45198264
32115,1211,1800900,1,12,33,19,475,45199475
32116,1414,1800800,3,12,33,20,889,45200889
32117,3093,1800800,1,12,33,23,982,45203982
32118,705,1800800,1,12,33,24,687,45204687
32119,2402,1800800,1,12,33,27,89,45207089
32120,18,1800900,1,12,33,27,107,45207107
32121,925,1800800,2,12,33,28,32,45208032
32122,247,1800800,1,12,33,28,279,45208279
32123,462,1800800,3,12,33,28,741,45208741
32124,679,1800800,1,12,33,29,420,45209420
32125,624,1800700,1,12,33,30,44,45210044
32126,317,1800700,1,12,33,30,361,45210361
32127,0,1800700,3,12,33,30,361,45210361
32128,0,1800700,1,12,33,30,361,45210361
32129,0,1800700,4,12,33,30,361,45210361
32130,1,1800700,1,12,33,30,362,45210362
32131,0,1800700,6,12,33,30,362,45210362
32132,0,1800700,1,12,33,30,362,45210362
32133,66,1800700,2,12,33,30,428,45210428
32134,778,1800700,1,12,33,31,206,45211206
32135,1453,1800700,3,12,33,32,659,45212659
32136,361,1800700,2,12,33,33,20,45213020
32137,1,1800700,1,12,33,33,21,45213021
32138,1078,1800800,1,12,33,34,99,45214099
32139,571,1800700,1,12,33,34,670,45214670
32140,922,1800800,5,12,33,35,592,45215592
32141,113,1800800,2,12,33,35,705,45215705
32142,1496,1800800,1,12,33,37,201,45217201
32144,154,1800900,1,12,33,37,355,45217355
32145,1975,1800700,1,12,33,39,330,45219330
32146,1449,1800700,1,12,33,40,779,45220779
32147,279,1800800,1,12,33,41,58,45221058
32148,34,1800700,1,12,33,41,92,45221092
32149,3013,1800700,1,12,33,44,105,45224105
32150,197,1800700,1,12,33,44,302,45224302
32151,1844,1800700,1,12,33,46,146,45226146
32153,182,1800600,2,12,33,46,328,45226328
32154,618,1800600,1,12,33,46,946,45226946
32155,30,1800600,3,12,33,46,976,45226976
32156,248,1800600,1,12,33,47,224,45227224
32157,33,1800600,1,12,33,47,257,45227257
32158,1311,1800700,1,12,33,48,568,45228568
32159,387,1800700,1,12,33,48,955,45228955
32160,774,1800700,4,12,33,49,729,45229729
32162,248,1800600,1,12,33,49,977,45229977
32163,300,1800800,1,12,33,50,277,45230277
32164,11,1800600,1,12,33,50,288,45230288
32165,465,1800600,1,12,33,50,753,45230753
32166,1613,1800600,6,12,33,52,366,45232366
32167,298,1800600,1,12,33,52,664,45232664
32168,340,1800600,4,12,33,53,4,45233004
32169,277,1800600,1,12,33,53,281,45233281
32170,605,1800700,1,12,33,53,886,45233886
32171,0,1800700,1,12,33,53,886,45233886
32172,415,1800600,1,12,33,54,301,45234301
32173,192,1800600,1,12,33,54,493,45234493
32174,1882,1800700,1,12,33,56,375,45236375
32175,69,1800600,4,12,33,56,444,45236444
32176,90,1800600,1,12,33,56,534,45236534
32177,232,1800600,1,12,33,56,766,45236766
32178,1031,1800700,1,12,33,57,797,45237797
32179,1152,1800700,1,12,33,58,949,45238949
32180,178,1800600,3,12,33,59,127,45239127
32181,296,1800500,1,12,33,59,423,45239423
32182,84,1800500,1,12,33,59,507,45239507
32183,25,1800500,1,12,33,59,532,45239532
32184,30,1800500,2,12,33,59,562,45239562
32185,3,1800500,2,12,33,59,565,45239565
32186,4,1800500,1,12,33,59,569,45239569
32187,8,1800500,3,12,33,59,577,45239577
32188,40,1800500,2,12,33,59,617,45239617
32189,77,1800600,1,12,33,59,694,45239694
32190,80,1800500,1,12,33,59,774,45239774
32191,10,1800500,1,12,33,59,784,45239784
32192,18,1800500,1,12,33,59,802,45239802
32193,4,1800500,1,12,33,59,806,45239806
32194,5,1800500,1,12,33,59,811,45239811
32195,36,1800500,1,12,33,59,847,45239847
32196,3,1800500,1,12,33,59,850,45239850
32197,5,1800500,1,12,33,59,855,45239855
32198,1,1800500,1,12,33,59,856,45239856
32199,270,1800500,2,12,34,0,126,45240126
32200,40,1800500,2,12,34,0,166,45240166
32201,23,1800500,2,12,34,0,189,45240189
32202,37,1800500,1,12,34,0,226,45240226
32203,0,1800500,1,12,34,0,226,45240226
32204,0,1800500,3,12,34,0,226,45240226
32205,1,1800500,1,12,34,0,227,45240227
32206,0,1800500,1,12,34,0,227,45240227
32207,0,1800500,1,12,34,0,227,45240227
32208,0,1800500,1,12,34,0,227,45240227
32209,1,1800500,1,12,34,0,228,45240228
32210,229,1800500,1,12,34,0,457,45240457
32211,423,1800500,1,12,34,0,880,45240880
32212,453,1800500,1,12,34,1,333,45241333
32213,18,1800500,1,12,34,1,351,45241351
32214,283,1800500,1,12,34,1,634,45241634
32215,46,1800400,10,12,34,1,680,45241680
32216,1,1800400,5,12,34,1,681,45241681
32217,45,1800400,1,12,34,1,726,45241726
32218,124,1800300,3,12,34,1,850,45241850
32219,6,1800300,1,12,34,1,856,45241856
32220,85,1800300,2,12,34,1,941,45241941
32221,35,1800300,22,12,34,1,976,45241976
32222,7,1800300,3,12,34,1,983,45241983
32223,89,1800300,1,12,34,2,72,45242072
32224,80,1800300,1,12,34,2,152,45242152
32225,3,1800300,1,12,34,2,155,45242155
32226,9,1800300,1,12,34,2,164,45242164
32227,139,1800300,1,12,34,2,303,45242303
32228,46,1800300,1,12,34,2,349,45242349
32229,4,1800400,1,12,34,2,353,45242353
32230,116,1800400,1,12,34,2,469,45242469
32232,48,1800300,1,12,34,2,517,45242517
32233,17,1800400,1,12,34,2,534,45242534
32234,133,1800300,3,12,34,2,667,45242667
32235,19,1800300,1,12,34,2,686,45242686
32236,137,1800300,1,12,34,2,823,45242823
32237,473,1800500,1,12,34,3,296,45243296
32238,0,1800600,2,12,34,3,296,45243296
32239,36,1800400,2,12,34,3,332,45243332
32240,147,1800400,1,12,34,3,479,45243479
32241,450,1800400,1,12,34,3,929,45243929
32242,143,1800400,1,12,34,4,72,45244072
32243,28,1800500,1,12,34,4,100,45244100
32244,1,1800600,1,12,34,4,101,45244101
32245,1226,1800500,1,12,34,5,327,45245327
32246,1844,1800400,1,12,34,7,171,45247171
32247,242,1800400,1,12,34,7,413,45247413
32248,1248,1800500,1,12,34,8,661,45248661
32249,64,1800400,1,12,34,8,725,45248725
32250,0,1800400,1,12,34,8,725,45248725
32251,0,1800400,1,12,34,8,725,45248725
32252,0,1800400,1,12,34,8,725,45248725
32253,0,1800400,1,12,34,8,725,45248725
32254,0,1800300,1,12,34,8,725,45248725
32255,0,1800300,1,12,34,8,725,45248725
32256,1,1800300,1,12,34,8,726,45248726
32257,760,1800500,1,12,34,9,486,45249486
32258,299,1800300,1,12,34,9,785,45249785
32259,144,1800300,2,12,34,9,929,45249929
32260,400,1800300,2,12,34,10,329,45250329
32261,180,1800300,1,12,34,10,509,45250509
32262,18,1800400,1,12,34,10,527,45250527
32263,1255,1800400,1,12,34,11,782,45251782
32264,1103,1800400,1,12,34,12,885,45252885
32265,223,1800300,1,12,34,13,108,45253108
32266,895,1800400,1,12,34,14,3,45254003
32267,0,1800400,1,12,34,14,3,45254003
32268,617,1800300,8,12,34,14,620,45254620
32269,142,1800300,1,12,34,14,762,45254762
32270,0,1800300,1,12,34,14,762,45254762
32271,0,1800400,1,12,34,14,762,45254762
32272,0,1800300,1,12,34,14,762,45254762
32273,1131,1800400,1,12,34,15,893,45255893
32274,331,1800400,1,12,34,16,224,45256224
32275,0,1800400,1,12,34,16,224,45256224
32276,650,1800400,1,12,34,16,874,45256874
32277,214,1800400,2,12,34,17,88,45257088
32278,13,1800300,1,12,34,17,101,45257101
32279,0,1800300,1,12,34,17,101,45257101
32280,0,1800300,1,12,34,17,101,45257101
32281,0,1800300,1,12,34,17,101,45257101
32282,1,1800300,1,12,34,17,102,45257102
32283,0,1800300,1,12,34,17,102,45257102
32284,149,1800400,1,12,34,17,251,45257251
32285,585,1800300,1,12,34,17,836,45257836
32286,4,1800300,3,12,34,17,840,45257840
32287,87,1800400,1,12,34,17,927,45257927
32288,321,1800400,1,12,34,18,248,45258248
32289,164,1800300,1,12,34,18,412,45258412
32290,112,1800300,1,12,34,18,524,45258524
32291,471,1800400,1,12,34,18,995,45258995
32292,415,1800400,1,12,34,19,410,45259410
32293,142,1800400,2,12,34,19,552,45259552
32294,477,1800400,5,12,34,20,29,45260029
32295,334,1800500,3,12,34,20,363,45260363
32296,1,1800500,1,12,34,20,364,45260364
32297,0,1800500,3,12,34,20,364,45260364
32298,0,1800500,1,12,34,20,364,45260364
32299,82,1800500,1,12,34,20,446,45260446
32300,364,1800500,2,12,34,20,810,45260810
32302,419,1800500,1,12,34,21,229,45261229
32303,29,1800500,2,12,34,21,258,45261258
32304,327,1800400,2,12,34,21,585,45261585
32305,53,1800400,2,12,34,21,638,45261638
32306,240,1800500,1,12,34,21,878,45261878
32307,134,1800400,1,12,34,22,12,45262012
32308,931,1800500,1,12,34,22,943,45262943
32309,323,1800400,2,12,34,23,266,45263266
32310,263,1800300,1,12,34,23,529,45263529
32311,405,1800400,1,12,34,23,934,45263934
32312,77,1800400,1,12,34,24,11,45264011
32313,453,1800400,1,12,34,24,464,45264464
32314,296,1800300,1,12,34,24,760,45264760
32315,1089,1800300,4,12,34,25,849,45265849
32316,0,1800300,3,12,34,25,849,45265849
32317,368,1800200,1,12,34,26,217,45266217
32318,13,1800200,2,12,34,26,230,45266230
32319,0,1800200,1,12,34,26,230,45266230
32320,285,1800200,1,12,34,26,515,45266515
32321,1645,1800200,1,12,34,28,160,45268160
32322,39,1800200,1,12,34,28,199,45268199
32323,26,1800200,1,12,34,28,225,45268225
32324,0,1800200,1,12,34,28,225,45268225
32325,830,1800200,2,12,34,29,55,45269055
32326,0,1800200,1,12,34,29,55,45269055
32327,1,1800200,2,12,34,29,56,45269056
32328,0,1800200,31,12,34,29,56,45269056
32329,1,1800100,1,12,34,29,57,45269057
32330,55,1800200,1,12,34,29,112,45269112
32331,749,1800100,1,12,34,29,861,45269861
32332,37,1800100,1,12,34,29,898,45269898
32333,53,1800100,1,12,34,29,951,45269951
32334,541,1800100,1,12,34,30,492,45270492
32335,316,1800100,3,12,34,30,808,45270808
32336,75,1800100,1,12,34,30,883,45270883
32337,75,1800200,1,12,34,30,958,45270958
32338,91,1800200,1,12,34,31,49,45271049
32339,172,1800100,3,12,34,31,221,45271221
32340,113,1800200,1,12,34,31,334,45271334
32341,202,1800100,3,12,34,31,536,45271536
32342,97,1800100,2,12,34,31,633,45271633
32343,234,1800100,2,12,34,31,867,45271867
32344,14,1800100,3,12,34,31,881,45271881
32345,310,1800100,3,12,34,32,191,45272191
32346,202,1800200,1,12,34,32,393,45272393
32347,235,1800200,1,12,34,32,628,45272628
32348,895,1800100,1,12,34,33,523,45273523
32349,8,1800100,4,12,34,33,531,45273531
32350,1,1800100,5,12,34,33,532,45273532
32351,0,1800100,1,12,34,33,532,45273532
32352,0,1800100,7,12,34,33,532,45273532
32353,0,1800100,7,12,34,33,532,45273532
32354,0,1800100,7,12,34,33,532,45273532
32355,0,1800100,8,12,34,33,532,45273532
32356,0,1800100,1,12,34,33,532,45273532
32357,0,1800100,1,12,34,33,532,45273532
32358,1,1800100,1,12,34,33,533,45273533
32359,0,1800100,1,12,34,33,533,45273533
32360,0,1800100,1,12,34,33,533,45273533
32361,312,1800100,4,12,34,33,845,45273845
32362,378,1800100,4,12,34,34,223,45274223
32363,416,1800200,4,12,34,34,639,45274639
32364,398,1800200,1,12,34,35,37,45275037
32365,137,1800100,1,12,34,35,174,45275174
32366,2,1800100,1,12,34,35,176,45275176
32367,20,1800100,1,12,34,35,196,45275196
32368,436,1800100,1,12,34,35,632,45275632
32369,45,1800100,2,12,34,35,677,45275677
32370,103,1800100,2,12,34,35,780,45275780
32371,106,1800200,3,12,34,35,886,45275886
32372,70,1800200,1,12,34,35,956,45275956
32373,1071,1800200,1,12,34,37,27,45277027
32374,365,1800200,1,12,34,37,392,45277392
32375,84,1800100,1,12,34,37,476,45277476
32376,1477,1800200,2,12,34,38,953,45278953
32377,81,1800300,1,12,34,39,34,45279034
32378,279,1800300,1,12,34,39,313,45279313
32379,122,1800300,1,12,34,39,435,45279435
32380,2,1800300,4,12,34,39,437,45279437
32381,176,1800200,1,12,34,39,613,45279613
32382,231,1800400,1,12,34,39,844,45279844
32383,681,1800200,1,12,34,40,525,45280525
32384,686,1800200,1,12,34,41,211,45281211
32385,148,1800300,1,12,34,41,359,45281359
32386,364,1800400,1,12,34,41,723,45281723
32387,694,1800400,5,12,34,42,417,45282417
32388,1,1800400,1,12,34,42,418,45282418
32389,587,1800500,14,12,34,43,5,45283005
32390,345,1800600,1,12,34,43,350,45283350
32391,551,1800600,1,12,34,43,901,45283901
32392,804,1800600,1,12,34,44,705,45284705
32393,85,1800500,1,12,34,44,790,45284790
32394,556,1800600,1,12,34,45,346,45285346
32395,376,1800600,1,12,34,45,722,45285722
32396,16,1800600,3,12,34,45,738,45285738
32397,0,1800600,2,12,34,45,738,45285738
32398,1,1800600,1,12,34,45,739,45285739
32399,0,1800600,7,12,34,45,739,45285739
32400,0,1800600,1,12,34,45,739,45285739
32401,14,1800600,3,12,34,45,753,45285753
32402,1479,1800600,1,12,34,47,232,45287232
32403,292,1800700,1,12,34,47,524,45287524
32404,762,1800700,1,12,34,48,286,45288286
32405,65,1800600,1,12,34,48,351,45288351
32406,1289,1800700,1,12,34,49,640,45289640
32407,84,1800700,6,12,34,49,724,45289724
32408,708,1800800,10,12,34,50,432,45290432
32409,528,1800800,1,12,34,50,960,45290960
32410,1032,1800900,2,12,34,51,992,45291992
32411,119,1800900,1,12,34,52,111,45292111
32412,493,1800800,1,12,34,52,604,45292604
32413,239,1800700,2,12,34,52,843,45292843
32414,43,1800700,1,12,34,52,886,45292886
32415,76,1800800,1,12,34,52,962,45292962
32416,15,1800700,1,12,34,52,977,45292977
32417,1647,1800800,1,12,34,54,624,45294624
32418,70,1800700,1,12,34,54,694,45294694
32419,599,1800800,2,12,34,55,293,45295293
32420,154,1800700,2,12,34,55,447,45295447
32421,617,1800700,1,12,34,56,64,45296064
32422,135,1800700,1,12,34,56,199,45296199
32423,239,1800800,1,12,34,56,438,45296438
32424,467,1800800,1,12,34,56,905,45296905
32425,153,1800800,1,12,34,57,58,45297058
32426,1058,1800800,5,12,34,58,116,45298116
32427,1069,1800900,1,12,34,59,185,45299185
32428,2099,1800800,1,12,35,1,284,45301284
32429,74,1800700,1,12,35,1,358,45301358
32430,0,1800700,1,12,35,1,358,45301358
32431,0,1800700,2,12,35,1,358,45301358
32432,0,1800700,1,12,35,1,358,45301358
32433,0,1800700,1,12,35,1,358,45301358
32434,53,1800800,1,12,35,1,411,45301411
32435,16,1800700,2,12,35,1,427,45301427
32436,10,1800700,2,12,35,1,437,45301437
32437,58,1800700,1,12,35,1,495,45301495
32438,116,1800900,1,12,35,1,611,45301611
32439,21,1800700,2,12,35,1,632,45301632
32440,2,1800700,1,12,35,1,634,45301634
32441,1,1800700,4,12,35,1,635,45301635
32442,8,1800600,2,12,35,1,643,45301643
32443,7,1800600,2,12,35,1,650,45301650
32444,134,1800700,1,12,35,1,784,45301784
32445,17,1800600,1,12,35,1,801,45301801
32446,24,1800600,1,12,35,1,825,45301825
32447,0,1800800,4,12,35,1,825,45301825
32448,275,1800700,1,12,35,2,100,45302100
32450,89,1800600,3,12,35,2,189,45302189
32452,37,1800600,1,12,35,2,226,45302226
32453,84,1800700,1,12,35,2,310,45302310
32454,223,1800600,1,12,35,2,533,45302533
32455,1123,1800600,1,12,35,3,656,45303656
32456,92,1800600,1,12,35,3,748,45303748
32457,0,1800600,1,12,35,3,748,45303748
32458,194,1800700,1,12,35,3,942,45303942
32459,0,1800700,3,12,35,3,942,45303942
32460,42,1800600,1,12,35,3,984,45303984
32461,1260,1800600,2,12,35,5,244,45305244
32462,633,1800600,1,12,35,5,877,45305877
32463,464,1800600,1,12,35,6,341,45306341
32464,170,1800500,1,12,35,6,511,45306511
32465,152,1800600,1,12,35,6,663,45306663
32466,93,1800600,2,12,35,6,756,45306756
32467,542,1800600,2,12,35,7,298,45307298
32468,1,1800600,2,12,35,7,299,45307299
32469,0,1800700,1,12,35,7,299,45307299
32470,5,1800600,1,12,35,7,304,45307304
32472,46,1800500,1,12,35,7,350,45307350
32473,1,1800500,1,12,35,7,351,45307351
32474,133,1800500,1,12,35,7,484,45307484
32475,1750,1800700,2,12,35,9,234,45309234
32476,95,1800600,1,12,35,9,329,45309329
32477,1571,1800800,1,12,35,10,900,45310900
32478,1089,1800700,1,12,35,11,989,45311989
32479,0,1800700,1,12,35,11,989,45311989
32480,0,1800700,3,12,35,11,989,45311989
32481,1,1800600,3,12,35,11,990,45311990
32482,0,1800600,1,12,35,11,990,45311990
32483,1,1800600,2,12,35,11,991,45311991
32484,10,1800500,4,12,35,12,1,45312001
32485,288,1800500,1,12,35,12,289,45312289
32486,480,1800500,1,12,35,12,769,45312769
32487,1881,1800400,4,12,35,14,650,45314650
32488,1,1800400,1,12,35,14,651,45314651
32489,1242,1800300,1,12,35,15,893,45315893
32490,8,1800300,4,12,35,15,901,45315901
32491,86,1800300,1,12,35,15,987,45315987
32492,372,1800400,1,12,35,16,359,45316359
32493,1964,1800400,1,12,35,18,323,45318323
32494,27,1800300,1,12,35,18,350,45318350
32495,0,1800300,1,12,35,18,350,45318350
32496,1,1800300,1,12,35,18,351,45318351
32497,1039,1800500,1,12,35,19,390,45319390
32498,1476,1800400,1,12,35,20,866,45320866
32499,366,1800300,1,12,35,21,232,45321232
32500,0,1800300,1,12,35,21,232,45321232
32501,1307,1800200,4,12,35,22,539,45322539
32502,0,1800200,2,12,35,22,539,45322539
32503,0,1800100,3,12,35,22,539,45322539
32504,1,1800100,1,12,35,22,540,45322540
32505,1,1800100,1,12,35,22,541,45322541
32506,0,1800100,2,12,35,22,541,45322541
32507,0,1800100,5,12,35,22,541,45322541
32508,162,1800100,1,12,35,22,703,45322703
32509,29,1800200,1,12,35,22,732,45322732
32510,24,1800000,1,12,35,22,756,45322756
32511,139,1800100,1,12,35,22,895,45322895
32513,7,1800000,4,12,35,22,902,45322902
32514,39,1800000,1,12,35,22,941,45322941
32515,2,1800000,2,12,35,22,943,45322943
32516,23,1800000,2,12,35,22,966,45322966
32517,5,1800000,2,12,35,22,971,45322971
32518,25,1800000,2,12,35,22,996,45322996
32519,7,1800200,4,12,35,23,3,45323003
32520,85,1800000,5,12,35,23,88,45323088
32521,107,1800000,1,12,35,23,195,45323195
32522,128,1800200,1,12,35,23,323,45323323
32523,377,1800100,1,12,35,23,700,45323700
32524,999,1800100,4,12,35,24,699,45324699
32525,1,1800100,6,12,35,24,700,45324700
32526,81,1800200,1,12,35,24,781,45324781
32527,93,1800200,1,12,35,24,874,45324874
32528,201,1800100,6,12,35,25,75,45325075
32529,0,1800100,4,12,35,25,75,45325075
32530,351,1800100,6,12,35,25,426,45325426
32531,1,1800100,4,12,35,25,427,45325427
32532,0,1800200,1,12,35,25,427,45325427
32533,70,1800100,1,12,35,25,497,45325497
32534,573,1800200,2,12,35,26,70,45326070
32535,435,1800100,1,12,35,26,505,45326505
32536,20,1800300,1,12,35,26,525,45326525
32537,202,1800100,1,12,35,26,727,45326727
32538,479,1800100,1,12,35,27,206,45327206
32539,336,1800200,1,12,35,27,542,45327542
32540,1,1800200,1,12,35,27,543,45327543
32541,458,1800100,1,12,35,28,1,45328001
32542,0,1800100,3,12,35,28,1,45328001
32543,875,1800000,8,12,35,28,876,45328876
32544,0,1800000,14,12,35,28,876,45328876
32545,1,1800000,3,12,35,28,877,45328877
32546,0,1800000,6,12,35,28,877,45328877
32547,0,1800000,7,12,35,28,877,45328877
32548,0,1800000,8,12,35,28,877,45328877
32549,0,1800000,24,12,35,28,877,45328877
32550,2,1799900,1,12,35,28,879,45328879
32551,108,1799900,1,12,35,28,987,45328987
32552,51,1800000,1,12,35,29,38,45329038
32553,15,1799900,10,12,35,29,53,45329053
32554,1,1799900,2,12,35,29,54,45329054
32555,0,1799900,1,12,35,29,54,45329054
32556,0,1799900,4,12,35,29,54,45329054
32557,0,1799900,11,12,35,29,54,45329054
32558,70,1799800,1,12,35,29,124,45329124
32559,38,1799800,15,12,35,29,162,45329162
32561,74,1799700,1,12,35,29,236,45329236
32562,2,1799700,1,12,35,29,238,45329238
32563,32,1799700,3,12,35,29,270,45329270
32564,7,1799700,15,12,35,29,277,45329277
32565,15,1799700,1,12,35,29,292,45329292
32566,26,1799700,1,12,35,29,318,45329318
32567,42,1799700,1,12,35,29,360,45329360
32568,36,1799800,1,12,35,29,396,45329396
32569,76,1799800,1,12,35,29,472,45329472
32570,2,1799700,2,12,35,29,474,45329474
32571,9,1799700,1,12,35,29,483,45329483
32572,46,1799700,1,12,35,29,529,45329529
32573,19,1799700,1,12,35,29,548,45329548
32574,72,1799800,1,12,35,29,620,45329620
32575,57,1799700,2,12,35,29,677,45329677
32576,9,1799700,1,12,35,29,686,45329686
32577,160,1799600,8,12,35,29,846,45329846
32578,152,1799600,1,12,35,29,998,45329998
32579,13,1799800,1,12,35,30,11,45330011
32580,124,1799600,4,12,35,30,135,45330135
32581,52,1799600,8,12,35,30,187,45330187
32582,58,1799600,1,12,35,30,245,45330245
32584,110,1799500,1,12,35,30,355,45330355
32585,4,1799500,1,12,35,30,359,45330359
32586,19,1799500,1,12,35,30,378,45330378
32587,30,1799500,1,12,35,30,408,45330408
32588,14,1799500,3,12,35,30,422,45330422
32589,1,1799500,1,12,35,30,423,45330423
32590,5,1799500,2,12,35,30,428,45330428
32591,14,1799500,8,12,35,30,442,45330442
32592,1,1799600,1,12,35,30,443,45330443
32593,36,1799500,1,12,35,30,479,45330479
32594,12,1799400,1,12,35,30,491,45330491
32595,53,1799500,1,12,35,30,544,45330544
32596,59,1799500,1,12,35,30,603,45330603
32597,39,1799500,2,12,35,30,642,45330642
32598,10,1799500,1,12,35,30,652,45330652
32599,13,1799400,3,12,35,30,665,45330665
32600,47,1799400,1,12,35,30,712,45330712
32601,4,1799400,1,12,35,30,716,45330716
32602,69,1799400,2,12,35,30,785,45330785
32603,23,1799500,2,12,35,30,808,45330808
32605,18,1799400,1,12,35,30,826,45330826
32606,18,1799400,1,12,35,30,844,45330844
32607,2,1799400,1,12,35,30,846,45330846
32608,6,1799600,1,12,35,30,852,45330852
32609,89,1799500,1,12,35,30,941,45330941
32610,51,1799600,1,12,35,30,992,45330992
32612,163,1799500,1,12,35,31,155,45331155
32613,119,1799500,1,12,35,31,274,45331274
32614,183,1799400,1,12,35,31,457,45331457
32615,41,1799400,1,12,35,31,498,45331498
32616,200,1799500,2,12,35,31,698,45331698
32617,38,1799500,2,12,35,31,736,45331736
32618,175,1799600,2,12,35,31,911,45331911
32620,23,1799700,1,12,35,31,934,45331934
32621,56,1799600,1,12,35,31,990,45331990
32622,199,1799500,8,12,35,32,189,45332189
32623,429,1799500,5,12,35,32,618,45332618
32624,62,1799500,2,12,35,32,680,45332680
32625,34,1799500,1,12,35,32,714,45332714
32626,323,1799600,1,12,35,33,37,45333037
32627,207,1799500,1,12,35,33,244,45333244
32628,29,1799500,1,12,35,33,273,45333273
32629,19,1799700,3,12,35,33,292,45333292
32630,31,1799700,1,12,35,33,323,45333323
32631,6,1799600,1,12,35,33,329,45333329
32632,684,1799700,1,12,35,34,13,45334013
32634,695,1799800,3,12,35,34,708,45334708
32636,348,1799700,2,12,35,35,56,45335056
32637,42,1799700,1,12,35,35,98,45335098
32638,98,1799700,1,12,35,35,196,45335196
32639,719,1799800,2,12,35,35,915,45335915
32641,29,1799700,1,12,35,35,944,45335944
32642,579,1799700,1,12,35,36,523,45336523
32643,69,1799700,1,12,35,36,592,45336592
32644,1000,1799700,1,12,35,37,592,45337592
32645,449,1799800,3,12,35,38,41,45338041
32646,550,1799600,3,12,35,38,591,45338591
32647,730,1799800,1,12,35,39,321,45339321
32648,361,1799700,1,12,35,39,682,45339682
32649,4,1799700,1,12,35,39,686,45339686
32650,441,1799800,2,12,35,40,127,45340127
32651,310,1799700,2,12,35,40,437,45340437
32653,797,1799600,1,12,35,41,234,45341234
32654,160,1799800,1,12,35,41,394,45341394
32655,635,1799600,1,12,35,42,29,45342029
32656,293,1799600,2,12,35,42,322,45342322
32657,301,1799600,6,12,35,42,623,45342623
32658,447,1799600,1,12,35,43,70,45343070
32659,416,1799700,1,12,35,43,486,45343486
32660,766,1799700,1,12,35,44,252,45344252
32661,310,1799700,1,12,35,44,562,45344562
32662,911,1799600,5,12,35,45,473,45345473
32663,94,1799700,1,12,35,45,567,45345567
32664,174,1799600,1,12,35,45,741,45345741
32665,499,1799600,10,12,35,46,240,45346240
32666,559,1799600,1,12,35,46,799,45346799
32667,447,1799700,4,12,35,47,246,45347246
32668,101,1799600,1,12,35,47,347,45347347
32669,584,1799600,1,12,35,47,931,45347931
32670,155,1799700,1,12,35,48,86,45348086
32671,7,1799600,4,12,35,48,93,45348093
32673,373,1799700,1,12,35,48,466,45348466
32674,90,1799700,1,12,35,48,556,45348556
32675,317,1799500,1,12,35,48,873,45348873
32676,8,1799700,1,12,35,48,881,45348881
32677,53,1799700,1,12,35,48,934,45348934
32678,96,1799500,1,12,35,49,30,45349030
32679,662,1799600,1,12,35,49,692,45349692
32680,536,1799700,1,12,35,50,228,45350228
32681,54,1799600,1,12,35,50,282,45350282
32683,731,1799500,1,12,35,51,13,45351013
32684,234,1799700,1,12,35,51,247,45351247
32685,530,1799500,1,12,35,51,777,45351777
32686,425,1799500,4,12,35,52,202,45352202
32687,538,1799500,1,12,35,52,740,45352740
32688,260,1799600,1,12,35,53,0,45353000
32689,53,1799500,1,12,35,53,53,45353053
32690,204,1799600,1,12,35,53,257,45353257
32691,229,1799500,4,12,35,53,486,45353486
32692,826,1799500,4,12,35,54,312,45354312
32693,11,1799500,1,12,35,54,323,45354323
32694,8,1799500,1,12,35,54,331,45354331
32695,12,1799500,2,12,35,54,343,45354343
32696,294,1799500,2,12,35,54,637,45354637
32697,627,1799500,2,12,35,55,264,45355264
32698,282,1799400,1,12,35,55,546,45355546
32699,275,1799400,1,12,35,55,821,45355821
32700,862,1799500,10,12,35,56,683,45356683
32701,835,1799400,4,12,35,57,518,45357518
32702,281,1799500,1,12,35,57,799,45357799
32703,1850,1799400,1,12,35,59,649,45359649
32704,52,1799400,1,12,35,59,701,45359701
32705,74,1799400,2,12,35,59,775,45359775
32706,2,1799400,2,12,35,59,777,45359777
32707,2,1799300,2,12,35,59,779,45359779
32708,6,1799300,7,12,35,59,785,45359785
32709,1,1799300,6,12,35,59,786,45359786
32711,91,1799200,2,12,35,59,877,45359877
32712,42,1799200,3,12,35,59,919,45359919
32713,50,1799200,1,12,35,59,969,45359969
32714,9,1799200,3,12,35,59,978,45359978
32715,19,1799200,1,12,35,59,997,45359997
32716,28,1799200,2,12,36,0,25,45360025
32717,14,1799200,2,12,36,0,39,45360039
32718,0,1799200,2,12,36,0,39,45360039
32719,3,1799200,2,12,36,0,42,45360042
32720,60,1799300,1,12,36,0,102,45360102
32721,1,1799300,1,12,36,0,103,45360103
32723,0,1799200,6,12,36,0,103,45360103
32725,0,1799100,1,12,36,0,103,45360103
32726,0,1799100,6,12,36,0,103,45360103
32727,0,1799100,2,12,36,0,103,45360103
32728,1,1799100,3,12,36,0,104,45360104
32729,0,1799100,4,12,36,0,104,45360104
32730,1,1799100,1,12,36,0,105,45360105
32731,1,1799100,2,12,36,0,106,45360106
32732,12,1799100,2,12,36,0,118,45360118
32734,41,1799000,2,12,36,0,159,45360159
32735,48,1799100,1,12,36,0,207,45360207
32736,17,1799100,2,12,36,0,224,45360224
32737,0,1799100,2,12,36,0,224,45360224
32739,15,1799000,1,12,36,0,239,45360239
32740,1,1799000,2,12,36,0,240,45360240
32741,0,1799000,3,12,36,0,240,45360240
32742,3,1799000,1,12,36,0,243,45360243
32743,7,1799100,1,12,36,0,250,45360250
32745,25,1799000,4,12,36,0,275,45360275
32746,25,1799000,3,12,36,0,300,45360300
32747,4,1799000,2,12,36,0,304,45360304
32748,1,1799100,1,12,36,0,305,45360305
32749,9,1799000,1,12,36,0,314,45360314
32750,34,1799000,3,12,36,0,348,45360348
32751,1,1799000,1,12,36,0,349,45360349
32752,26,1799100,1,12,36,0,375,45360375
32753,23,1799100,1,12,36,0,398,45360398
32754,7,1799100,1,12,36,0,405,45360405
32755,4,1799100,1,12,36,0,409,45360409
32756,18,1799100,1,12,36,0,427,45360427
32757,24,1799000,1,12,36,0,451,45360451
32758,13,1799200,1,12,36,0,464,45360464
32759,14,1799100,1,12,36,0,478,45360478
32760,6,1799100,1,12,36,0,484,45360484
32761,0,1799000,1,12,36,0,484,45360484
32762,6,1799000,1,12,36,0,490,45360490
32763,7,1799200,1,12,36,0,497,45360497
32764,29,1799200,1,12,36,0,526,45360526
32765,15,1799100,1,12,36,0,541,45360541
32766,69,1799100,1,12,36,0,610,45360610
32767,7,1799200,4,12,36,0,617,45360617
32768,32,1799300,1,12,36,0,649,45360649
32769,1,1799300,1,12,36,0,650,45360650
32770,57,1799400,1,12,36,0,707,45360707
32771,48,1799200,1,12,36,0,755,45360755
32772,97,1799200,4,12,36,0,852,45360852
32773,8,1799200,1,12,36,0,860,45360860
32774,36,1799200,2,12,36,0,896,45360896
32775,6,1799200,3,12,36,0,902,45360902
32776,20,1799200,1,12,36,0,922,45360922
32777,23,1799200,1,12,36,0,945,45360945
32778,112,1799100,1,12,36,1,57,45361057
32779,1,1799100,3,12,36,1,58,45361058
32780,1,1799100,1,12,36,1,59,45361059
32781,0,1799100,1,12,36,1,59,45361059
32782,0,1799200,1,12,36,1,59,45361059
32783,7,1799100,1,12,36,1,66,45361066
32784,6,1799100,1,12,36,1,72,45361072
32785,2,1799000,3,12,36,1,74,45361074
32786,20,1799100,1,12,36,1,94,45361094
32787,7,1799100,1,12,36,1,101,45361101
32788,0,1799100,1,12,36,1,101,45361101
32789,0,1799000,1,12,36,1,101,45361101
32790,0,1799000,1,12,36,1,101,45361101
32791,0,1799000,1,12,36,1,101,45361101
32792,0,1799000,1,12,36,1,101,45361101
32793,1,1799000,1,12,36,1,102,45361102
32794,0,1799000,1,12,36,1,102,45361102
32795,1,1799000,1,12,36,1,103,45361103
32796,89,1799200,1,12,36,1,192,45361192
32797,72,1799100,1,12,36,1,264,45361264
32799,66,1799200,1,12,36,1,330,45361330
32800,42,1799200,1,12,36,1,372,45361372
32801,13,1799100,4,12,36,1,385,45361385
32802,12,1799100,3,12,36,1,397,45361397
32803,38,1799000,1,12,36,1,435,45361435
32804,38,1799000,1,12,36,1,473,45361473
32805,8,1799200,1,12,36,1,481,45361481
32806,4,1799200,1,12,36,1,485,45361485
32807,13,1799100,1,12,36,1,498,45361498
32808,8,1799000,1,12,36,1,506,45361506
32809,10,1799000,1,12,36,1,516,45361516
32810,289,1799100,2,12,36,1,805,45361805
32811,15,1799100,2,12,36,1,820,45361820
32812,126,1799000,5,12,36,1,946,45361946
32813,88,1799000,1,12,36,2,34,45362034
32814,484,1799100,1,12,36,2,518,45362518
32815,758,1799000,1,12,36,3,276,45363276
32816,133,1799100,2,12,36,3,409,45363409
32817,96,1799100,1,12,36,3,505,45363505
32818,0,1799100,1,12,36,3,505,45363505
32820,21,1798900,2,12,36,3,526,45363526
32821,49,1798900,1,12,36,3,575,45363575
32822,94,1798900,3,12,36,3,669,45363669
32823,58,1798900,2,12,36,3,727,45363727
32824,10,1798800,2,12,36,3,737,45363737
32825,141,1798900,1,12,36,3,878,45363878
32826,37,1798800,3,12,36,3,915,45363915
32827,29,1798800,2,12,36,3,944,45363944
32828,24,1798800,2,12,36,3,968,45363968
32829,0,1798800,5,12,36,3,968,45363968
32830,17,1798800,1,12,36,3,985,45363985
32831,35,1798800,7,12,36,4,20,45364020
32832,1,1798800,14,12,36,4,21,45364021
32833,0,1798800,11,12,36,4,21,45364021
32834,149,1798800,1,12,36,4,170,45364170
32835,277,1798800,1,12,36,4,447,45364447
32836,377,1798800,4,12,36,4,824,45364824
32837,192,1798800,1,12,36,5,16,45365016
32838,9,1799000,1,12,36,5,25,45365025
32839,473,1798900,2,12,36,5,498,45365498
32840,6,1798800,4,12,36,5,504,45365504
32841,469,1798800,1,12,36,5,973,45365973
32842,1,1798800,1,12,36,5,974,45365974
32843,15,1798700,10,12,36,5,989,45365989
32845,139,1798600,1,12,36,6,128,45366128
32846,34,1798600,2,12,36,6,162,45366162
32847,1,1798600,2,12,36,6,163,45366163
32848,0,1798600,2,12,36,6,163,45366163
32849,2,1798600,3,12,36,6,165,45366165
32850,11,1798700,1,12,36,6,176,45366176
32851,58,1798600,3,12,36,6,234,45366234
32852,6,1798500,1,12,36,6,240,45366240
32853,12,1798500,4,12,36,6,252,45366252
32854,1,1798500,1,12,36,6,253,45366253
32855,53,1798500,1,12,36,6,306,45366306
32856,7,1798500,3,12,36,6,313,45366313
32857,11,1798500,1,12,36,6,324,45366324
32858,48,1798500,1,12,36,6,372,45366372
32859,11,1798500,1,12,36,6,383,45366383
32860,39,1798600,2,12,36,6,422,45366422
32862,32,1798500,1,12,36,6,454,45366454
32863,18,1798500,1,12,36,6,472,45366472
32864,162,1798500,1,12,36,6,634,45366634
32865,25,1798600,1,12,36,6,659,45366659
32866,7,1798600,3,12,36,6,666,45366666
32867,0,1798600,3,12,36,6,666,45366666
32869,36,1798600,3,12,36,6,702,45366702
32870,1,1798600,1,12,36,6,703,45366703
32871,1,1798700,1,12,36,6,704,45366704
32872,20,1798600,1,12,36,6,724,45366724
32873,14,1798500,1,12,36,6,738,45366738
32874,27,1798500,1,12,36,6,765,45366765
32875,21,1798500,1,12,36,6,786,45366786
32876,6,1798500,1,12,36,6,792,45366792
32877,78,1798500,3,12,36,6,870,45366870
32878,10,1798500,2,12,36,6,880,45366880
32879,80,1798500,1,12,36,6,960,45366960
32880,1,1798500,1,12,36,6,961,45366961
32881,1,1798500,1,12,36,6,962,45366962
32882,0,1798500,1,12,36,6,962,45366962
32883,0,1798500,1,12,36,6,962,45366962
32884,0,1798500,1,12,36,6,962,45366962
32885,34,1798600,1,12,36,6,996,45366996
32886,4,1798700,2,12,36,7,0,45367000
32887,5,1798600,1,12,36,7,5,45367005
32888,0,1798600,1,12,36,7,5,45367005
32889,0,1798600,1,12,36,7,5,45367005
32890,0,1798600,1,12,36,7,5,45367005
32891,95,1798600,1,12,36,7,100,45367100
32892,0,1798600,1,12,36,7,100,45367100
32893,0,1798600,1,12,36,7,100,45367100
32894,0,1798600,1,12,36,7,100,45367100
32895,0,1798600,1,12,36,7,100,45367100
32896,1,1798500,1,12,36,7,101,45367101
32897,0,1798500,1,12,36,7,101,45367101
32898,0,1798500,1,12,36,7,101,45367101
32899,0,1798500,1,12,36,7,101,45367101
32900,0,1798500,1,12,36,7,101,45367101
32901,0,1798500,1,12,36,7,101,45367101
32902,1,1798600,1,12,36,7,102,45367102
32903,10,1798700,1,12,36,7,112,45367112
32904,328,1798700,5,12,36,7,440,45367440
32905,1,1798700,1,12,36,7,441,45367441
32906,0,1798700,5,12,36,7,441,45367441
32907,0,1798800,1,12,36,7,441,45367441
32908,16,1798800,1,12,36,7,457,45367457
32909,205,1798700,1,12,36,7,662,45367662
32910,237,1798700,1,12,36,7,899,45367899
32911,206,1798700,2,12,36,8,105,45368105
32912,581,1798700,1,12,36,8,686,45368686
32913,143,1798800,2,12,36,8,829,45368829
32915,175,1798900,5,12,36,9,4,45369004
32916,88,1798800,1,12,36,9,92,45369092
32917,25,1798900,1,12,36,9,117,45369117
32918,74,1798800,1,12,36,9,191,45369191
32919,2,1798800,1,12,36,9,193,45369193
32920,123,1798700,1,12,36,9,316,45369316
32921,176,1798800,1,12,36,9,492,45369492
32922,60,1798800,5,12,36,9,552,45369552
32923,1,1798800,2,12,36,9,553,45369553
32924,306,1798900,1,12,36,9,859,45369859
32925,195,1798700,1,12,36,10,54,45370054
32926,160,1798900,2,12,36,10,214,45370214
32927,417,1799000,2,12,36,10,631,45370631
32928,685,1798800,1,12,36,11,316,45371316
32929,1050,1798900,1,12,36,12,366,45372366
32931,247,1798900,1,12,36,12,613,45372613
32932,123,1799000,1,12,36,12,736,45372736
32933,57,1799000,1,12,36,12,793,45372793
32934,91,1799000,3,12,36,12,884,45372884
32935,0,1799000,12,12,36,12,884,45372884
32936,1,1799100,2,12,36,12,885,45372885
32937,112,1799100,1,12,36,12,997,45372997
32938,250,1798900,5,12,36,13,247,45373247
32939,5,1798900,2,12,36,13,252,45373252
32940,133,1799000,1,12,36,13,385,45373385
32941,226,1799000,1,12,36,13,611,45373611
32942,413,1798900,3,12,36,14,24,45374024
32943,430,1798900,2,12,36,14,454,45374454
32944,218,1799000,1,12,36,14,672,45374672
32945,7,1799100,2,12,36,14,679,45374679
32946,34,1799000,1,12,36,14,713,45374713
32947,955,1799000,1,12,36,15,668,45375668
32948,37,1799100,1,12,36,15,705,45375705
32949,955,1799000,4,12,36,16,660,45376660
32950,56,1798900,2,12,36,16,716,45376716
32951,155,1799000,1,12,36,16,871,45376871
32952,764,1798900,4,12,36,17,635,45377635
32953,1,1798900,5,12,36,17,636,45377636
32954,0,1798900,1,12,36,17,636,45377636
32955,51,1798900,1,12,36,17,687,45377687
32957,38,1798800,1,12,36,17,725,45377725
32958,1,1798800,1,12,36,17,726,45377726
32959,0,1798800,1,12,36,17,726,45377726
32960,0,1798800,1,12,36,17,726,45377726
32961,0,1798800,1,12,36,17,726,45377726
32962,0,1798800,1,12,36,17,726,45377726
32963,0,1798800,1,12,36,17,726,45377726
32964,0,1798800,1,12,36,17,726,45377726
32965,0,1798800,1,12,36,17,726,45377726
32966,1,1798800,1,12,36,17,727,45377727
32967,0,1798800,1,12,36,17,727,45377727
32968,2,1798800,1,12,36,17,729,45377729
32969,0,1798800,1,12,36,17,729,45377729
32970,78,1798900,1,12,36,17,807,45377807
32971,270,1798800,1,12,36,18,77,45378077
32972,1,1799000,1,12,36,18,78,45378078
32973,752,1799000,1,12,36,18,830,45378830
32974,469,1798900,1,12,36,19,299,45379299
32975,1276,1798900,1,12,36,20,575,45380575
32976,388,1798800,1,12,36,20,963,45380963
32977,521,1798900,2,12,36,21,484,45381484
32978,357,1798800,2,12,36,21,841,45381841
32979,49,1798800,1,12,36,21,890,45381890
32980,1,1798800,2,12,36,21,891,45381891
32981,43,1798700,4,12,36,21,934,45381934
32982,1,1798700,2,12,36,21,935,45381935
32983,0,1798700,1,12,36,21,935,45381935
32984,0,1798700,1,12,36,21,935,45381935
32985,0,1798700,2,12,36,21,935,45381935
32986,0,1798700,5,12,36,21,935,45381935
32987,34,1798600,2,12,36,21,969,45381969
32988,1,1798600,1,12,36,21,970,45381970
32989,86,1798700,1,12,36,22,56,45382056
32990,431,1798500,2,12,36,22,487,45382487
32991,79,1798600,1,12,36,22,566,45382566
32992,338,1798500,9,12,36,22,904,45382904
32993,2,1798500,1,12,36,22,906,45382906
32994,787,1798500,1,12,36,23,693,45383693
32995,501,1798600,3,12,36,24,194,45384194
32997,2,1798800,1,12,36,24,196,45384196
32998,0,1798800,6,12,36,24,196,45384196
32999,0,1798800,2,12,36,24,196,45384196
33000,0,1798800,6,12,36,24,196,45384196
33001,3,1798900,3,12,36,24,199,45384199
33002,37,1799000,2,12,36,24,236,45384236
33003,0,1799000,1,12,36,24,236,45384236
33004,0,1799000,1,12,36,24,236,45384236
33005,0,1799000,2,12,36,24,236,45384236
33006,0,1799000,3,12,36,24,236,45384236
33007,1,1799000,2,12,36,24,237,45384237
33008,0,1799000,1,12,36,24,237,45384237
33009,31,1799000,1,12,36,24,268,45384268
33010,55,1799100,3,12,36,24,323,45384323
33011,225,1799000,2,12,36,24,548,45384548
33013,385,1798900,1,12,36,24,933,45384933
33014,1236,1798900,5,12,36,26,169,45386169
33015,1,1798900,1,12,36,26,170,45386170
33016,821,1798900,2,12,36,26,991,45386991
33017,144,1799000,1,12,36,27,135,45387135
33018,90,1798900,1,12,36,27,225,45387225
33019,0,1798900,1,12,36,27,225,45387225
33020,0,1798900,1,12,36,27,225,45387225
33021,1,1798900,1,12,36,27,226,45387226
33022,0,1798900,1,12,36,27,226,45387226
33023,0,1798900,1,12,36,27,226,45387226
33024,0,1798900,1,12,36,27,226,45387226
33025,55,1799000,1,12,36,27,281,45387281
33026,383,1799000,3,12,36,27,664,45387664
33027,194,1799000,1,12,36,27,858,45387858
33028,79,1799000,1,12,36,27,937,45387937
33029,302,1799000,1,12,36,28,239,45388239
33030,27,1799000,3,12,36,28,266,45388266
33031,114,1799000,2,12,36,28,380,45388380
33032,65,1798900,2,12,36,28,445,45388445
33033,216,1799100,1,12,36,28,661,45388661
33034,477,1799000,1,12,36,29,138,45389138
33035,1086,1799000,4,12,36,30,224,45390224
33037,261,1799000,1,12,36,30,485,45390485
33038,415,1799000,3,12,36,30,900,45390900
33039,435,1799100,2,12,36,31,335,45391335
33040,122,1799100,1,12,36,31,457,45391457
33041,182,1799000,1,12,36,31,639,45391639
33042,186,1799000,5,12,36,31,825,45391825
33043,101,1799100,1,12,36,31,926,45391926
33044,559,1799100,1,12,36,32,485,45392485
33045,2,1799100,2,12,36,32,487,45392487
33046,141,1799200,1,12,36,32,628,45392628
33047,185,1799100,2,12,36,32,813,45392813
33048,4,1799200,1,12,36,32,817,45392817
33049,64,1799200,2,12,36,32,881,45392881
33050,356,1799200,1,12,36,33,237,45393237
33051,468,1799200,1,12,36,33,705,45393705
33052,495,1799200,4,12,36,34,200,45394200
33053,0,1799200,1,12,36,34,200,45394200
33054,1,1799200,1,12,36,34,201,45394201
33055,134,1799100,2,12,36,34,335,45394335
33056,11,1799200,1,12,36,34,346,45394346
33057,190,1799200,1,12,36,34,536,45394536
33058,1179,1799200,3,12,36,35,715,45395715
33059,349,1799300,1,12,36,36,64,45396064
33060,269,1799200,1,12,36,36,333,45396333
33061,507,1799100,2,12,36,36,840,45396840
33062,300,1799100,1,12,36,37,140,45397140
33063,85,1799000,1,12,36,37,225,45397225
33064,0,1799000,1,12,36,37,225,45397225
33065,0,1799000,1,12,36,37,225,45397225
33066,0,1799000,1,12,36,37,225,45397225
33067,0,1799000,1,12,36,37,225,45397225
33068,0,1799000,1,12,36,37,225,45397225
33069,0,1799000,1,12,36,37,225,45397225
33070,0,1799000,1,12,36,37,225,45397225
33071,0,1799000,1,12,36,37,225,45397225
33072,0,1799000,1,12,36,37,225,45397225
33073,1,1799000,1,12,36,37,226,45397226
33074,1,1799000,1,12,36,37,227,45397227
33075,21,1799000,2,12,36,37,248,45397248
33076,306,1799100,2,12,36,37,554,45397554
33078,407,1799200,1,12,36,37,961,45397961
33079,0,1799300,1,12,36,37,961,45397961
33080,39,1799100,1,12,36,38,0,45398000
33081,854,1799300,2,12,36,38,854,45398854
33082,402,1799300,2,12,36,39,256,45399256
33083,1224,1799200,1,12,36,40,480,45400480
33084,551,1799100,2,12,36,41,31,45401031
33085,359,1799100,4,12,36,41,390,45401390
33086,138,1799200,2,12,36,41,528,45401528
33087,0,1799200,1,12,36,41,528,45401528
33088,664,1799000,4,12,36,42,192,45402192
33089,872,1799100,3,12,36,43,64,45403064
33090,159,1799100,7,12,36,43,223,45403223
33091,2773,1799100,2,12,36,45,996,45405996
33092,460,1799100,1,12,36,46,456,45406456
33093,1817,1799100,1,12,36,48,273,45408273
33094,77,1799000,1,12,36,48,350,45408350
33095,1631,1799100,1,12,36,49,981,45409981
33096,1655,1799100,1,12,36,51,636,45411636
33097,582,1799200,5,12,36,52,218,45412218
33098,1,1799200,4,12,36,52,219,45412219
33099,713,1799100,1,12,36,52,932,45412932
33100,5,1799100,3,12,36,52,937,45412937
33101,1658,1799200,5,12,36,54,595,45414595
33102,11,1799200,1,12,36,54,606,45414606
33103,0,1799200,1,12,36,54,606,45414606
33104,407,1799100,1,12,36,55,13,45415013
33105,1415,1799200,2,12,36,56,428,45416428
33107,164,1799100,3,12,36,56,592,45416592
33108,88,1799100,3,12,36,56,680,45416680
33109,344,1799200,1,12,36,57,24,45417024
33110,77,1799100,1,12,36,57,101,45417101
33111,34,1799200,1,12,36,57,135,45417135
33112,305,1799200,1,12,36,57,440,45417440
33113,991,1799200,1,12,36,58,431,45418431
33115,1724,1799200,1,12,37,0,155,45420155
33117,436,1799100,1,12,37,0,591,45420591
33118,49,1799300,5,12,37,0,640,45420640
33119,6,1799100,1,12,37,0,646,45420646
33120,40,1799100,2,12,37,0,686,45420686
33121,81,1799300,2,12,37,0,767,45420767
33122,89,1799100,1,12,37,0,856,45420856
33123,42,1799100,2,12,37,0,898,45420898
33124,820,1799200,1,12,37,1,718,45421718
33125,19,1799100,1,12,37,1,737,45421737
33126,219,1799000,1,12,37,1,956,45421956
33127,217,1799000,1,12,37,2,173,45422173
33128,149,1799000,1,12,37,2,322,45422322
33129,174,1799200,1,12,37,2,496,45422496
33130,10,1799200,5,12,37,2,506,45422506
33131,145,1799000,1,12,37,2,651,45422651
33132,53,1799000,1,12,37,2,704,45422704
33133,178,1799200,2,12,37,2,882,45422882
33134,1062,1799200,2,12,37,3,944,45423944
33135,2192,1799100,1,12,37,6,136,45426136
33136,377,1799000,4,12,37,6,513,45426513
33137,300,1799000,6,12,37,6,813,45426813
33138,2735,1799000,20,12,37,9,548,45429548
33139,1021,1799000,4,12,37,10,569,45430569
33140,260,1799000,1,12,37,10,829,45430829
33141,49,1798900,1,12,37,10,878,45430878
33142,1843,1799000,1,12,37,12,721,45432721
33143,147,1799000,1,12,37,12,868,45432868
33144,63,1799000,1,12,37,12,931,45432931
33145,1951,1799000,6,12,37,14,882,45434882
33146,1039,1799000,1,12,37,15,921,45435921
33147,101,1799000,1,12,37,16,22,45436022
33148,700,1799000,3,12,37,16,722,45436722
33150,23,1799000,1,12,37,16,745,45436745
33152,1783,1799200,1,12,37,18,528,45438528
33153,504,1799200,4,12,37,19,32,45439032
33154,346,1799100,1,12,37,19,378,45439378
33155,0,1799200,1,12,37,19,378,45439378
33156,208,1799000,1,12,37,19,586,45439586
33157,1715,1799000,1,12,37,21,301,45441301
33158,201,1799100,1,12,37,21,502,45441502
33159,49,1799100,2,12,37,21,551,45441551
33160,506,1799000,2,12,37,22,57,45442057
33161,671,1799100,4,12,37,22,728,45442728
33162,623,1799000,2,12,37,23,351,45443351
33163,273,1799000,2,12,37,23,624,45443624
33164,37,1799000,1,12,37,23,661,45443661
33166,559,1799000,2,12,37,24,220,45444220
33167,1349,1799000,1,12,37,25,569,45445569
33168,304,1799000,2,12,37,25,873,45445873
33169,723,1799000,1,12,37,26,596,45446596
33170,444,1798900,2,12,37,27,40,45447040
33171,1558,1799000,1,12,37,28,598,45448598
33172,743,1798900,1,12,37,29,341,45449341
33173,0,1799000,1,12,37,29,341,45449341
33174,91,1799000,1,12,37,29,432,45449432
33175,40,1799000,1,12,37,29,472,45449472
33176,419,1798900,1,12,37,29,891,45449891
33177,103,1798900,3,12,37,29,994,45449994
33179,10,1798800,1,12,37,30,4,45450004
33180,637,1798800,1,12,37,30,641,45450641
33181,419,1799000,3,12,37,31,60,45451060
33182,133,1798900,2,12,37,31,193,45451193
33183,37,1798900,1,12,37,31,230,45451230
33184,16,1798900,1,12,37,31,246,45451246
33185,70,1798900,1,12,37,31,316,45451316
33186,40,1798800,2,12,37,31,356,45451356
33187,60,1798800,1,12,37,31,416,45451416
33188,570,1799000,2,12,37,31,986,45451986
33189,1350,1799000,1,12,37,33,336,45453336
33190,559,1798900,1,12,37,33,895,45453895
33191,2861,1799000,1,12,37,36,756,45456756
33192,371,1798900,1,12,37,37,127,45457127
33193,337,1798900,1,12,37,37,464,45457464
33194,950,1799000,1,12,37,38,414,45458414
33195,196,1798900,1,12,37,38,610,45458610
33196,458,1798900,1,12,37,39,68,45459068
33198,631,1798800,1,12,37,39,699,45459699
33199,142,1798900,1,12,37,39,841,45459841
33200,388,1798900,1,12,37,40,229,45460229
33202,148,1799100,3,12,37,40,377,45460377
33203,0,1799100,2,12,37,40,377,45460377
33204,53,1799000,1,12,37,40,430,45460430
33205,268,1799100,3,12,37,40,698,45460698
33206,368,1799000,5,12,37,41,66,45461066
33207,1322,1799100,18,12,37,42,388,45462388
33209,2,1799200,2,12,37,42,390,45462390
33210,39,1799300,5,12,37,42,429,45462429
33211,1,1799300,3,12,37,42,430,45462430
33212,0,1799300,2,12,37,42,430,45462430
33213,0,1799300,1,12,37,42,430,45462430
33214,66,1799300,3,12,37,42,496,45462496
33215,0,1799300,1,12,37,42,496,45462496
33216,68,1799300,2,12,37,42,564,45462564
33218,1,1799400,1,12,37,42,565,45462565
33219,29,1799300,1,12,37,42,594,45462594
33220,1219,1799300,1,12,37,43,813,45463813
33221,99,1799300,1,12,37,43,912,45463912
33222,1299,1799300,2,12,37,45,211,45465211
33223,157,1799400,1,12,37,45,368,45465368
33224,31,1799400,1,12,37,45,399,45465399
33225,480,1799200,11,12,37,45,879,45465879
33226,54,1799300,1,12,37,45,933,45465933
33227,374,1799300,1,12,37,46,307,45466307
33228,156,1799300,2,12,37,46,463,45466463
33229,848,1799300,1,12,37,47,311,45467311
33230,74,1799300,2,12,37,47,385,45467385
33231,441,1799200,4,12,37,47,826,45467826
33232,1,1799200,1,12,37,47,827,45467827
33233,488,1799200,1,12,37,48,315,45468315
33234,1655,1799200,1,12,37,49,970,45469970
33235,392,1799100,1,12,37,50,362,45470362
33236,1,1799100,1,12,37,50,363,45470363
33237,1266,1799100,5,12,37,51,629,45471629
33238,266,1799200,2,12,37,51,895,45471895
33239,143,1799300,3,12,37,52,38,45472038
33240,475,1799300,1,12,37,52,513,45472513
33241,626,1799300,1,12,37,53,139,45473139
33242,150,1799300,1,12,37,53,289,45473289
33243,2113,1799300,2,12,37,55,402,45475402
33244,1601,1799200,1,12,37,57,3,45477003
33245,5,1799200,2,12,37,57,8,45477008
33246,1,1799200,2,12,37,57,9,45477009
33247,331,1799300,1,12,37,57,340,45477340
33248,536,1799300,1,12,37,57,876,45477876
33249,239,1799300,1,12,37,58,115,45478115
33250,144,1799200,2,12,37,58,259,45478259
33251,8,1799300,6,12,37,58,267,45478267
33253,524,1799300,2,12,37,58,791,45478791
33254,623,1799300,4,12,37,59,414,45479414
33255,85,1799300,1,12,37,59,499,45479499
33256,643,1799300,3,12,38,0,142,45480142
33257,84,1799300,1,12,38,0,226,45480226
33258,0,1799300,2,12,38,0,226,45480226
33260,0,1799400,3,12,38,0,226,45480226
33261,0,1799400,5,12,38,0,226,45480226
33262,0,1799500,2,12,38,0,226,45480226
33263,1,1799500,2,12,38,0,227,45480227
33264,1,1799500,3,12,38,0,228,45480228
33265,0,1799400,1,12,38,0,228,45480228
33266,1,1799500,1,12,38,0,229,45480229
33267,0,1799500,1,12,38,0,229,45480229
33268,123,1799500,3,12,38,0,352,45480352
33269,109,1799500,1,12,38,0,461,45480461
33270,67,1799500,3,12,38,0,528,45480528
33271,53,1799400,2,12,38,0,581,45480581
33273,145,1799400,1,12,38,0,726,45480726
33274,391,1799400,1,12,38,1,117,45481117
33275,39,1799400,2,12,38,1,156,45481156
33276,16,1799500,2,12,38,1,172,45481172
33277,54,1799500,1,12,38,1,226,45481226
33278,1,1799500,1,12,38,1,227,45481227
33279,221,1799500,1,12,38,1,448,45481448
33281,138,1799400,2,12,38,1,586,45481586
33283,35,1799300,3,12,38,1,621,45481621
33284,2,1799300,1,12,38,1,623,45481623
33285,7,1799400,1,12,38,1,630,45481630
33286,71,1799500,1,12,38,1,701,45481701
33287,159,1799500,1,12,38,1,860,45481860
33288,65,1799300,1,12,38,1,925,45481925
33289,457,1799400,1,12,38,2,382,45482382
33290,1452,1799500,1,12,38,3,834,45483834
33291,83,1799500,5,12,38,3,917,45483917
33292,43,1799500,3,12,38,3,960,45483960
33293,303,1799400,1,12,38,4,263,45484263
33294,65,1799500,1,12,38,4,328,45484328
33295,707,1799500,1,12,38,5,35,45485035
33296,1255,1799500,1,12,38,6,290,45486290
33297,544,1799500,1,12,38,6,834,45486834
33298,624,1799500,1,12,38,7,458,45487458
33299,17,1799500,1,12,38,7,475,45487475
33300,1,1799500,1,12,38,7,476,45487476
33301,0,1799600,1,12,38,7,476,45487476
33302,0,1799600,1,12,38,7,476,45487476
33303,0,1799600,1,12,38,7,476,45487476
33304,0,1799600,1,12,38,7,476,45487476
33305,0,1799600,1,12,38,7,476,45487476
33306,0,1799600,1,12,38,7,476,45487476
33307,0,1799600,1,12,38,7,476,45487476
33308,0,1799600,1,12,38,7,476,45487476
33309,0,1799600,1,12,38,7,476,45487476
33310,1,1799600,1,12,38,7,477,45487477
33311,740,1799500,2,12,38,8,217,45488217
33312,343,1799600,1,12,38,8,560,45488560
33313,1805,1799500,1,12,38,10,365,45490365
33314,52,1799600,1,12,38,10,417,45490417
33315,1,1799600,9,12,38,10,418,45490418
33316,705,1799600,1,12,38,11,123,45491123
33317,29,1799600,1,12,38,11,152,45491152
33318,588,1799500,1,12,38,11,740,45491740
33319,229,1799600,1,12,38,11,969,45491969
33320,489,1799500,1,12,38,12,458,45492458
33321,508,1799500,1,12,38,12,966,45492966
33322,216,1799600,1,12,38,13,182,45493182
33323,173,1799600,1,12,38,13,355,45493355
33324,575,1799500,2,12,38,13,930,45493930
33325,71,1799500,1,12,38,14,1,45494001
33326,13,1799500,1,12,38,14,14,45494014
33327,0,1799500,5,12,38,14,14,45494014
33328,44,1799500,1,12,38,14,58,45494058
33329,674,1799500,1,12,38,14,732,45494732
33330,339,1799500,1,12,38,15,71,45495071
33331,406,1799500,1,12,38,15,477,45495477
33332,321,1799400,1,12,38,15,798,45495798
33333,228,1799500,2,12,38,16,26,45496026
33334,11,1799600,1,12,38,16,37,45496037
33335,2496,1799500,1,12,38,18,533,45498533
33336,67,1799600,1,12,38,18,600,45498600
33337,0,1799600,1,12,38,18,600,45498600
33338,1,1799600,1,12,38,18,601,45498601
33339,0,1799600,1,12,38,18,601,45498601
33340,1076,1799500,1,12,38,19,677,45499677
33341,2391,1799500,1,12,38,22,68,45502068
33342,18,1799500,2,12,38,22,86,45502086
33343,317,1799400,2,12,38,22,403,45502403
33344,798,1799500,1,12,38,23,201,45503201
33345,264,1799500,1,12,38,23,465,45503465
33346,221,1799500,3,12,38,23,686,45503686
33347,752,1799400,15,12,38,24,438,45504438
33348,181,1799400,1,12,38,24,619,45504619
33349,339,1799400,1,12,38,24,958,45504958
33350,874,1799400,1,12,38,25,832,45505832
33351,749,1799400,2,12,38,26,581,45506581
33352,2767,1799400,2,12,38,29,348,45509348
33353,127,1799400,1,12,38,29,475,45509475
33354,1,1799500,1,12,38,29,476,45509476
33355,662,1799300,1,12,38,30,138,45510138
33356,276,1799400,1,12,38,30,414,45510414
33357,1099,1799400,1,12,38,31,513,45511513
33358,911,1799400,1,12,38,32,424,45512424
33359,899,1799300,1,12,38,33,323,45513323
33360,748,1799400,1,12,38,34,71,45514071
33361,502,1799500,1,12,38,34,573,45514573
33362,1632,1799400,1,12,38,36,205,45516205
33363,878,1799400,1,12,38,37,83,45517083
33364,17,1799500,1,12,38,37,100,45517100
33365,1,1799500,1,12,38,37,101,45517101
33366,0,1799500,1,12,38,37,101,45517101
33367,0,1799500,1,12,38,37,101,45517101
33368,0,1799500,1,12,38,37,101,45517101
33369,823,1799500,1,12,38,37,924,45517924
33370,1013,1799500,3,12,38,38,937,45518937
33371,1365,1799400,1,12,38,40,302,45520302
33372,477,1799500,1,12,38,40,779,45520779
33373,374,1799500,1,12,38,41,153,45521153
33374,965,1799500,1,12,38,42,118,45522118
33375,127,1799400,1,12,38,42,245,45522245
33376,195,1799500,2,12,38,42,440,45522440
33377,2808,1799400,2,12,38,45,248,45525248
33378,44,1799500,24,12,38,45,292,45525292
33380,2,1799700,2,12,38,45,294,45525294
33381,0,1799700,1,12,38,45,294,45525294
33382,0,1799700,2,12,38,45,294,45525294
33383,1,1799700,2,12,38,45,295,45525295
33384,0,1799700,1,12,38,45,295,45525295
33385,0,1799700,1,12,38,45,295,45525295
33386,0,1799700,1,12,38,45,295,45525295
33387,1,1799700,3,12,38,45,296,45525296
33388,4,1799800,6,12,38,45,300,45525300
33389,1,1799800,7,12,38,45,301,45525301
33390,0,1799800,2,12,38,45,301,45525301
33391,42,1799900,1,12,38,45,343,45525343
33392,0,1799900,5,12,38,45,343,45525343
33393,0,1799900,1,12,38,45,343,45525343
33394,0,1799900,2,12,38,45,343,45525343
33395,0,1799900,8,12,38,45,343,45525343
33396,1,1799900,1,12,38,45,344,45525344
33397,1,1799900,3,12,38,45,345,45525345
33398,57,1800000,2,12,38,45,402,45525402
33399,77,1800000,3,12,38,45,479,45525479
33400,2,1799800,1,12,38,45,481,45525481
33401,12,1800000,1,12,38,45,493,45525493
33402,7,1800000,1,12,38,45,500,45525500
33403,26,1800000,2,12,38,45,526,45525526
33404,1,1800000,1,12,38,45,527,45525527
33405,91,1800000,1,12,38,45,618,45525618
33406,25,1800000,1,12,38,45,643,45525643
33407,68,1800000,1,12,38,45,711,45525711
33408,132,1800000,3,12,38,45,843,45525843
33409,145,1799800,5,12,38,45,988,45525988
33410,130,1799900,1,12,38,46,118,45526118
33411,1,1799800,1,12,38,46,119,45526119
33412,38,1799900,1,12,38,46,157,45526157
33413,25,1799900,1,12,38,46,182,45526182
33414,250,1799900,5,12,38,46,432,45526432
33415,351,1799900,1,12,38,46,783,45526783
33417,86,1799800,3,12,38,46,869,45526869
33418,169,1800000,4,12,38,47,38,45527038
33419,62,1800000,1,12,38,47,100,45527100
33420,325,1800000,1,12,38,47,425,45527425
33421,380,1800000,1,12,38,47,805,45527805
33422,252,1800000,2,12,38,48,57,45528057
33423,338,1800000,2,12,38,48,395,45528395
33424,318,1800000,1,12,38,48,713,45528713
33425,722,1800100,2,12,38,49,435,45529435
33426,54,1800100,1,12,38,49,489,45529489
33427,37,1800100,1,12,38,49,526,45529526
33428,65,1800100,5,12,38,49,591,45529591
33429,82,1800000,1,12,38,49,673,45529673
33430,140,1799900,1,12,38,49,813,45529813
33431,112,1800100,1,12,38,49,925,45529925
33432,329,1799900,1,12,38,50,254,45530254
33433,1,1799900,2,12,38,50,255,45530255
33434,3,1799800,1,12,38,50,258,45530258
33435,347,1799900,1,12,38,50,605,45530605
33436,435,1799900,2,12,38,51,40,45531040
33437,211,1799900,3,12,38,51,251,45531251
33438,395,1799900,1,12,38,51,646,45531646
33439,214,1799700,1,12,38,51,860,45531860
33440,243,1799800,1,12,38,52,103,45532103
33441,1262,1799900,1,12,38,53,365,45533365
33442,59,1799900,1,12,38,53,424,45533424
33443,1151,1799700,1,12,38,54,575,45534575
33444,240,1799600,1,12,38,54,815,45534815
33445,69,1799800,4,12,38,54,884,45534884
33446,635,1799700,3,12,38,55,519,45535519
33447,231,1799700,1,12,38,55,750,45535750
33448,125,1799700,2,12,38,55,875,45535875
33449,490,1799700,1,12,38,56,365,45536365
33450,76,1799800,1,12,38,56,441,45536441
33451,49,1799700,1,12,38,56,490,45536490
33452,318,1799800,1,12,38,56,808,45536808
33453,988,1799800,1,12,38,57,796,45537796
33455,168,1799700,1,12,38,57,964,45537964
33456,1056,1799700,1,12,38,59,20,45539020
33458,392,1799700,2,12,38,59,412,45539412
33460,198,1799700,1,12,38,59,610,45539610
33461,1521,1799700,1,12,39,1,131,45541131
33462,269,1799700,3,12,39,1,400,45541400
33463,86,1799600,1,12,39,1,486,45541486
33464,1920,1799600,2,12,39,3,406,45543406
33465,241,1799600,2,12,39,3,647,45543647
33466,180,1799700,1,12,39,3,827,45543827
33467,208,1799700,2,12,39,4,35,45544035
33468,636,1799800,1,12,39,4,671,45544671
33469,2481,1799700,1,12,39,7,152,45547152
33471,187,1799700,1,12,39,7,339,45547339
33472,490,1799700,2,12,39,7,829,45547829
33473,101,1799800,1,12,39,7,930,45547930
33474,766,1799800,1,12,39,8,696,45548696
33475,30,1799700,2,12,39,8,726,45548726
33476,582,1799800,2,12,39,9,308,45549308
33477,1268,1799800,1,12,39,10,576,45550576
33478,580,1799800,1,12,39,11,156,45551156
33479,598,1799800,1,12,39,11,754,45551754
33480,489,1799800,1,12,39,12,243,45552243
33481,82,1799700,3,12,39,12,325,45552325
33482,708,1799800,1,12,39,13,33,45553033
33483,68,1799800,2,12,39,13,101,45553101
33484,647,1799700,2,12,39,13,748,45553748
33485,473,1799800,1,12,39,14,221,45554221
33486,44,1799800,1,12,39,14,265,45554265
33487,280,1799800,1,12,39,14,545,45554545
33488,688,1799800,1,12,39,15,233,45555233
33489,455,1799800,1,12,39,15,688,45555688
33490,841,1799800,1,12,39,16,529,45556529
33491,964,1799800,1,12,39,17,493,45557493
33492,76,1799800,2,12,39,17,569,45557569
33493,1,1799800,1,12,39,17,570,45557570
33494,797,1799800,1,12,39,18,367,45558367
33495,393,1799800,1,12,39,18,760,45558760
33496,59,1799700,1,12,39,18,819,45558819
33497,67,1799800,1,12,39,18,886,45558886
33498,112,1799800,1,12,39,18,998,45558998
33499,423,1799800,1,12,39,19,421,45559421
33500,35,1799900,1,12,39,19,456,45559456
33501,534,1799800,5,12,39,19,990,45559990
33502,161,1799800,3,12,39,20,151,45560151
33503,11,1799800,1,12,39,20,162,45560162
33504,1168,1799800,1,12,39,21,330,45561330
33505,169,1799900,1,12,39,21,499,45561499
33506,366,1799800,1,12,39,21,865,45561865
33507,557,1799900,8,12,39,22,422,45562422
33508,782,1799900,4,12,39,23,204,45563204
33509,665,1800000,2,12,39,23,869,45563869
33510,691,1800000,1,12,39,24,560,45564560
33511,37,1799900,2,12,39,24,597,45564597
33512,68,1800000,1,12,39,24,665,45564665
33513,525,1800000,1,12,39,25,190,45565190
33514,302,1799900,1,12,39,25,492,45565492
33515,65,1799900,1,12,39,25,557,45565557
33516,1273,1799900,1,12,39,26,830,45566830
33517,0,1799900,1,12,39,26,830,45566830
33518,390,1800000,1,12,39,27,220,45567220
33519,765,1800000,1,12,39,27,985,45567985
33520,207,1799900,1,12,39,28,192,45568192
33521,30,1799900,2,12,39,28,222,45568222
33522,687,1799900,2,12,39,28,909,45568909
33523,123,1800000,1,12,39,29,32,45569032
33524,1237,1800000,5,12,39,30,269,45570269
33525,205,1799900,1,12,39,30,474,45570474
33526,1451,1799900,2,12,39,31,925,45571925
33527,248,1799900,1,12,39,32,173,45572173
33528,793,1799900,1,12,39,32,966,45572966
33529,270,1799900,1,12,39,33,236,45573236
33530,0,1799900,1,12,39,33,236,45573236
33531,1027,1799900,1,12,39,34,263,45574263
33532,2942,1799900,1,12,39,37,205,45577205
33533,1454,1799900,1,12,39,38,659,45578659
33534,1236,1799900,1,12,39,39,895,45579895
33535,87,1799800,1,12,39,39,982,45579982
33536,1777,1799900,2,12,39,41,759,45581759
33537,355,1799900,1,12,39,42,114,45582114
33538,724,1799800,2,12,39,42,838,45582838
33539,53,1799800,3,12,39,42,891,45582891
33540,1,1799800,6,12,39,42,892,45582892
33541,611,1799700,2,12,39,43,503,45583503
33542,125,1799700,1,12,39,43,628,45583628
33543,1154,1799800,3,12,39,44,782,45584782
33544,3310,1799800,1,12,39,48,92,45588092
33545,24,1799800,1,12,39,48,116,45588116
33546,2090,1799800,1,12,39,50,206,45590206
33547,1433,1799800,1,12,39,51,639,45591639
33548,440,1799800,1,12,39,52,79,45592079
33549,2698,1799700,2,12,39,54,777,45594777
33550,0,1799800,1,12,39,54,777,45594777
33551,3620,1799800,1,12,39,58,397,45598397
33552,1794,1799700,1,12,40,0,191,45600191
33553,0,1799700,1,12,40,0,191,45600191
33554,828,1799700,1,12,40,1,19,45601019
33555,11,1799700,3,12,40,1,30,45601030
33556,1,1799700,1,12,40,1,31,45601031
33557,47,1799700,3,12,40,1,78,45601078
33558,0,1799700,2,12,40,1,78,45601078
33559,0,1799700,1,12,40,1,78,45601078
33560,1,1799700,3,12,40,1,79,45601079
33561,0,1799700,1,12,40,1,79,45601079
33562,0,1799700,1,12,40,1,79,45601079
33563,0,1799700,2,12,40,1,79,45601079
33564,29,1799700,1,12,40,1,108,45601108
33565,145,1799700,1,12,40,1,253,45601253
33566,34,1799700,1,12,40,1,287,45601287
33567,146,1799600,1,12,40,1,433,45601433
33568,92,1799600,1,12,40,1,525,45601525
33569,170,1799600,1,12,40,1,695,45601695
33570,337,1799600,1,12,40,2,32,45602032
33571,246,1799700,1,12,40,2,278,45602278
33572,46,1799700,1,12,40,2,324,45602324
33573,95,1799600,1,12,40,2,419,45602419
33574,4394,1799700,1,12,40,6,813,45606813
33575,752,1799600,1,12,40,7,565,45607565
33576,36,1799600,1,12,40,7,601,45607601
33577,475,1799600,2,12,40,8,76,45608076
33578,280,1799700,1,12,40,8,356,45608356
33579,131,1799700,3,12,40,8,487,45608487
33580,354,1799600,3,12,40,8,841,45608841
33581,623,1799700,1,12,40,9,464,45609464
33582,50,1799700,1,12,40,9,514,45609514
33583,595,1799700,1,12,40,10,109,45610109
33584,190,1799600,1,12,40,10,299,45610299
33585,2351,1799700,1,12,40,12,650,45612650
33586,963,1799700,1,12,40,13,613,45613613
33587,786,1799600,2,12,40,14,399,45614399
33588,99,1799600,53,12,40,14,498,45614498
33589,0,1799600,16,12,40,14,498,45614498
33590,0,1799600,5,12,40,14,498,45614498
33591,0,1799600,7,12,40,14,498,45614498
33592,0,1799600,2,12,40,14,498,45614498
33593,0,1799600,2,12,40,14,498,45614498
33594,0,1799600,1,12,40,14,498,45614498
33595,1,1799600,1,12,40,14,499,45614499
33596,0,1799600,1,12,40,14,499,45614499
33597,0,1799600,8,12,40,14,499,45614499
33598,0,1799600,2,12,40,14,499,45614499
33599,0,1799600,1,12,40,14,499,45614499
33600,0,1799600,2,12,40,14,499,45614499
33601,0,1799600,4,12,40,14,499,45614499
33602,0,1799500,1,12,40,14,499,45614499
33603,674,1799600,2,12,40,15,173,45615173
33604,1,1799600,2,12,40,15,174,45615174
33605,888,1799700,4,12,40,16,62,45616062
33606,103,1799800,1,12,40,16,165,45616165
33607,2044,1799800,8,12,40,18,209,45618209
33608,0,1799800,12,12,40,18,209,45618209
33609,0,1799800,1,12,40,18,209,45618209
33610,0,1799800,2,12,40,18,209,45618209
33611,0,1799800,5,12,40,18,209,45618209
33612,17,1799700,1,12,40,18,226,45618226
33613,0,1799700,1,12,40,18,226,45618226
33614,0,1799700,1,12,40,18,226,45618226
33615,0,1799700,1,12,40,18,226,45618226
33616,1,1799700,1,12,40,18,227,45618227
33617,1931,1799700,1,12,40,20,158,45620158
33618,893,1799800,8,12,40,21,51,45621051
33619,0,1799800,8,12,40,21,51,45621051
33621,3,1800000,1,12,40,21,54,45621054
33622,89,1800000,1,12,40,21,143,45621143
33623,60,1799900,1,12,40,21,203,45621203
33624,16,1800000,4,12,40,21,219,45621219
33625,197,1800000,4,12,40,21,416,45621416
33626,0,1800000,1,12,40,21,416,45621416
33627,0,1800100,13,12,40,21,416,45621416
33628,2,1800100,1,12,40,21,418,45621418
33629,442,1800000,1,12,40,21,860,45621860
33630,573,1800000,2,12,40,22,433,45622433
33631,68,1799900,1,12,40,22,501,45622501
33632,1167,1800000,1,12,40,23,668,45623668
33634,1828,1800000,1,12,40,25,496,45625496
33635,135,1800100,1,12,40,25,631,45625631
33636,213,1800100,1,12,40,25,844,45625844
33637,835,1800000,1,12,40,26,679,45626679
33638,278,1800100,1,12,40,26,957,45626957
33639,920,1800200,1,12,40,27,877,45627877
33640,187,1800200,1,12,40,28,64,45628064
33641,981,1800200,1,12,40,29,45,45629045
33642,371,1800200,1,12,40,29,416,45629416
33643,414,1800200,1,12,40,29,830,45629830
33644,834,1800200,2,12,40,30,664,45630664
33645,811,1800200,1,12,40,31,475,45631475
33646,183,1800200,1,12,40,31,658,45631658
33647,538,1800100,1,12,40,32,196,45632196
33648,217,1800200,10,12,40,32,413,45632413
33649,542,1800100,1,12,40,32,955,45632955
33650,2222,1800100,1,12,40,35,177,45635177
33651,207,1800100,3,12,40,35,384,45635384
33652,3166,1800100,3,12,40,38,550,45638550
33653,740,1800100,1,12,40,39,290,45639290
33654,635,1800100,3,12,40,39,925,45639925
33655,627,1800200,8,12,40,40,552,45640552
33656,3420,1800200,5,12,40,43,972,45643972
33657,610,1800200,1,12,40,44,582,45644582
33658,3187,1800200,2,12,40,47,769,45647769
33659,2511,1800200,3,12,40,50,280,45650280
33660,744,1800300,1,12,40,51,24,45651024
33661,36,1800200,3,12,40,51,60,45651060
33662,1933,1800100,1,12,40,52,993,45652993
33663,86,1800200,1,12,40,53,79,45653079
33664,311,1800200,2,12,40,53,390,45653390
33665,944,1800200,5,12,40,54,334,45654334
33666,1158,1800200,5,12,40,55,492,45655492
33667,282,1800200,1,12,40,55,774,45655774
33668,822,1800100,1,12,40,56,596,45656596
33669,461,1800100,1,12,40,57,57,45657057
33670,737,1800100,9,12,40,57,794,45657794
33671,810,1800100,2,12,40,58,604,45658604
33672,11,1800100,1,12,40,58,615,45658615
33673,412,1800000,1,12,40,59,27,45659027
33674,2041,1800100,1,12,41,1,68,45661068
33675,21,1800100,2,12,41,1,89,45661089
33676,45,1800000,2,12,41,1,134,45661134
33677,206,1800000,2,12,41,1,340,45661340
33678,32,1800000,1,12,41,1,372,45661372
33679,193,1800100,1,12,41,1,565,45661565
33680,1611,1800000,5,12,41,3,176,45663176
33681,5,1800000,1,12,41,3,181,45663181
33682,98,1800000,2,12,41,3,279,45663279
33683,60,1800000,1,12,41,3,339,45663339
33684,145,1799800,1,12,41,3,484,45663484
33685,199,1800000,5,12,41,3,683,45663683
33686,12,1799800,1,12,41,3,695,45663695
33687,607,1799900,1,12,41,4,302,45664302
33688,771,1800000,1,12,41,5,73,45665073
33689,943,1800000,3,12,41,6,16,45666016
33690,0,1800000,1,12,41,6,16,45666016
33691,0,1800000,1,12,41,6,16,45666016
33692,464,1799900,1,12,41,6,480,45666480
33693,817,1800000,1,12,41,7,297,45667297
33694,2320,1799900,1,12,41,9,617,45669617
33695,682,1799800,2,12,41,10,299,45670299
33696,4697,1799800,1,12,41,14,996,45674996
33697,907,1799900,1,12,41,15,903,45675903
33698,601,1799900,1,12,41,16,504,45676504
33699,2042,1799900,1,12,41,18,546,45678546
33700,1961,1800000,1,12,41,20,507,45680507
33701,13,1800000,1,12,41,20,520,45680520
33702,29,1799900,1,12,41,20,549,45680549
33704,11439,1799900,1,12,41,31,988,45691988
33705,114,1800000,1,12,41,32,102,45692102
33706,763,1799900,1,12,41,32,865,45692865
33707,4083,1800000,2,12,41,36,948,45696948
33708,1166,1799900,1,12,41,38,114,45698114
33709,358,1799900,1,12,41,38,472,45698472
33710,2312,1800000,1,12,41,40,784,45700784
33711,1163,1799900,2,12,41,41,947,45701947
33712,244,1800000,1,12,41,42,191,45702191
33713,661,1799900,10,12,41,42,852,45702852
33714,359,1799900,1,12,41,43,211,45703211
33715,825,1799900,1,12,41,44,36,45704036
33716,1269,1799900,5,12,41,45,305,45705305
33717,1,1799900,1,12,41,45,306,45705306
33718,882,1799900,1,12,41,46,188,45706188
33719,1481,1800000,2,12,41,47,669,45707669
33720,1,1800000,1,12,41,47,670,45707670
33721,0,1800000,1,12,41,47,670,45707670
33722,0,1800000,1,12,41,47,670,45707670
33723,0,1800000,1,12,41,47,670,45707670
33724,0,1800000,3,12,41,47,670,45707670
33725,2215,1800000,1,12,41,49,885,45709885
33726,3309,1800000,1,12,41,53,194,45713194
33727,247,1800000,1,12,41,53,441,45713441
33728,7074,1800000,1,12,42,0,515,45720515
33729,86,1799900,1,12,42,0,601,45720601
33730,0,1799900,2,12,42,0,601,45720601
33731,1,1799900,1,12,42,0,602,45720602
33732,0,1799900,2,12,42,0,602,45720602
33733,0,1799900,1,12,42,0,602,45720602
33734,6835,1800000,1,12,42,7,437,45727437
33735,38,1799900,1,12,42,7,475,45727475
33736,1,1799900,1,12,42,7,476,45727476
33737,111,1800000,1,12,42,7,587,45727587
33738,1598,1800000,1,12,42,9,185,45729185
33739,40,1799900,1,12,42,9,225,45729225
33740,996,1800000,2,12,42,10,221,45730221
33741,65,1800000,3,12,42,10,286,45730286
33742,327,1799900,1,12,42,10,613,45730613
33743,986,1800000,1,12,42,11,599,45731599
33744,230,1800000,1,12,42,11,829,45731829
33745,990,1800000,2,12,42,12,819,45732819
33746,1951,1799900,1,12,42,14,770,45734770
33747,662,1799900,3,12,42,15,432,45735432
33748,1227,1800000,1,12,42,16,659,45736659
33749,206,1800000,1,12,42,16,865,45736865
33750,834,1800000,1,12,42,17,699,45737699
33751,27,1799900,1,12,42,17,726,45737726
33752,3,1799900,1,12,42,17,729,45737729
33753,1575,1799800,5,12,42,19,304,45739304
33754,744,1799800,3,12,42,20,48,45740048
33755,1101,1799900,1,12,42,21,149,45741149
33756,1534,1799900,1,12,42,22,683,45742683
33757,372,1799900,2,12,42,23,55,45743055
33758,642,1799900,1,12,42,23,697,45743697
33759,270,1799900,1,12,42,23,967,45743967
33760,3111,1799800,7,12,42,27,78,45747078
33761,1,1799800,1,12,42,27,79,45747079
33762,0,1799800,3,12,42,27,79,45747079
33763,15,1799900,1,12,42,27,94,45747094
33764,2501,1799700,1,12,42,29,595,45749595
33765,5,1799700,1,12,42,29,600,45749600
33766,0,1799700,1,12,42,29,600,45749600
33767,0,1799700,1,12,42,29,600,45749600
33768,1,1799700,1,12,42,29,601,45749601
33769,15,1799800,3,12,42,29,616,45749616
33770,277,1799700,1,12,42,29,893,45749893
33771,455,1799700,1,12,42,30,348,45750348
33772,1304,1799700,1,12,42,31,652,45751652
33773,928,1799700,1,12,42,32,580,45752580
33774,394,1799800,1,12,42,32,974,45752974
33775,267,1799800,1,12,42,33,241,45753241
33776,621,1799700,3,12,42,33,862,45753862
33777,154,1799600,1,12,42,34,16,45754016
33778,661,1799600,1,12,42,34,677,45754677
33779,502,1799700,1,12,42,35,179,45755179
33780,175,1799700,1,12,42,35,354,45755354
33781,116,1799700,2,12,42,35,470,45755470
33782,231,1799600,1,12,42,35,701,45755701
33783,970,1799600,5,12,42,36,671,45756671
33784,1514,1799600,1,12,42,38,185,45758185
33785,40,1799600,1,12,42,38,225,45758225
33786,0,1799600,1,12,42,38,225,45758225
33787,125,1799600,2,12,42,38,350,45758350
33788,1129,1799600,1,12,42,39,479,45759479
33789,886,1799600,1,12,42,40,365,45760365
33790,34,1799600,1,12,42,40,399,45760399
33791,677,1799700,1,12,42,41,76,45761076
33792,22,1799700,1,12,42,41,98,45761098
33793,4963,1799700,1,12,42,46,61,45766061
33794,279,1799700,1,12,42,46,340,45766340
33795,1221,1799700,1,12,42,47,561,45767561
33796,40,1799600,1,12,42,47,601,45767601
33797,103,1799700,5,12,42,47,704,45767704
33798,69,1799700,1,12,42,47,773,45767773
33799,227,1799700,1,12,42,48,0,45768000
33800,1080,1799700,1,12,42,49,80,45769080
33801,2053,1799700,3,12,42,51,133,45771133
33802,41,1799700,3,12,42,51,174,45771174
33803,25,1799700,1,12,42,51,199,45771199
33804,1708,1799800,1,12,42,52,907,45772907
33805,1740,1799700,2,12,42,54,647,45774647
33806,116,1799800,1,12,42,54,763,45774763
33807,1079,1799800,1,12,42,55,842,45775842
33808,268,1799800,1,12,42,56,110,45776110
33810,2100,1799900,4,12,42,58,210,45778210
33811,1458,1799800,1,12,42,59,668,45779668
33812,564,1799800,1,12,43,0,232,45780232
33813,313,1799800,3,12,43,0,545,45780545
33814,225,1799800,1,12,43,0,770,45780770
33815,1428,1799800,1,12,43,2,198,45782198
33816,150,1799800,1,12,43,2,348,45782348
33817,190,1799700,1,12,43,2,538,45782538
33818,891,1799700,1,12,43,3,429,45783429
33819,1246,1799800,1,12,43,4,675,45784675
33820,1901,1799800,1,12,43,6,576,45786576
33821,275,1799800,1,12,43,6,851,45786851
33822,2121,1799800,1,12,43,8,972,45788972
33823,450,1799800,1,12,43,9,422,45789422
33824,1765,1799900,1,12,43,11,187,45791187
33825,0,1799800,2,12,43,11,187,45791187
33826,346,1799800,1,12,43,11,533,45791533
33827,2009,1799700,2,12,43,13,542,45793542
33828,11,1799800,1,12,43,13,553,45793553
33829,5271,1799700,1,12,43,18,824,45798824
33830,594,1799800,1,12,43,19,418,45799418
33831,617,1799800,1,12,43,20,35,45800035
33832,1625,1799800,2,12,43,21,660,45801660
33833,6974,1799800,1,12,43,28,634,45808634
33834,973,1799600,1,12,43,29,607,45809607
33835,1124,1799700,1,12,43,30,731,45810731
33836,759,1799700,1,12,43,31,490,45811490
33838,235,1799600,4,12,43,31,725,45811725
33839,2649,1799800,1,12,43,34,374,45814374
33840,263,1799800,1,12,43,34,637,45814637
33841,0,1799800,1,12,43,34,637,45814637
33842,562,1799800,1,12,43,35,199,45815199
33843,1,1799800,1,12,43,35,200,45815200
33844,0,1799800,7,12,43,35,200,45815200
33845,31,1799900,2,12,43,35,231,45815231
33846,0,1799900,1,12,43,35,231,45815231
33847,1,1799900,1,12,43,35,232,45815232
33848,0,1799900,18,12,43,35,232,45815232
33849,0,1799900,1,12,43,35,232,45815232
33850,0,1799900,1,12,43,35,232,45815232
33851,4,1800000,1,12,43,35,236,45815236
33852,1,1800000,7,12,43,35,237,45815237
33853,0,1800000,1,12,43,35,237,45815237
33854,0,1800000,12,12,43,35,237,45815237
33855,39,1800000,1,12,43,35,276,45815276
33856,34,1799900,1,12,43,35,310,45815310
33857,75,1800000,1,12,43,35,385,45815385
33858,119,1799900,1,12,43,35,504,45815504
33859,614,1799900,3,12,43,36,118,45816118
33861,1614,1800000,1,12,43,37,732,45817732
33862,68,1800000,1,12,43,37,800,45817800
33863,646,1800100,1,12,43,38,446,45818446
33864,833,1800100,1,12,43,39,279,45819279
33865,694,1800100,1,12,43,39,973,45819973
33866,308,1800100,1,12,43,40,281,45820281
33867,163,1800000,1,12,43,40,444,45820444
33868,289,1800000,2,12,43,40,733,45820733
33869,566,1800100,1,12,43,41,299,45821299
33870,66,1800000,7,12,43,41,365,45821365
33872,82,1800100,1,12,43,41,447,45821447
33873,1710,1800100,1,12,43,43,157,45823157
33874,1556,1800100,2,12,43,44,713,45824713
33875,18,1800100,2,12,43,44,731,45824731
33876,1522,1800100,1,12,43,46,253,45826253
33877,57,1800000,2,12,43,46,310,45826310
33878,171,1800100,1,12,43,46,481,45826481
33879,550,1800100,1,12,43,47,31,45827031
33880,272,1800100,2,12,43,47,303,45827303
33881,74,1800000,2,12,43,47,377,45827377
33882,156,1800000,1,12,43,47,533,45827533
33883,2843,1800200,34,12,43,50,376,45830376
33884,22,1800300,1,12,43,50,398,45830398
33885,100,1800300,2,12,43,50,498,45830498
33886,3,1800300,1,12,43,50,501,45830501
33887,14,1800300,1,12,43,50,515,45830515
33888,205,1800300,1,12,43,50,720,45830720
33889,23,1800300,2,12,43,50,743,45830743
33890,34,1800300,1,12,43,50,777,45830777
33891,275,1800300,12,12,43,51,52,45831052
33892,331,1800400,2,12,43,51,383,45831383
33893,138,1800400,5,12,43,51,521,45831521
33894,7,1800400,1,12,43,51,528,45831528
33895,9,1800400,3,12,43,51,537,45831537
33897,52,1800400,1,12,43,51,589,45831589
33898,44,1800500,1,12,43,51,633,45831633
33899,9,1800500,1,12,43,51,642,45831642
33900,16,1800500,1,12,43,51,658,45831658
33901,16,1800500,2,12,43,51,674,45831674
33902,28,1800500,1,12,43,51,702,45831702
33903,196,1800400,1,12,43,51,898,45831898
33904,195,1800500,1,12,43,52,93,45832093
33905,70,1800500,1,12,43,52,163,45832163
33906,0,1800500,8,12,43,52,163,45832163
33907,1,1800500,1,12,43,52,164,45832164
33908,0,1800500,1,12,43,52,164,45832164
33909,0,1800500,1,12,43,52,164,45832164
33910,1,1800500,1,12,43,52,165,45832165
33911,0,1800500,5,12,43,52,165,45832165
33912,99,1800500,1,12,43,52,264,45832264
33913,325,1800500,1,12,43,52,589,45832589
33914,36,1800500,1,12,43,52,625,45832625
33915,111,1800500,1,12,43,52,736,45832736
33916,55,1800400,1,12,43,52,791,45832791
33917,85,1800400,1,12,43,52,876,45832876
33918,605,1800400,1,12,43,53,481,45833481
33919,620,1800300,1,12,43,54,101,45834101
33920,267,1800400,7,12,43,54,368,45834368
33921,96,1800500,1,12,43,54,464,45834464
33922,23,1800500,2,12,43,54,487,45834487
33923,682,1800600,10,12,43,55,169,45835169
33924,116,1800600,2,12,43,55,285,45835285
33925,18,1800600,2,12,43,55,303,45835303
33926,207,1800600,1,12,43,55,510,45835510
33927,75,1800600,1,12,43,55,585,45835585
33928,103,1800500,1,12,43,55,688,45835688
33929,23,1800500,1,12,43,55,711,45835711
33930,643,1800500,1,12,43,56,354,45836354
33931,105,1800400,13,12,43,56,459,45836459
33932,0,1800400,13,12,43,56,459,45836459
33933,0,1800400,13,12,43,56,459,45836459
33935,9,1800200,3,12,43,56,468,45836468
33936,28,1800300,1,12,43,56,496,45836496
33937,880,1800200,2,12,43,57,376,45837376
33938,24,1800200,1,12,43,57,400,45837400
33939,20,1800200,1,12,43,57,420,45837420
33940,365,1800300,1,12,43,57,785,45837785
33941,321,1800300,1,12,43,58,106,45838106
33942,709,1800200,2,12,43,58,815,45838815
33944,40,1800300,1,12,43,58,855,45838855
33945,1057,1800200,1,12,43,59,912,45839912
33946,89,1800200,1,12,44,0,1,45840001
33948,1669,1800200,1,12,44,1,670,45841670
33949,1697,1800200,1,12,44,3,367,45843367
33950,178,1800300,2,12,44,3,545,45843545
33951,3185,1800200,1,12,44,6,730,45846730
33952,418,1800200,1,12,44,7,148,45847148
33954,635,1800200,1,12,44,7,783,45847783
33955,2145,1800200,1,12,44,9,928,45849928
33956,1454,1800200,1,12,44,11,382,45851382
33957,239,1800200,1,12,44,11,621,45851621
33958,66,1800100,1,12,44,11,687,45851687
33959,388,1800200,2,12,44,12,75,45852075
33960,362,1800300,1,12,44,12,437,45852437
33961,0,1800300,6,12,44,12,437,45852437
33962,136,1800300,1,12,44,12,573,45852573
33963,661,1800400,2,12,44,13,234,45853234
33964,224,1800400,1,12,44,13,458,45853458
33965,200,1800400,1,12,44,13,658,45853658
33966,580,1800400,3,12,44,14,238,45854238
33967,249,1800400,3,12,44,14,487,45854487
33969,1463,1800300,1,12,44,15,950,45855950
33970,511,1800400,1,12,44,16,461,45856461
33971,355,1800400,2,12,44,16,816,45856816
33972,545,1800200,1,12,44,17,361,45857361
33973,315,1800400,2,12,44,17,676,45857676
33974,124,1800400,3,12,44,17,800,45857800
33975,458,1800400,1,12,44,18,258,45858258
33976,1159,1800400,1,12,44,19,417,45859417
33978,1076,1800300,2,12,44,20,493,45860493
33979,704,1800500,1,12,44,21,197,45861197
33980,618,1800400,1,12,44,21,815,45861815
33982,306,1800300,3,12,44,22,121,45862121
33984,3,1800200,2,12,44,22,124,45862124
33985,131,1800200,1,12,44,22,255,45862255
33986,53,1800200,1,12,44,22,308,45862308
33987,256,1800200,1,12,44,22,564,45862564
33988,1125,1800200,1,12,44,23,689,45863689
33989,293,1800200,1,12,44,23,982,45863982
33990,187,1800200,1,12,44,24,169,45864169
33991,493,1800200,1,12,44,24,662,45864662
33992,1617,1800200,3,12,44,26,279,45866279
33993,66,1800200,1,12,44,26,345,45866345
33994,1872,1800200,1,12,44,28,217,45868217
33995,40,1800200,1,12,44,28,257,45868257
33996,0,1800200,8,12,44,28,257,45868257
33997,0,1800200,7,12,44,28,257,45868257
33998,0,1800200,1,12,44,28,257,45868257
33999,0,1800200,15,12,44,28,257,45868257
34000,279,1800400,1,12,44,28,536,45868536
34002,2,1800500,8,12,44,28,538,45868538
34003,59,1800600,1,12,44,28,597,45868597
34004,1248,1800600,1,12,44,29,845,45869845
34005,492,1800600,1,12,44,30,337,45870337
34006,681,1800600,2,12,44,31,18,45871018
34007,145,1800600,1,12,44,31,163,45871163
34008,448,1800500,1,12,44,31,611,45871611
34009,1250,1800500,5,12,44,32,861,45872861
34011,48,1800300,1,12,44,32,909,45872909
34012,26,1800300,1,12,44,32,935,45872935
34013,450,1800300,3,12,44,33,385,45873385
34014,2059,1800300,1,12,44,35,444,45875444
34015,4209,1800400,2,12,44,39,653,45879653
34016,231,1800400,3,12,44,39,884,45879884
34017,4056,1800400,1,12,44,43,940,45883940
34018,230,1800300,1,12,44,44,170,45884170
34019,2743,1800300,1,12,44,46,913,45886913
34020,594,1800400,1,12,44,47,507,45887507
34021,2905,1800400,2,12,44,50,412,45890412
34022,0,1800400,1,12,44,50,412,45890412
34023,204,1800400,1,12,44,50,616,45890616
34024,25,1800400,2,12,44,50,641,45890641
34025,189,1800400,15,12,44,50,830,45890830
34026,1,1800400,1,12,44,50,831,45890831
34027,0,1800400,1,12,44,50,831,45890831
34028,0,1800400,11,12,44,50,831,45890831
34029,0,1800400,1,12,44,50,831,45890831
34030,0,1800400,2,12,44,50,831,45890831
34031,1,1800400,1,12,44,50,832,45890832
34032,0,1800400,1,12,44,50,832,45890832
34033,0,1800400,1,12,44,50,832,45890832
34034,41,1800400,1,12,44,50,873,45890873
34035,713,1800500,1,12,44,51,586,45891586
34036,0,1800500,1,12,44,51,586,45891586
34037,3,1800400,3,12,44,51,589,45891589
34039,215,1800300,1,12,44,51,804,45891804
34040,1966,1800300,1,12,44,53,770,45893770
34041,2052,1800400,1,12,44,55,822,45895822
34042,1133,1800400,1,12,44,56,955,45896955
34043,977,1800400,1,12,44,57,932,45897932
34044,63,1800500,1,12,44,57,995,45897995
34045,2819,1800400,1,12,45,0,814,45900814
34046,152,1800400,2,12,45,0,966,45900966
34047,42,1800300,2,12,45,1,8,45901008
34048,75,1800400,1,12,45,1,83,45901083
34049,2,1800300,1,12,45,1,85,45901085
34050,1,1800300,1,12,45,1,86,45901086
34051,17,1800300,2,12,45,1,103,45901103
34052,20,1800200,1,12,45,1,123,45901123
34053,59,1800400,1,12,45,1,182,45901182
34054,28,1800200,1,12,45,1,210,45901210
34055,2,1800200,2,12,45,1,212,45901212
34056,229,1800300,2,12,45,1,441,45901441
34057,81,1800200,2,12,45,1,522,45901522
34058,9,1800200,1,12,45,1,531,45901531
34059,16,1800200,2,12,45,1,547,45901547
34060,92,1800200,2,12,45,1,639,45901639
34061,0,1800200,5,12,45,1,639,45901639
34062,1,1800200,1,12,45,1,640,45901640
34063,0,1800200,1,12,45,1,640,45901640
34064,0,1800200,3,12,45,1,640,45901640
34065,0,1800200,2,12,45,1,640,45901640
34066,0,1800200,1,12,45,1,640,45901640
34067,20,1800300,1,12,45,1,660,45901660
34068,0,1800300,1,12,45,1,660,45901660
34069,13,1800300,2,12,45,1,673,45901673
34070,12,1800300,1,12,45,1,685,45901685
34071,17,1800300,1,12,45,1,702,45901702
34072,104,1800300,1,12,45,1,806,45901806
34073,72,1800300,1,12,45,1,878,45901878
34074,4,1800300,2,12,45,1,882,45901882
34075,6,1800300,1,12,45,1,888,45901888
34076,0,1800300,3,12,45,1,888,45901888
34077,1166,1800300,1,12,45,3,54,45903054
34078,301,1800400,1,12,45,3,355,45903355
34079,168,1800200,1,12,45,3,523,45903523
34080,347,1800200,1,12,45,3,870,45903870
34081,23,1800300,2,12,45,3,893,45903893
34083,426,1800300,1,12,45,4,319,45904319
34084,142,1800300,1,12,45,4,461,45904461
34085,973,1800200,1,12,45,5,434,45905434
34086,1161,1800300,1,12,45,6,595,45906595
34087,2457,1800300,2,12,45,9,52,45909052
34088,528,1800300,1,12,45,9,580,45909580
34089,400,1800300,1,12,45,9,980,45909980
34090,96,1800300,1,12,45,10,76,45910076
34091,314,1800300,1,12,45,10,390,45910390
34092,179,1800400,3,12,45,10,569,45910569
34093,2173,1800400,1,12,45,12,742,45912742
34094,2886,1800400,1,12,45,15,628,45915628
34095,287,1800300,1,12,45,15,915,45915915
34096,546,1800400,2,12,45,16,461,45916461
34097,19,1800400,1,12,45,16,480,45916480
34098,291,1800400,2,12,45,16,771,45916771
34099,63,1800400,1,12,45,16,834,45916834
34100,302,1800400,2,12,45,17,136,45917136
34102,246,1800400,1,12,45,17,382,45917382
34103,553,1800300,4,12,45,17,935,45917935
34104,1966,1800400,1,12,45,19,901,45919901
34105,1460,1800500,3,12,45,21,361,45921361
34106,4524,1800500,1,12,45,25,885,45925885
34107,87,1800400,1,12,45,25,972,45925972
34108,304,1800500,1,12,45,26,276,45926276
34109,996,1800400,1,12,45,27,272,45927272
34110,3991,1800400,1,12,45,31,263,45931263
34111,95,1800400,1,12,45,31,358,45931358
34112,53,1800400,1,12,45,31,411,45931411
34113,3167,1800400,1,12,45,34,578,45934578
34114,1552,1800400,1,12,45,36,130,45936130
34115,593,1800400,1,12,45,36,723,45936723
34116,2134,1800400,13,12,45,38,857,45938857
34117,127,1800400,1,12,45,38,984,45938984
34118,864,1800400,1,12,45,39,848,45939848
34119,1,1800400,1,12,45,39,849,45939849
34120,133,1800400,2,12,45,39,982,45939982
34121,1330,1800400,1,12,45,41,312,45941312
34122,1813,1800400,3,12,45,43,125,45943125
34123,1255,1800400,6,12,45,44,380,45944380
34124,872,1800500,1,12,45,45,252,45945252
34125,112,1800500,1,12,45,45,364,45945364
34126,1284,1800400,2,12,45,46,648,45946648
34127,595,1800500,3,12,45,47,243,45947243
34128,64,1800500,1,12,45,47,307,45947307
34129,1300,1800500,1,12,45,48,607,45948607
34130,0,1800500,1,12,45,48,607,45948607
34131,92,1800500,2,12,45,48,699,45948699
34132,205,1800400,1,12,45,48,904,45948904
34133,357,1800400,1,12,45,49,261,45949261
34134,314,1800500,1,12,45,49,575,45949575
34135,2078,1800400,1,12,45,51,653,45951653
34136,682,1800500,1,12,45,52,335,45952335
34137,644,1800500,3,12,45,52,979,45952979
34138,76,1800500,1,12,45,53,55,45953055
34139,0,1800500,1,12,45,53,55,45953055
34140,0,1800500,1,12,45,53,55,45953055
34141,1,1800500,7,12,45,53,56,45953056
34142,482,1800500,5,12,45,53,538,45953538
34143,905,1800400,1,12,45,54,443,45954443
34144,873,1800500,1,12,45,55,316,45955316
34145,1370,1800600,1,12,45,56,686,45956686
34146,1610,1800500,1,12,45,58,296,45958296
34147,1484,1800600,1,12,45,59,780,45959780
34148,3042,1800500,1,12,46,2,822,45962822
34149,533,1800500,1,12,46,3,355,45963355
34150,120,1800600,1,12,46,3,475,45963475
34151,0,1800600,1,12,46,3,475,45963475
34152,0,1800600,1,12,46,3,475,45963475
34153,0,1800600,1,12,46,3,475,45963475
34154,0,1800600,1,12,46,3,475,45963475
34155,1,1800600,1,12,46,3,476,45963476
34156,0,1800600,1,12,46,3,476,45963476
34157,452,1800500,1,12,46,3,928,45963928
34158,817,1800600,2,12,46,4,745,45964745
34159,15,1800600,1,12,46,4,760,45964760
34160,89,1800600,1,12,46,4,849,45964849
34161,63,1800600,1,12,46,4,912,45964912
34162,125,1800600,2,12,46,5,37,45965037
34163,856,1800600,1,12,46,5,893,45965893
34164,29,1800600,1,12,46,5,922,45965922
34165,11,1800600,1,12,46,5,933,45965933
34166,15,1800600,2,12,46,5,948,45965948
34167,1,1800600,1,12,46,5,949,45965949
34168,1,1800600,3,12,46,5,950,45965950
34169,0,1800600,1,12,46,5,950,45965950
34170,0,1800600,2,12,46,5,950,45965950
34171,0,1800600,1,12,46,5,950,45965950
34172,0,1800600,3,12,46,5,950,45965950
34173,1558,1800700,1,12,46,7,508,45967508
34174,153,1800700,2,12,46,7,661,45967661
34175,362,1800700,1,12,46,8,23,45968023
34176,0,1800700,1,12,46,8,23,45968023
34177,77,1800700,1,12,46,8,100,45968100
34178,1,1800700,1,12,46,8,101,45968101
34179,1046,1800800,2,12,46,9,147,45969147
34180,134,1800800,5,12,46,9,281,45969281
34181,4,1800800,2,12,46,9,285,45969285
34182,3,1800800,1,12,46,9,288,45969288
34183,397,1800800,2,12,46,9,685,45969685
34184,967,1800700,1,12,46,10,652,45970652
34185,1,1800700,2,12,46,10,653,45970653
34186,3366,1800600,1,12,46,14,19,45974019
34187,905,1800700,2,12,46,14,924,45974924
34188,1507,1800800,2,12,46,16,431,45976431
34189,236,1800700,1,12,46,16,667,45976667
34190,145,1800800,1,12,46,16,812,45976812
34191,122,1800800,5,12,46,16,934,45976934
34192,411,1800800,3,12,46,17,345,45977345
34193,5,1800900,1,12,46,17,350,45977350
34194,0,1800900,1,12,46,17,350,45977350
34195,1,1800900,1,12,46,17,351,45977351
34196,148,1800900,5,12,46,17,499,45977499
34197,35,1800900,2,12,46,17,534,45977534
34198,202,1800900,1,12,46,17,736,45977736
34199,1214,1800900,3,12,46,18,950,45978950
34200,42,1800900,1,12,46,18,992,45978992
34201,11,1800900,1,12,46,19,3,45979003
34202,991,1800900,1,12,46,19,994,45979994
34203,5,1800900,1,12,46,19,999,45979999
34204,21,1800900,1,12,46,20,20,45980020
34205,58,1801000,1,12,46,20,78,45980078
34206,49,1801000,2,12,46,20,127,45980127
34207,18,1801000,1,12,46,20,145,45980145
34208,5,1801000,1,12,46,20,150,45980150
34209,11,1801000,2,12,46,20,161,45980161
34210,14,1801000,1,12,46,20,175,45980175
34211,16,1801000,1,12,46,20,191,45980191
34212,8,1801000,1,12,46,20,199,45980199
34213,1,1801000,1,12,46,20,200,45980200
34214,11,1801000,1,12,46,20,211,45980211
34215,13,1801000,1,12,46,20,224,45980224
34216,21,1801000,1,12,46,20,245,45980245
34217,10,1801000,2,12,46,20,255,45980255
34218,1,1801000,7,12,46,20,256,45980256
34219,0,1801000,4,12,46,20,256,45980256
34220,48,1801100,1,12,46,20,304,45980304
34221,64,1801100,2,12,46,20,368,45980368
34223,45,1801200,2,12,46,20,413,45980413
34224,59,1801100,1,12,46,20,472,45980472
34225,5,1801200,1,12,46,20,477,45980477
34226,54,1801200,1,12,46,20,531,45980531
34227,6,1801200,1,12,46,20,537,45980537
34228,14,1801200,1,12,46,20,551,45980551
34229,55,1801200,1,12,46,20,606,45980606
34230,94,1801200,1,12,46,20,700,45980700
34231,8,1801200,1,12,46,20,708,45980708
34232,14,1801200,1,12,46,20,722,45980722
34233,30,1801200,1,12,46,20,752,45980752
34234,28,1801200,1,12,46,20,780,45980780
34235,588,1801200,1,12,46,21,368,45981368
34236,36,1801200,1,12,46,21,404,45981404
34237,16,1801200,1,12,46,21,420,45981420
34238,19,1801200,1,12,46,21,439,45981439
34239,161,1801300,1,12,46,21,600,45981600
34240,19,1801300,1,12,46,21,619,45981619
34241,50,1801200,2,12,46,21,669,45981669
34242,119,1801200,2,12,46,21,788,45981788
34243,47,1801100,1,12,46,21,835,45981835
34244,207,1801200,3,12,46,22,42,45982042
34245,2,1801200,7,12,46,22,44,45982044
34246,218,1801200,2,12,46,22,262,45982262
34248,116,1801100,1,12,46,22,378,45982378
34249,41,1801300,2,12,46,22,419,45982419
34250,89,1801300,1,12,46,22,508,45982508
34251,68,1801300,1,12,46,22,576,45982576
34252,362,1801100,3,12,46,22,938,45982938
34253,26,1801100,1,12,46,22,964,45982964
34254,43,1801200,1,12,46,23,7,45983007
34255,57,1801200,6,12,46,23,64,45983064
34256,252,1801200,4,12,46,23,316,45983316
34257,528,1801200,1,12,46,23,844,45983844
34258,28,1801200,1,12,46,23,872,45983872
34259,0,1801100,1,12,46,23,872,45983872
34260,179,1801100,1,12,46,24,51,45984051
34261,367,1801100,2,12,46,24,418,45984418
34263,601,1801200,1,12,46,25,19,45985019
34264,13,1801200,1,12,46,25,32,45985032
34265,19,1801200,1,12,46,25,51,45985051
34266,16,1801200,2,12,46,25,67,45985067
34267,64,1801200,1,12,46,25,131,45985131
34268,121,1801300,5,12,46,25,252,45985252
34269,241,1801200,1,12,46,25,493,45985493
34270,228,1801200,5,12,46,25,721,45985721
34271,1359,1801300,1,12,46,27,80,45987080
34272,461,1801300,1,12,46,27,541,45987541
34273,186,1801300,1,12,46,27,727,45987727
34274,40,1801200,10,12,46,27,767,45987767
34275,0,1801200,10,12,46,27,767,45987767
34277,3,1801000,2,12,46,27,770,45987770
34278,1,1801000,23,12,46,27,771,45987771
34279,5,1801100,1,12,46,27,776,45987776
34280,54,1800900,5,12,46,27,830,45987830
34281,7,1800900,2,12,46,27,837,45987837
34282,35,1800900,1,12,46,27,872,45987872
34283,152,1801000,1,12,46,28,24,45988024
34284,4,1801100,1,12,46,28,28,45988028
34285,72,1801100,1,12,46,28,100,45988100
34286,0,1801100,1,12,46,28,100,45988100
34287,1,1801100,1,12,46,28,101,45988101
34288,0,1801100,1,12,46,28,101,45988101
34289,60,1801100,1,12,46,28,161,45988161
34290,100,1801100,1,12,46,28,261,45988261
34291,67,1801100,1,12,46,28,328,45988328
34292,64,1801100,1,12,46,28,392,45988392
34293,70,1801100,1,12,46,28,462,45988462
34294,73,1801100,1,12,46,28,535,45988535
34295,185,1801100,1,12,46,28,720,45988720
34296,114,1801000,1,12,46,28,834,45988834
34297,127,1801100,1,12,46,28,961,45988961
34298,66,1801100,1,12,46,29,27,45989027
34299,400,1801100,1,12,46,29,427,45989427
34300,212,1801100,1,12,46,29,639,45989639
34301,346,1801000,1,12,46,29,985,45989985
34302,88,1801100,5,12,46,30,73,45990073
34303,311,1801000,3,12,46,30,384,45990384
34304,1302,1801100,2,12,46,31,686,45991686
34305,892,1800900,1,12,46,32,578,45992578
34306,299,1801100,3,12,46,32,877,45992877
34307,230,1800900,10,12,46,33,107,45993107
34308,52,1800900,5,12,46,33,159,45993159
34310,3,1800900,1,12,46,33,162,45993162
34311,474,1800900,2,12,46,33,636,45993636
34312,578,1801000,1,12,46,34,214,45994214
34313,601,1801000,1,12,46,34,815,45994815
34314,207,1801000,1,12,46,35,22,45995022
34315,2379,1800900,2,12,46,37,401,45997401
34316,584,1800800,15,12,46,37,985,45997985
34317,3,1800800,14,12,46,37,988,45997988
34318,66,1800900,2,12,46,38,54,45998054
34319,47,1801000,1,12,46,38,101,45998101
34320,0,1801000,1,12,46,38,101,45998101
34321,1825,1800800,2,12,46,39,926,45999926
34322,98,1801000,2,12,46,40,24,46000024
34323,842,1801000,2,12,46,40,866,46000866
34324,621,1800900,5,12,46,41,487,46001487
34325,1735,1800800,1,12,46,43,222,46003222
34326,83,1800900,9,12,46,43,305,46003305
34327,973,1801000,2,12,46,44,278,46004278
34328,2823,1800800,1,12,46,47,101,46007101
34329,1410,1800800,1,12,46,48,511,46008511
34330,614,1800900,1,12,46,49,125,46009125
34331,877,1800900,1,12,46,50,2,46010002
34332,3033,1800900,1,12,46,53,35,46013035
34333,128,1800800,6,12,46,53,163,46013163
34334,3,1800800,8,12,46,53,166,46013166
34335,334,1800900,1,12,46,53,500,46013500
34336,429,1800800,1,12,46,53,929,46013929
34337,1295,1800800,1,12,46,55,224,46015224
34338,32,1800900,3,12,46,55,256,46015256
34339,1,1800900,1,12,46,55,257,46015257
34340,1547,1800900,1,12,46,56,804,46016804
34341,1,1800900,1,12,46,56,805,46016805
34342,1057,1800900,1,12,46,57,862,46017862
34343,964,1800900,2,12,46,58,826,46018826
34344,79,1800900,1,12,46,58,905,46018905
34345,331,1800900,1,12,46,59,236,46019236
34346,470,1800900,2,12,46,59,706,46019706
34347,280,1800800,1,12,46,59,986,46019986
34348,800,1800900,1,12,47,0,786,46020786
34349,254,1801000,10,12,47,1,40,46021040
34350,350,1800900,1,12,47,1,390,46021390
34351,1143,1801000,2,12,47,2,533,46022533
34352,1378,1800900,1,12,47,3,911,46023911
34353,5998,1800900,1,12,47,9,909,46029909
34354,1235,1800900,2,12,47,11,144,46031144
34355,488,1800900,1,12,47,11,632,46031632
34356,813,1800900,5,12,47,12,445,46032445
34357,2,1800900,1,12,47,12,447,46032447
34358,1124,1800900,1,12,47,13,571,46033571
34359,8336,1800900,1,12,47,21,907,46041907
34360,2020,1801000,1,12,47,23,927,46043927
34361,2195,1800900,1,12,47,26,122,46046122
34362,780,1800900,1,12,47,26,902,46046902
34363,1760,1800900,1,12,47,28,662,46048662
34364,3844,1800900,1,12,47,32,506,46052506
34365,861,1800900,2,12,47,33,367,46053367
34366,5292,1800900,8,12,47,38,659,46058659
34368,73,1800900,1,12,47,38,732,46058732
34369,1366,1800800,1,12,47,40,98,46060098
34370,1514,1800800,1,12,47,41,612,46061612
34371,0,1800800,2,12,47,41,612,46061612
34372,0,1800800,20,12,47,41,612,46061612
34373,200,1800700,1,12,47,41,812,46061812
34374,88,1800700,1,12,47,41,900,46061900
34375,222,1800800,1,12,47,42,122,46062122
34376,1183,1800700,1,12,47,43,305,46063305
34377,48,1800700,1,12,47,43,353,46063353
34378,1375,1800700,2,12,47,44,728,46064728
34379,0,1800700,5,12,47,44,728,46064728
34380,71,1800700,1,12,47,44,799,46064799
34381,1173,1800600,2,12,47,45,972,46065972
34382,0,1800600,2,12,47,45,972,46065972
34383,0,1800600,1,12,47,45,972,46065972
34384,0,1800600,1,12,47,45,972,46065972
34385,0,1800600,2,12,47,45,972,46065972
34386,1,1800600,1,12,47,45,973,46065973
34387,39,1800500,1,12,47,46,12,46066012
34388,7,1800500,1,12,47,46,19,46066019
34389,14,1800500,10,12,47,46,33,46066033
34390,1283,1800500,1,12,47,47,316,46067316
34391,2552,1800500,1,12,47,49,868,46069868
34392,128,1800500,1,12,47,49,996,46069996
34393,2074,1800500,2,12,47,52,70,46072070
34394,767,1800400,1,12,47,52,837,46072837
34395,63,1800400,2,12,47,52,900,46072900
34396,1579,1800600,1,12,47,54,479,46074479
34397,3664,1800600,2,12,47,58,143,46078143
34398,376,1800500,1,12,47,58,519,46078519
34399,172,1800500,1,12,47,58,691,46078691
34400,1114,1800600,1,12,47,59,805,46079805
34401,3073,1800600,1,12,48,2,878,46082878
34402,58,1800500,1,12,48,2,936,46082936
34403,3247,1800500,3,12,48,6,183,46086183
34404,71,1800500,1,12,48,6,254,46086254
34405,2146,1800500,3,12,48,8,400,46088400
34406,107,1800500,1,12,48,8,507,46088507
34407,68,1800500,2,12,48,8,575,46088575
34408,925,1800500,1,12,48,9,500,46089500
34409,2076,1800500,1,12,48,11,576,46091576
34410,623,1800400,10,12,48,12,199,46092199
34411,87,1800400,4,12,48,12,286,46092286
34412,272,1800400,7,12,48,12,558,46092558
34413,66,1800400,1,12,48,12,624,46092624
34414,1064,1800400,1,12,48,13,688,46093688
34415,943,1800400,1,12,48,14,631,46094631
34416,164,1800400,1,12,48,14,795,46094795
34417,1810,1800400,1,12,48,16,605,46096605
34418,1,1800400,1,12,48,16,606,46096606
34419,1449,1800400,1,12,48,18,55,46098055
34421,873,1800300,3,12,48,18,928,46098928
34422,3103,1800300,1,12,48,22,31,46102031
34423,547,1800300,1,12,48,22,578,46102578
34424,2921,1800300,1,12,48,25,499,46105499
34425,384,1800300,1,12,48,25,883,46105883
34426,1022,1800300,1,12,48,26,905,46106905
34427,1375,1800300,1,12,48,28,280,46108280
34428,1279,1800300,1,12,48,29,559,46109559
34429,309,1800300,1,12,48,29,868,46109868
34430,152,1800300,1,12,48,30,20,46110020
34431,188,1800200,1,12,48,30,208,46110208
34432,2298,1800200,6,12,48,32,506,46112506
34433,1,1800200,7,12,48,32,507,46112507
34434,0,1800200,1,12,48,32,507,46112507
34435,925,1800200,1,12,48,33,432,46113432
34436,671,1800200,1,12,48,34,103,46114103
34437,659,1800200,7,12,48,34,762,46114762
34439,183,1800100,2,12,48,34,945,46114945
34440,14,1800100,1,12,48,34,959,46114959
34441,82,1800100,4,12,48,35,41,46115041
34442,1009,1800100,4,12,48,36,50,46116050
34443,552,1800100,1,12,48,36,602,46116602
34444,68,1800100,2,12,48,36,670,46116670
34445,314,1800100,1,12,48,36,984,46116984
34446,254,1800100,1,12,48,37,238,46117238
34447,527,1800100,1,12,48,37,765,46117765
34448,1734,1800100,1,12,48,39,499,46119499
34449,3291,1800000,2,12,48,42,790,46122790
34450,65,1800000,1,12,48,42,855,46122855
34451,33,1800000,1,12,48,42,888,46122888
34452,53,1800000,1,12,48,42,941,46122941
34453,126,1800000,1,12,48,43,67,46123067
34454,16,1800000,1,12,48,43,83,46123083
34455,789,1800000,2,12,48,43,872,46123872
34456,40,1800100,1,12,48,43,912,46123912
34457,76,1800100,1,12,48,43,988,46123988
34458,1,1800100,1,12,48,43,989,46123989
34459,0,1800100,4,12,48,43,989,46123989
34460,0,1800100,1,12,48,43,989,46123989
34461,5350,1800100,1,12,48,49,339,46129339
34462,2937,1800100,1,12,48,52,276,46132276
34463,555,1800100,1,12,48,52,831,46132831
34464,2625,1800200,2,12,48,55,456,46135456
34465,106,1800100,1,12,48,55,562,46135562
34466,79,1800200,1,12,48,55,641,46135641
34467,1011,1800200,2,12,48,56,652,46136652
34468,88,1800200,3,12,48,56,740,46136740
34469,762,1800200,1,12,48,57,502,46137502
34470,407,1800200,1,12,48,57,909,46137909
34471,2624,1800300,3,12,49,0,533,46140533
34472,689,1800200,1,12,49,1,222,46141222
34473,226,1800200,2,12,49,1,448,46141448
34474,174,1800200,3,12,49,1,622,46141622
34475,497,1800200,1,12,49,2,119,46142119
34477,1647,1800200,2,12,49,3,766,46143766
34478,1527,1800100,1,12,49,5,293,46145293
34479,819,1800200,1,12,49,6,112,46146112
34480,655,1800200,1,12,49,6,767,46146767
34481,137,1800300,1,12,49,6,904,46146904
34482,2007,1800200,1,12,49,8,911,46148911
34483,589,1800300,1,12,49,9,500,46149500
34484,342,1800300,1,12,49,9,842,46149842
34485,1,1800300,8,12,49,9,843,46149843
34486,0,1800300,1,12,49,9,843,46149843
34487,0,1800300,1,12,49,9,843,46149843
34488,647,1800300,1,12,49,10,490,46150490
34489,1118,1800400,1,12,49,11,608,46151608
34490,224,1800300,1,12,49,11,832,46151832
34491,1635,1800400,3,12,49,13,467,46153467
34492,360,1800400,3,12,49,13,827,46153827
34493,269,1800300,1,12,49,14,96,46154096
34494,1386,1800400,1,12,49,15,482,46155482
34495,868,1800400,1,12,49,16,350,46156350
34496,4365,1800300,8,12,49,20,715,46160715
34497,1482,1800200,2,12,49,22,197,46162197
34498,2340,1800200,2,12,49,24,537,46164537
34499,6644,1800100,1,12,49,31,181,46171181
34500,42,1800200,1,12,49,31,223,46171223
34501,1367,1800100,2,12,49,32,590,46172590
34502,0,1800100,1,12,49,32,590,46172590
34503,196,1800100,2,12,49,32,786,46172786
34504,1,1800100,1,12,49,32,787,46172787
34505,0,1800100,3,12,49,32,787,46172787
34506,0,1800100,6,12,49,32,787,46172787
34507,57,1800100,1,12,49,32,844,46172844
34508,1920,1800100,1,12,49,34,764,46174764
34510,3664,1800100,6,12,49,38,428,46178428
34511,60,1800100,1,12,49,38,488,46178488
34512,1486,1800000,2,12,49,39,974,46179974
34513,84,1800000,12,12,49,40,58,46180058
34514,57,1799900,2,12,49,40,115,46180115
34515,135,1799900,2,12,49,40,250,46180250
34516,15,1800000,3,12,49,40,265,46180265
34517,78,1799900,1,12,49,40,343,46180343
34518,73,1799900,1,12,49,40,416,46180416
34519,2625,1799900,1,12,49,43,41,46183041
34520,123,1799900,1,12,49,43,164,46183164
34521,148,1799900,1,12,49,43,312,46183312
34523,2108,1799800,9,12,49,45,420,46185420
34524,583,1799700,1,12,49,46,3,46186003
34525,166,1799700,1,12,49,46,169,46186169
34526,196,1799700,1,12,49,46,365,46186365
34527,1710,1799700,1,12,49,48,75,46188075
34528,129,1799800,1,12,49,48,204,46188204
34529,621,1799700,4,12,49,48,825,46188825
34530,233,1799700,1,12,49,49,58,46189058
34531,657,1799700,1,12,49,49,715,46189715
34532,1291,1799700,3,12,49,51,6,46191006
34533,53,1799700,1,12,49,51,59,46191059
34534,990,1799700,1,12,49,52,49,46192049
34535,348,1799700,1,12,49,52,397,46192397
34536,1857,1799600,4,12,49,54,254,46194254
34537,1869,1799600,1,12,49,56,123,46196123
34538,60,1799600,1,12,49,56,183,46196183
34539,1034,1799600,12,12,49,57,217,46197217
34540,1657,1799500,1,12,49,58,874,46198874
34541,175,1799500,1,12,49,59,49,46199049
34542,72,1799500,1,12,49,59,121,46199121
34543,151,1799500,2,12,49,59,272,46199272
34544,28,1799500,6,12,49,59,300,46199300
34545,1220,1799500,3,12,50,0,520,46200520
34546,1,1799500,2,12,50,0,521,46200521
34547,68,1799500,1,12,50,0,589,46200589
34548,2,1799500,4,12,50,0,591,46200591
34549,363,1799400,3,12,50,0,954,46200954
34550,5,1799400,10,12,50,0,959,46200959
34551,15,1799400,1,12,50,0,974,46200974
34552,7,1799300,6,12,50,0,981,46200981
34553,63,1799300,1,12,50,1,44,46201044
34554,124,1799300,1,12,50,1,168,46201168
34555,15,1799300,5,12,50,1,183,46201183
34556,58,1799300,1,12,50,1,241,46201241
34557,63,1799300,1,12,50,1,304,46201304
34558,0,1799300,1,12,50,1,304,46201304
34559,0,1799300,1,12,50,1,304,46201304
34560,1,1799200,2,12,50,1,305,46201305
34561,100,1799200,1,12,50,1,405,46201405
34562,8,1799300,1,12,50,1,413,46201413
34563,17,1799200,1,12,50,1,430,46201430
34564,14,1799200,1,12,50,1,444,46201444
34565,15,1799200,1,12,50,1,459,46201459
34566,1,1799200,1,12,50,1,460,46201460
34567,31,1799200,1,12,50,1,491,46201491
34568,88,1799400,1,12,50,1,579,46201579
34569,88,1799400,1,12,50,1,667,46201667
34570,352,1799300,2,12,50,2,19,46202019
34571,223,1799200,4,12,50,2,242,46202242
34572,269,1799300,1,12,50,2,511,46202511
34573,205,1799300,1,12,50,2,716,46202716
34574,480,1799200,3,12,50,3,196,46203196
34575,2066,1799300,3,12,50,5,262,46205262
34576,94,1799400,1,12,50,5,356,46205356
34577,33,1799400,1,12,50,5,389,46205389
34578,41,1799400,1,12,50,5,430,46205430
34579,561,1799300,1,12,50,5,991,46205991
34580,132,1799500,1,12,50,6,123,46206123
34581,50,1799500,1,12,50,6,173,46206173
34582,150,1799400,2,12,50,6,323,46206323
34583,814,1799400,1,12,50,7,137,46207137
34584,79,1799500,3,12,50,7,216,46207216
34585,262,1799400,1,12,50,7,478,46207478
34586,197,1799400,1,12,50,7,675,46207675
34587,2111,1799400,1,12,50,9,786,46209786
34588,631,1799400,1,12,50,10,417,46210417
34589,2,1799400,3,12,50,10,419,46210419
34590,40,1799500,2,12,50,10,459,46210459
34591,325,1799400,1,12,50,10,784,46210784
34592,982,1799400,1,12,50,11,766,46211766
34593,879,1799200,1,12,50,12,645,46212645
34594,0,1799200,1,12,50,12,645,46212645
34595,2,1799200,1,12,50,12,647,46212647
34596,20,1799200,1,12,50,12,667,46212667
34597,218,1799300,1,12,50,12,885,46212885
34598,1024,1799200,1,12,50,13,909,46213909
34599,261,1799200,1,12,50,14,170,46214170
34600,74,1799300,1,12,50,14,244,46214244
34601,204,1799300,1,12,50,14,448,46214448
34602,1310,1799200,1,12,50,15,758,46215758
34603,588,1799200,2,12,50,16,346,46216346
34604,38,1799300,8,12,50,16,384,46216384
34605,345,1799200,2,12,50,16,729,46216729
34606,920,1799300,3,12,50,17,649,46217649
34607,733,1799300,1,12,50,18,382,46218382
34608,385,1799300,2,12,50,18,767,46218767
34609,207,1799200,4,12,50,18,974,46218974
34610,179,1799300,1,12,50,19,153,46219153
34611,546,1799100,1,12,50,19,699,46219699
34612,49,1799100,4,12,50,19,748,46219748
34613,1,1799100,1,12,50,19,749,46219749
34614,45,1799100,1,12,50,19,794,46219794
34615,59,1799100,1,12,50,19,853,46219853
34616,39,1799300,1,12,50,19,892,46219892
34617,151,1799100,2,12,50,20,43,46220043
34618,194,1799100,1,12,50,20,237,46220237
34619,122,1799200,1,12,50,20,359,46220359
34620,558,1799200,1,12,50,20,917,46220917
34621,0,1799200,2,12,50,20,917,46220917
34622,155,1799100,1,12,50,21,72,46221072
34623,136,1799100,1,12,50,21,208,46221208
34624,747,1799200,1,12,50,21,955,46221955
34625,261,1799100,3,12,50,22,216,46222216
34626,260,1799100,2,12,50,22,476,46222476
34627,0,1799100,1,12,50,22,476,46222476
34628,0,1799100,4,12,50,22,476,46222476
34629,84,1799100,3,12,50,22,560,46222560
34630,50,1799000,1,12,50,22,610,46222610
34631,29,1799100,1,12,50,22,639,46222639
34632,141,1799000,1,12,50,22,780,46222780
34633,15,1799000,1,12,50,22,795,46222795
34634,42,1799000,1,12,50,22,837,46222837
34635,5,1799000,1,12,50,22,842,46222842
34636,41,1799000,1,12,50,22,883,46222883
34637,38,1799100,1,12,50,22,921,46222921
34638,1,1799100,1,12,50,22,922,46222922
34639,29,1799200,1,12,50,22,951,46222951
34640,309,1799000,14,12,50,23,260,46223260
34641,87,1799000,1,12,50,23,347,46223347
34642,348,1799000,1,12,50,23,695,46223695
34643,945,1799000,1,12,50,24,640,46224640
34644,133,1799000,1,12,50,24,773,46224773
34645,31,1799100,1,12,50,24,804,46224804
34646,269,1799000,1,12,50,25,73,46225073
34647,70,1799100,2,12,50,25,143,46225143
34648,293,1799000,1,12,50,25,436,46225436
34649,591,1799000,1,12,50,26,27,46226027
34650,178,1799000,1,12,50,26,205,46226205
34651,164,1799100,1,12,50,26,369,46226369
34652,171,1799100,4,12,50,26,540,46226540
34653,133,1799200,2,12,50,26,673,46226673
34654,250,1799100,1,12,50,26,923,46226923
34655,1004,1799200,1,12,50,27,927,46227927
34656,250,1799200,1,12,50,28,177,46228177
34657,303,1799200,1,12,50,28,480,46228480
34658,37,1799100,1,12,50,28,517,46228517
34659,378,1799100,1,12,50,28,895,46228895
34660,176,1799100,1,12,50,29,71,46229071
34661,656,1799200,1,12,50,29,727,46229727
34662,9,1799100,1,12,50,29,736,46229736
34663,1171,1799200,1,12,50,30,907,46230907
34664,189,1799100,3,12,50,31,96,46231096
34665,1,1799100,1,12,50,31,97,46231097
34666,280,1799000,1,12,50,31,377,46231377
34667,22,1799100,1,12,50,31,399,46231399
34668,185,1799000,2,12,50,31,584,46231584
34669,0,1799000,1,12,50,31,584,46231584
34670,1,1799000,1,12,50,31,585,46231585
34671,0,1799000,1,12,50,31,585,46231585
34672,0,1799000,1,12,50,31,585,46231585
34673,0,1799000,20,12,50,31,585,46231585
34674,438,1799000,1,12,50,32,23,46232023
34675,245,1798900,1,12,50,32,268,46232268
34676,101,1799100,1,12,50,32,369,46232369
34677,56,1799000,1,12,50,32,425,46232425
34678,297,1799000,1,12,50,32,722,46232722
34679,834,1799000,1,12,50,33,556,46233556
34680,333,1799000,1,12,50,33,889,46233889
34681,334,1799000,1,12,50,34,223,46234223
34682,245,1799000,1,12,50,34,468,46234468
34683,615,1799000,1,12,50,35,83,46235083
34684,105,1799000,2,12,50,35,188,46235188
34685,52,1798900,3,12,50,35,240,46235240
34686,730,1798900,1,12,50,35,970,46235970
34687,300,1799000,1,12,50,36,270,46236270
34688,561,1798900,1,12,50,36,831,46236831
34689,1075,1798900,1,12,50,37,906,46237906
34690,712,1798900,3,12,50,38,618,46238618
34691,28,1799000,1,12,50,38,646,46238646
34692,428,1798900,2,12,50,39,74,46239074
34693,37,1799000,2,12,50,39,111,46239111
34694,366,1799000,1,12,50,39,477,46239477
34695,126,1798900,1,12,50,39,603,46239603
34696,885,1798900,1,12,50,40,488,46240488
34697,979,1798900,1,12,50,41,467,46241467
34698,300,1798900,1,12,50,41,767,46241767
34699,424,1799000,1,12,50,42,191,46242191
34700,243,1799000,1,12,50,42,434,46242434
34701,11,1798900,2,12,50,42,445,46242445
34702,43,1798900,1,12,50,42,488,46242488
34703,181,1798800,10,12,50,42,669,46242669
34704,62,1798900,1,12,50,42,731,46242731
34705,65,1798800,2,12,50,42,796,46242796
34706,1,1798800,1,12,50,42,797,46242797
34707,10,1798900,2,12,50,42,807,46242807
34708,164,1798900,1,12,50,42,971,46242971
34709,80,1798800,10,12,50,43,51,46243051
34710,192,1798900,1,12,50,43,243,46243243
34711,143,1798800,10,12,50,43,386,46243386
34712,1,1798800,1,12,50,43,387,46243387
34713,0,1798800,1,12,50,43,387,46243387
34714,0,1798800,3,12,50,43,387,46243387
34715,13,1798700,1,12,50,43,400,46243400
34716,76,1798800,1,12,50,43,476,46243476
34717,30,1798700,5,12,50,43,506,46243506
34718,49,1798700,1,12,50,43,555,46243555
34719,61,1798800,2,12,50,43,616,46243616
34720,122,1798800,1,12,50,43,738,46243738
34721,57,1798800,1,12,50,43,795,46243795
34722,0,1798800,1,12,50,43,795,46243795
34723,85,1798800,4,12,50,43,880,46243880
34724,126,1798700,5,12,50,44,6,46244006
34725,36,1798800,1,12,50,44,42,46244042
34726,56,1798700,1,12,50,44,98,46244098
34727,217,1798800,1,12,50,44,315,46244315
34728,432,1798700,1,12,50,44,747,46244747
34729,1057,1798800,1,12,50,45,804,46245804
34730,656,1798800,1,12,50,46,460,46246460
34731,0,1798800,1,12,50,46,460,46246460
34732,803,1798700,1,12,50,47,263,46247263
34733,556,1798700,5,12,50,47,819,46247819
34734,291,1798700,1,12,50,48,110,46248110
34735,654,1798700,1,12,50,48,764,46248764
34736,413,1798700,1,12,50,49,177,46249177
34737,287,1798700,2,12,50,49,464,46249464
34738,304,1798700,1,12,50,49,768,46249768
34739,49,1798800,6,12,50,49,817,46249817
34740,786,1798700,2,12,50,50,603,46250603
34741,59,1798700,2,12,50,50,662,46250662
34742,841,1798700,1,12,50,51,503,46251503
34743,28,1798700,1,12,50,51,531,46251531
34744,280,1798700,1,12,50,51,811,46251811
34745,488,1798800,1,12,50,52,299,46252299
34746,398,1798700,2,12,50,52,697,46252697
34747,10,1798800,1,12,50,52,707,46252707
34748,81,1798700,1,12,50,52,788,46252788
34749,129,1798800,1,12,50,52,917,46252917
34750,664,1798800,1,12,50,53,581,46253581
34751,239,1798800,1,12,50,53,820,46253820
34752,0,1798800,1,12,50,53,820,46253820
34753,90,1798800,1,12,50,53,910,46253910
34754,175,1798800,2,12,50,54,85,46254085
34755,994,1798900,4,12,50,55,79,46255079
34756,141,1798900,1,12,50,55,220,46255220
34757,727,1798900,1,12,50,55,947,46255947
34758,407,1798900,1,12,50,56,354,46256354
34759,86,1798900,1,12,50,56,440,46256440
34760,456,1798900,2,12,50,56,896,46256896
34761,285,1799000,1,12,50,57,181,46257181
34762,0,1799000,1,12,50,57,181,46257181
34763,135,1798900,1,12,50,57,316,46257316
34764,16,1798900,3,12,50,57,332,46257332
34765,48,1799000,1,12,50,57,380,46257380
34766,78,1798900,1,12,50,57,458,46257458
34767,1213,1798900,1,12,50,58,671,46258671
34768,993,1799000,1,12,50,59,664,46259664
34769,508,1798900,2,12,51,0,172,46260172
34770,9,1798800,2,12,51,0,181,46260181
34771,305,1799000,1,12,51,0,486,46260486
34772,207,1799000,1,12,51,0,693,46260693
34773,271,1798900,1,12,51,0,964,46260964
34774,728,1798800,2,12,51,1,692,46261692
34775,316,1798800,1,12,51,2,8,46262008
34776,925,1798900,1,12,51,2,933,46262933
34777,899,1798900,1,12,51,3,832,46263832
34778,117,1798900,1,12,51,3,949,46263949
34779,1420,1798800,1,12,51,5,369,46265369
34780,36,1798900,8,12,51,5,405,46265405
34782,789,1798900,2,12,51,6,194,46266194
34783,1199,1798900,1,12,51,7,393,46267393
34784,83,1798800,1,12,51,7,476,46267476
34785,1,1798800,3,12,51,7,477,46267477
34786,543,1798800,3,12,51,8,20,46268020
34787,381,1798900,3,12,51,8,401,46268401
34789,678,1798900,2,12,51,9,79,46269079
34790,422,1798900,1,12,51,9,501,46269501
34791,191,1799000,2,12,51,9,692,46269692
34792,136,1799000,1,12,51,9,828,46269828
34793,176,1799000,1,12,51,10,4,46270004
34794,900,1798900,1,12,51,10,904,46270904
34795,253,1799000,1,12,51,11,157,46271157
34796,200,1799000,1,12,51,11,357,46271357
34797,783,1799000,42,12,51,12,140,46272140
34798,1,1799100,1,12,51,12,141,46272141
34799,0,1799100,6,12,51,12,141,46272141
34800,0,1799100,2,12,51,12,141,46272141
34801,0,1799100,4,12,51,12,141,46272141
34802,0,1799100,1,12,51,12,141,46272141
34803,2,1799200,1,12,51,12,143,46272143
34804,1,1799200,2,12,51,12,144,46272144
34805,38,1799200,1,12,51,12,182,46272182
34806,0,1799200,4,12,51,12,182,46272182
34807,167,1799200,1,12,51,12,349,46272349
34808,305,1799200,1,12,51,12,654,46272654
34809,849,1799200,1,12,51,13,503,46273503
34810,2181,1799200,1,12,51,15,684,46275684
34811,1223,1799200,1,12,51,16,907,46276907
34812,262,1799300,1,12,51,17,169,46277169
34813,56,1799200,1,12,51,17,225,46277225
34814,1,1799100,1,12,51,17,226,46277226
34815,0,1799100,1,12,51,17,226,46277226
34816,0,1799100,1,12,51,17,226,46277226
34817,1,1799100,1,12,51,17,227,46277227
34818,49,1799100,1,12,51,17,276,46277276
34819,982,1799200,1,12,51,18,258,46278258
34820,354,1799300,1,12,51,18,612,46278612
34821,1491,1799200,2,12,51,20,103,46280103
34822,2006,1799300,2,12,51,22,109,46282109
34823,3420,1799300,1,12,51,25,529,46285529
34824,2920,1799200,3,12,51,28,449,46288449
34825,459,1799200,1,12,51,28,908,46288908
34826,825,1799200,1,12,51,29,733,46289733
34827,0,1799200,1,12,51,29,733,46289733
34828,596,1799200,1,12,51,30,329,46290329
34829,1490,1799200,1,12,51,31,819,46291819
34830,341,1799300,1,12,51,32,160,46292160
34831,1819,1799200,1,12,51,33,979,46293979
34832,2348,1799300,7,12,51,36,327,46296327
34833,377,1799400,6,12,51,36,704,46296704
34834,194,1799400,1,12,51,36,898,46296898
34835,74,1799400,1,12,51,36,972,46296972
34836,97,1799500,1,12,51,37,69,46297069
34837,799,1799500,1,12,51,37,868,46297868
34838,1482,1799500,1,12,51,39,350,46299350
34839,33,1799400,1,12,51,39,383,46299383
34840,4933,1799300,4,12,51,44,316,46304316
34842,323,1799400,1,12,51,44,639,46304639
34843,619,1799300,1,12,51,45,258,46305258
34844,1,1799300,1,12,51,45,259,46305259
34845,0,1799300,1,12,51,45,259,46305259
34846,4120,1799300,1,12,51,49,379,46309379
34847,2376,1799200,1,12,51,51,755,46311755
34848,735,1799300,1,12,51,52,490,46312490
34849,355,1799400,2,12,51,52,845,46312845
34850,46,1799400,4,12,51,52,891,46312891
34851,138,1799400,1,12,51,53,29,46313029
34852,3140,1799400,2,12,51,56,169,46316169
34854,122,1799300,3,12,51,56,291,46316291
34855,1925,1799500,1,12,51,58,216,46318216
34856,542,1799500,1,12,51,58,758,46318758
34857,351,1799500,5,12,51,59,109,46319109
34858,169,1799500,1,12,51,59,278,46319278
34859,987,1799600,3,12,52,0,265,46320265
34860,885,1799500,1,12,52,1,150,46321150
34861,461,1799500,1,12,52,1,611,46321611
34862,60,1799600,1,12,52,1,671,46321671
34863,246,1799500,1,12,52,1,917,46321917
34864,1969,1799500,1,12,52,3,886,46323886
34865,3422,1799500,1,12,52,7,308,46327308
34866,2057,1799500,1,12,52,9,365,46329365
34867,111,1799400,1,12,52,9,476,46329476
34868,0,1799400,1,12,52,9,476,46329476
34869,2532,1799500,2,12,52,12,8,46332008
34870,166,1799400,1,12,52,12,174,46332174
34871,1773,1799500,3,12,52,13,947,46333947
34872,799,1799500,1,12,52,14,746,46334746
34873,180,1799400,8,12,52,14,926,46334926
34874,2081,1799500,2,12,52,17,7,46337007
34875,663,1799600,2,12,52,17,670,46337670
34876,164,1799500,1,12,52,17,834,46337834
34877,617,1799400,1,12,52,18,451,46338451
34878,24,1799400,1,12,52,18,475,46338475
34879,701,1799500,1,12,52,19,176,46339176
34880,3506,1799400,1,12,52,22,682,46342682
34881,1,1799500,2,12,52,22,683,46342683
34882,139,1799500,2,12,52,22,822,46342822
34883,1,1799500,1,12,52,22,823,46342823
34884,3871,1799500,4,12,52,26,694,46346694
34885,364,1799400,1,12,52,27,58,46347058
34886,191,1799500,1,12,52,27,249,46347249
34887,996,1799500,1,12,52,28,245,46348245
34888,1141,1799500,1,12,52,29,386,46349386
34889,28,1799500,1,12,52,29,414,46349414
34890,0,1799500,1,12,52,29,414,46349414
34891,1597,1799500,1,12,52,31,11,46351011
34892,610,1799500,2,12,52,31,621,46351621
34893,0,1799500,2,12,52,31,621,46351621
34895,243,1799300,2,12,52,31,864,46351864
34896,48,1799300,2,12,52,31,912,46351912
34897,465,1799300,2,12,52,32,377,46352377
34898,27,1799200,2,12,52,32,404,46352404
34899,129,1799400,1,12,52,32,533,46352533
34900,580,1799400,1,12,52,33,113,46353113
34901,447,1799400,2,12,52,33,560,46353560
34902,3227,1799400,1,12,52,36,787,46356787
34903,1138,1799500,2,12,52,37,925,46357925
34904,51,1799400,1,12,52,37,976,46357976
34905,917,1799400,2,12,52,38,893,46358893
34906,3995,1799400,1,12,52,42,888,46362888
34907,1020,1799400,1,12,52,43,908,46363908
34908,3344,1799400,1,12,52,47,252,46367252
34909,1234,1799400,2,12,52,48,486,46368486
34910,418,1799400,1,12,52,48,904,46368904
34911,512,1799500,5,12,52,49,416,46369416
34912,1,1799500,1,12,52,49,417,46369417
34913,4015,1799500,2,12,52,53,432,46373432
34914,1062,1799500,1,12,52,54,494,46374494
34915,2647,1799500,2,12,52,57,141,46377141
34916,537,1799600,1,12,52,57,678,46377678
34917,345,1799600,15,12,52,58,23,46378023
34918,955,1799600,1,12,52,58,978,46378978
34919,1143,1799600,1,12,53,0,121,46380121
34920,287,1799700,1,12,53,0,408,46380408
34921,0,1799600,1,12,53,0,408,46380408
34922,66,1799500,1,12,53,0,474,46380474
34923,165,1799600,1,12,53,0,639,46380639
34924,114,1799600,1,12,53,0,753,46380753
34925,56,1799600,1,12,53,0,809,46380809
34926,294,1799600,1,12,53,1,103,46381103
34927,518,1799500,1,12,53,1,621,46381621
34929,19,1799400,2,12,53,1,640,46381640
34930,386,1799600,3,12,53,2,26,46382026
34931,2097,1799400,8,12,53,4,123,46384123
34933,2967,1799400,1,12,53,7,90,46387090
34934,685,1799600,1,12,53,7,775,46387775
34935,689,1799500,2,12,53,8,464,46388464
34936,830,1799500,1,12,53,9,294,46389294
34937,559,1799600,1,12,53,9,853,46389853
34938,2581,1799500,1,12,53,12,434,46392434
34939,485,1799500,3,12,53,12,919,46392919
34940,4879,1799600,1,12,53,17,798,46397798
34941,1186,1799600,4,12,53,18,984,46398984
34942,1641,1799500,1,12,53,20,625,46400625
34943,6035,1799600,4,12,53,26,660,46406660
34944,516,1799700,4,12,53,27,176,46407176
34945,1618,1799600,1,12,53,28,794,46408794
34946,1375,1799600,1,12,53,30,169,46410169
34947,3271,1799600,1,12,53,33,440,46413440
34948,1142,1799600,1,12,53,34,582,46414582
34949,1814,1799700,5,12,53,36,396,46416396
34950,0,1799700,1,12,53,36,396,46416396
34951,0,1799700,4,12,53,36,396,46416396
34952,0,1799700,5,12,53,36,396,46416396
34953,1478,1799700,1,12,53,37,874,46417874
34954,1056,1799800,1,12,53,38,930,46418930
34955,69,1799800,5,12,53,38,999,46418999
34956,29,1799800,1,12,53,39,28,46419028
34958,2343,1799900,1,12,53,41,371,46421371
34959,574,1799900,1,12,53,41,945,46421945
34960,1364,1799900,1,12,53,43,309,46423309
34961,242,1799900,5,12,53,43,551,46423551
34962,2898,1799900,1,12,53,46,449,46426449
34963,1443,1799900,1,12,53,47,892,46427892
34964,473,1799900,1,12,53,48,365,46428365
34965,2132,1799800,3,12,53,50,497,46430497
34966,484,1799900,1,12,53,50,981,46430981
34967,1307,1799800,1,12,53,52,288,46432288
34968,826,1799900,1,12,53,53,114,46433114
34969,444,1799800,1,12,53,53,558,46433558
34970,7106,1799900,1,12,54,0,664,46440664
34971,930,1799800,1,12,54,1,594,46441594
34972,70,1799800,1,12,54,1,664,46441664
34973,2248,1799900,1,12,54,3,912,46443912
34974,1,1799900,2,12,54,3,913,46443913
34975,0,1799900,5,12,54,3,913,46443913
34976,0,1799900,2,12,54,3,913,46443913
34977,0,1799900,1,12,54,3,913,46443913
34978,0,1799900,7,12,54,3,913,46443913
34979,0,1799900,1,12,54,3,913,46443913
34980,0,1799900,8,12,54,3,913,46443913
34981,208,1799900,1,12,54,4,121,46444121
34982,3567,1799900,1,12,54,7,688,46447688
34983,304,1799900,1,12,54,7,992,46447992
34984,2527,1800000,1,12,54,10,519,46450519
34985,98,1800000,1,12,54,10,617,46450617
34986,77,1800000,1,12,54,10,694,46450694
34987,909,1800000,3,12,54,11,603,46451603
34988,182,1800000,9,12,54,11,785,46451785
34989,390,1800000,1,12,54,12,175,46452175
34990,140,1800000,1,12,54,12,315,46452315
34991,522,1800100,5,12,54,12,837,46452837
34992,150,1800100,1,12,54,12,987,46452987
34993,1024,1800100,2,12,54,14,11,46454011
34994,407,1800100,1,12,54,14,418,46454418
34995,72,1800100,2,12,54,14,490,46454490
34996,795,1800100,4,12,54,15,285,46455285
34997,185,1800100,1,12,54,15,470,46455470
34998,71,1800000,1,12,54,15,541,46455541
34999,22,1800000,5,12,54,15,563,46455563
35000,6,1800100,1,12,54,15,569,46455569
35001,439,1800000,2,12,54,16,8,46456008
35002,34,1799900,1,12,54,16,42,46456042
35003,1,1799900,9,12,54,16,43,46456043
35004,0,1799900,3,12,54,16,43,46456043
35005,0,1799900,1,12,54,16,43,46456043
35006,0,1799900,3,12,54,16,43,46456043
35007,405,1799900,3,12,54,16,448,46456448
35009,1863,1800000,1,12,54,18,311,46458311
35010,1802,1800000,1,12,54,20,113,46460113
35011,521,1799900,1,12,54,20,634,46460634
35012,1322,1800000,2,12,54,21,956,46461956
35013,1,1800000,16,12,54,21,957,46461957
35014,3326,1800100,1,12,54,25,283,46465283
35015,886,1800000,1,12,54,26,169,46466169
35016,473,1800000,2,12,54,26,642,46466642
35017,421,1800000,1,12,54,27,63,46467063
35018,61,1800000,1,12,54,27,124,46467124
35019,591,1800000,1,12,54,27,715,46467715
35020,255,1799900,1,12,54,27,970,46467970
35021,0,1799900,5,12,54,27,970,46467970
35022,297,1799900,1,12,54,28,267,46468267
35023,2718,1799900,2,12,54,30,985,46470985
35024,2684,1799900,1,12,54,33,669,46473669
35025,1,1799900,1,12,54,33,670,46473670
35026,5926,1799900,1,12,54,39,596,46479596
35027,68,1799900,1,12,54,39,664,46479664
35028,610,1799900,1,12,54,40,274,46480274
35029,472,1799900,3,12,54,40,746,46480746
35030,418,1799900,1,12,54,41,164,46481164
35031,3561,1799800,6,12,54,44,725,46484725
35032,1,1799800,1,12,54,44,726,46484726
35033,2101,1799900,1,12,54,46,827,46486827
35034,2524,1799900,1,12,54,49,351,46489351
35035,998,1799900,4,12,54,50,349,46490349
35036,2591,1799900,1,12,54,52,940,46492940
35037,2111,1799900,1,12,54,55,51,46495051
35038,2443,1800000,2,12,54,57,494,46497494
35039,686,1799900,1,12,54,58,180,46498180
35040,918,1800000,1,12,54,59,98,46499098
35041,1467,1799900,2,12,55,0,565,46500565
35042,502,1799900,1,12,55,1,67,46501067
35043,0,1799900,1,12,55,1,67,46501067
35044,1,1799900,1,12,55,1,68,46501068
35045,0,1799900,2,12,55,1,68,46501068
35046,244,1799900,1,12,55,1,312,46501312
35047,266,1799800,1,12,55,1,578,46501578
35048,172,1799800,1,12,55,1,750,46501750
35050,42,1799800,1,12,55,1,792,46501792
35051,972,1799700,2,12,55,2,764,46502764
35052,1003,1799800,2,12,55,3,767,46503767
35053,624,1799700,1,12,55,4,391,46504391
35054,2685,1799700,2,12,55,7,76,46507076
35055,1127,1799700,1,12,55,8,203,46508203
35056,747,1799700,1,12,55,8,950,46508950
35057,690,1799800,1,12,55,9,640,46509640
35058,3,1799700,2,12,55,9,643,46509643
35059,5250,1799700,1,12,55,14,893,46514893
35060,103,1799700,1,12,55,14,996,46514996
35061,557,1799800,1,12,55,15,553,46515553
35062,460,1799700,3,12,55,16,13,46516013
35063,1354,1799700,1,12,55,17,367,46517367
35064,354,1799700,2,12,55,17,721,46517721
35065,0,1799700,1,12,55,17,721,46517721
35066,1081,1799800,1,12,55,18,802,46518802
35067,5,1799800,1,12,55,18,807,46518807
35068,390,1799900,7,12,55,19,197,46519197
35069,334,1799800,3,12,55,19,531,46519531
35070,257,1800000,1,12,55,19,788,46519788
35071,731,1800000,1,12,55,20,519,46520519
35072,578,1800000,1,12,55,21,97,46521097
35073,421,1800000,1,12,55,21,518,46521518
35074,940,1799900,2,12,55,22,458,46522458
35075,0,1799900,1,12,55,22,458,46522458
35076,1343,1800000,1,12,55,23,801,46523801
35077,2154,1799900,1,12,55,25,955,46525955
35078,2709,1800000,1,12,55,28,664,46528664
35079,960,1800000,1,12,55,29,624,46529624
35080,137,1799900,2,12,55,29,761,46529761
35081,38,1800000,1,12,55,29,799,46529799
35082,301,1799900,1,12,55,30,100,46530100
35083,1096,1799900,1,12,55,31,196,46531196
35084,3247,1799900,5,12,55,34,443,46534443
35086,3585,1799900,1,12,55,38,28,46538028
35087,2873,1799900,1,12,55,40,901,46540901
35088,160,1799800,1,12,55,41,61,46541061
35089,1397,1799800,5,12,55,42,458,46542458
35090,1669,1799900,9,12,55,44,127,46544127
35092,2074,1799900,1,12,55,46,201,46546201
35093,3313,1799900,2,12,55,49,514,46549514
35094,13069,1799900,1,12,56,2,583,46562583
35095,1230,1799900,2,12,56,3,813,46563813
35096,69,1799900,1,12,56,3,882,46563882
35097,3,1799900,1,12,56,3,885,46563885
35098,6480,1799900,4,12,56,10,365,46570365
35099,74,1799900,2,12,56,10,439,46570439
35100,68,1799900,1,12,56,10,507,46570507
35101,2604,1799900,2,12,56,13,111,46573111
35102,2207,1799900,1,12,56,15,318,46575318
35103,2037,1799800,4,12,56,17,355,46577355
35104,1,1799800,5,12,56,17,356,46577356
35105,5510,1799900,1,12,56,22,866,46582866
35106,0,1799900,5,12,56,22,866,46582866
35107,41,1800000,1,12,56,22,907,46582907
35108,0,1800000,1,12,56,22,907,46582907
35109,0,1800000,2,12,56,22,907,46582907
35110,0,1800000,1,12,56,22,907,46582907
35111,51,1800000,1,12,56,22,958,46582958
35112,0,1800000,1,12,56,22,958,46582958
35113,0,1800000,18,12,56,22,958,46582958
35114,157,1800000,1,12,56,23,115,46583115
35115,95,1799900,1,12,56,23,210,46583210
35116,3845,1800000,1,12,56,27,55,46587055
35117,4037,1800100,4,12,56,31,92,46591092
35118,1022,1800000,1,12,56,32,114,46592114
35119,1524,1800100,5,12,56,33,638,46593638
35120,2,1800200,16,12,56,33,640,46593640
35121,91,1800300,6,12,56,33,731,46593731
35122,146,1800400,1,12,56,33,877,46593877
35123,38,1800400,1,12,56,33,915,46593915
35124,61,1800300,1,12,56,33,976,46593976
35125,37,1800400,1,12,56,34,13,46594013
35126,250,1800400,1,12,56,34,263,46594263
35127,51,1800400,1,12,56,34,314,46594314
35128,323,1800400,1,12,56,34,637,46594637
35129,263,1800400,2,12,56,34,900,46594900
35130,253,1800400,6,12,56,35,153,46595153
35132,142,1800400,1,12,56,35,295,46595295
35133,41,1800400,1,12,56,35,336,46595336
35134,1124,1800400,3,12,56,36,460,46596460
35136,12,1800300,1,12,56,36,472,46596472
35137,3817,1800400,1,12,56,40,289,46600289
35138,2602,1800400,2,12,56,42,891,46602891
35139,196,1800400,1,12,56,43,87,46603087
35140,87,1800500,5,12,56,43,174,46603174
35141,64,1800400,9,12,56,43,238,46603238
35142,148,1800300,1,12,56,43,386,46603386
35143,738,1800400,2,12,56,44,124,46604124
35144,627,1800400,4,12,56,44,751,46604751
35146,3682,1800400,1,12,56,48,433,46608433
35147,1212,1800500,2,12,56,49,645,46609645
35148,1244,1800500,1,12,56,50,889,46610889
35149,710,1800500,1,12,56,51,599,46611599
35150,68,1800500,1,12,56,51,667,46611667
35151,422,1800500,2,12,56,52,89,46612089
35152,939,1800500,1,12,56,53,28,46613028
35153,312,1800400,1,12,56,53,340,46613340
35154,243,1800500,1,12,56,53,583,46613583
35155,291,1800500,1,12,56,53,874,46613874
35156,406,1800400,1,12,56,54,280,46614280
35157,1218,1800500,2,12,56,55,498,46615498
35158,4033,1800600,1,12,56,59,531,46619531
35159,131,1800600,1,12,56,59,662,46619662
35160,75,1800600,1,12,56,59,737,46619737
35161,227,1800500,4,12,56,59,964,46619964
35162,464,1800600,2,12,57,0,428,46620428
35163,77,1800500,2,12,57,0,505,46620505
35164,0,1800500,2,12,57,0,505,46620505
35165,3,1800400,2,12,57,0,508,46620508
35166,69,1800500,1,12,57,0,577,46620577
35167,98,1800500,1,12,57,0,675,46620675
35168,1080,1800500,1,12,57,1,755,46621755
35169,7,1800600,5,12,57,1,762,46621762
35170,144,1800500,2,12,57,1,906,46621906
35171,43,1800500,2,12,57,1,949,46621949
35172,241,1800600,5,12,57,2,190,46622190
35173,378,1800600,1,12,57,2,568,46622568
35174,640,1800600,2,12,57,3,208,46623208
35175,181,1800600,1,12,57,3,389,46623389
35176,824,1800600,2,12,57,4,213,46624213
35177,69,1800600,1,12,57,4,282,46624282
35178,379,1800600,1,12,57,4,661,46624661
35179,3051,1800600,1,12,57,7,712,46627712
35180,2954,1800600,1,12,57,10,666,46630666
35181,635,1800600,1,12,57,11,301,46631301
35182,130,1800600,1,12,57,11,431,46631431
35183,2805,1800600,1,12,57,14,236,46634236
35184,979,1800600,1,12,57,15,215,46635215
35185,1236,1800600,1,12,57,16,451,46636451
35186,410,1800600,2,12,57,16,861,46636861
35187,2636,1800600,3,12,57,19,497,46639497
35189,1,1800500,23,12,57,19,498,46639498
35190,2,1800500,1,12,57,19,500,46639500
35191,129,1800600,3,12,57,19,629,46639629
35192,2121,1800500,1,12,57,21,750,46641750
35193,44,1800400,1,12,57,21,794,46641794
35194,0,1800400,1,12,57,21,794,46641794
35195,0,1800400,8,12,57,21,794,46641794
35196,0,1800400,1,12,57,21,794,46641794
35197,1,1800400,1,12,57,21,795,46641795
35198,978,1800500,1,12,57,22,773,46642773
35199,2335,1800300,5,12,57,25,108,46645108
35200,351,1800300,2,12,57,25,459,46645459
35201,1248,1800400,2,12,57,26,707,46646707
35202,6771,1800400,1,12,57,33,478,46653478
35203,2828,1800300,2,12,57,36,306,46656306
35204,4124,1800400,2,12,57,40,430,46660430
35206,3843,1800300,2,12,57,44,273,46664273
35207,355,1800400,1,12,57,44,628,46664628
35208,1412,1800300,2,12,57,46,40,46666040
35209,510,1800400,2,12,57,46,550,46666550
35210,2969,1800400,1,12,57,49,519,46669519
35211,2292,1800400,6,12,57,51,811,46671811
35213,576,1800300,1,12,57,52,387,46672387
35214,836,1800300,1,12,57,53,223,46673223
35215,38,1800400,1,12,57,53,261,46673261
35216,360,1800400,2,12,57,53,621,46673621
35217,3318,1800500,1,12,57,56,939,46676939
35218,80,1800500,2,12,57,57,19,46677019
35219,3175,1800500,1,12,58,0,194,46680194
35220,886,1800500,3,12,58,1,80,46681080
35221,602,1800400,1,12,58,1,682,46681682
35222,0,1800400,3,12,58,1,682,46681682
35223,1838,1800400,1,12,58,3,520,46683520
35224,2561,1800400,1,12,58,6,81,46686081
35225,2131,1800400,1,12,58,8,212,46688212
35226,1,1800400,1,12,58,8,213,46688213
35227,1378,1800500,3,12,58,9,591,46689591
35228,1,1800500,5,12,58,9,592,46689592
35229,4011,1800400,4,12,58,13,603,46693603
35230,14554,1800400,1,12,58,28,157,46708157
35231,703,1800400,1,12,58,28,860,46708860
35232,28,1800400,1,12,58,28,888,46708888
35233,680,1800400,1,12,58,29,568,46709568
35234,691,1800400,1,12,58,30,259,46710259
35235,1223,1800400,1,12,58,31,482,46711482
35236,2949,1800400,1,12,58,34,431,46714431
35237,50,1800300,1,12,58,34,481,46714481
35238,68,1800400,1,12,58,34,549,46714549
35239,1778,1800400,1,12,58,36,327,46716327
35240,35,1800300,7,12,58,36,362,46716362
35241,1392,1800300,1,12,58,37,754,46717754
35242,1056,1800300,1,12,58,38,810,46718810
35244,394,1800300,1,12,58,39,204,46719204
35245,1864,1800200,1,12,58,41,68,46721068
35246,57,1800100,1,12,58,41,125,46721125
35247,2,1800100,2,12,58,41,127,46721127
35249,50,1800000,1,12,58,41,177,46721177
35250,14,1800100,1,12,58,41,191,46721191
35251,48,1800200,3,12,58,41,239,46721239
35252,2,1800100,2,12,58,41,241,46721241
35253,25,1800000,1,12,58,41,266,46721266
35254,748,1800100,1,12,58,42,14,46722014
35255,0,1800000,3,12,58,42,14,46722014
35256,675,1800100,1,12,58,42,689,46722689
35258,591,1800200,2,12,58,43,280,46723280
35259,213,1800200,1,12,58,43,493,46723493
35260,703,1800300,3,12,58,44,196,46724196
35261,1802,1800300,3,12,58,45,998,46725998
35262,2064,1800200,1,12,58,48,62,46728062
35264,2637,1800200,1,12,58,50,699,46730699
35266,402,1800100,1,12,58,51,101,46731101
35267,7905,1800200,1,12,58,59,6,46739006
35269,554,1800100,2,12,58,59,560,46739560
35270,1321,1800200,1,12,59,0,881,46740881
35272,1972,1800100,1,12,59,2,853,46742853
35273,10,1800200,1,12,59,2,863,46742863
35274,0,1800100,1,12,59,2,863,46742863
35275,443,1800300,1,12,59,3,306,46743306
35276,2120,1800200,1,12,59,5,426,46745426
35277,487,1800300,1,12,59,5,913,46745913
35278,102,1800200,1,12,59,6,15,46746015
35279,4334,1800200,1,12,59,10,349,46750349
35280,3106,1800300,9,12,59,13,455,46753455
35281,2086,1800400,2,12,59,15,541,46755541
35282,5,1800400,10,12,59,15,546,46755546
35283,3619,1800500,1,12,59,19,165,46759165
35284,498,1800300,4,12,59,19,663,46759663
35285,8352,1800400,3,12,59,28,15,46768015
35287,2607,1800500,1,12,59,30,622,46770622
35288,1472,1800400,1,12,59,32,94,46772094
35289,1816,1800500,1,12,59,33,910,46773910
35290,6444,1800400,1,12,59,40,354,46780354
35291,0,1800400,4,12,59,40,354,46780354
35292,2993,1800300,1,12,59,43,347,46783347
35293,2080,1800200,1,12,59,45,427,46785427
35294,1,1800200,1,12,59,45,428,46785428
35295,0,1800200,1,12,59,45,428,46785428
35296,26,1800100,2,12,59,45,454,46785454
35297,1547,1800100,2,12,59,47,1,46787001
35298,6,1800000,2,12,59,47,7,46787007
35299,1225,1800000,13,12,59,48,232,46788232
35300,3,1799900,2,12,59,48,235,46788235
35301,7,1799900,3,12,59,48,242,46788242
35302,23,1799800,1,12,59,48,265,46788265
35303,23,1800000,2,12,59,48,288,46788288
35304,963,1799800,1,12,59,49,251,46789251
35305,3565,1799900,1,12,59,52,816,46792816
35306,1429,1799900,1,12,59,54,245,46794245
35307,407,1799900,1,12,59,54,652,46794652
35308,1092,1799800,1,12,59,55,744,46795744
35309,1082,1799800,1,12,59,56,826,46796826
35310,1510,1800000,3,12,59,58,336,46798336
35311,8,1800000,1,12,59,58,344,46798344
35312,433,1800000,1,12,59,58,777,46798777
35313,69,1800100,1,12,59,58,846,46798846
35314,1153,1800100,1,12,59,59,999,46799999
35315,142,1800100,1,13,0,0,141,46800141
35316,88,1800000,3,13,0,0,229,46800229
35317,2,1800000,1,13,0,0,231,46800231
35318,94,1800000,2,13,0,0,325,46800325
35320,91,1800000,3,13,0,0,416,46800416
35321,751,1800000,1,13,0,1,167,46801167
35322,94,1800000,2,13,0,1,261,46801261
35323,928,1799800,1,13,0,2,189,46802189
35324,459,1799800,5,13,0,2,648,46802648
35325,1,1799800,3,13,0,2,649,46802649
35326,23,1799700,3,13,0,2,672,46802672
35327,549,1799900,1,13,0,3,221,46803221
35328,793,1799700,9,13,0,4,14,46804014
35329,2,1799600,5,13,0,4,16,46804016
35330,1338,1799600,1,13,0,5,354,46805354
35331,2455,1799600,1,13,0,7,809,46807809
35332,245,1799600,1,13,0,8,54,46808054
35333,98,1799600,1,13,0,8,152,46808152
35334,280,1799700,2,13,0,8,432,46808432
35335,76,1799600,1,13,0,8,508,46808508
35336,492,1799600,1,13,0,9,0,46809000
35337,1459,1799700,1,13,0,10,459,46810459
35338,1,1799600,1,13,0,10,460,46810460
35339,712,1799700,1,13,0,11,172,46811172
35340,1164,1799600,1,13,0,12,336,46812336
35341,644,1799700,2,13,0,12,980,46812980
35342,358,1799700,5,13,0,13,338,46813338
35343,147,1799600,1,13,0,13,485,46813485
35344,69,1799700,1,13,0,13,554,46813554
35345,336,1799600,1,13,0,13,890,46813890
35346,524,1799700,1,13,0,14,414,46814414
35347,615,1799700,2,13,0,15,29,46815029
35348,171,1799600,6,13,0,15,200,46815200
35350,91,1799600,1,13,0,15,291,46815291
35351,89,1799600,1,13,0,15,380,46815380
35352,31,1799600,1,13,0,15,411,46815411
35353,2026,1799700,1,13,0,17,437,46817437
35354,304,1799700,2,13,0,17,741,46817741
35355,299,1799700,1,13,0,18,40,46818040
35356,548,1799600,1,13,0,18,588,46818588
35357,2600,1799700,1,13,0,21,188,46821188
35358,0,1799700,2,13,0,21,188,46821188
35359,0,1799600,7,13,0,21,188,46821188
35360,89,1799600,1,13,0,21,277,46821277
35361,101,1799600,1,13,0,21,378,46821378
35362,1429,1799500,1,13,0,22,807,46822807
35363,1,1799500,1,13,0,22,808,46822808
35364,0,1799500,8,13,0,22,808,46822808
35365,1689,1799600,5,13,0,24,497,46824497
35366,0,1799600,5,13,0,24,497,46824497
35367,0,1799600,5,13,0,24,497,46824497
35369,3,1799700,1,13,0,24,500,46824500
35370,6,1799700,1,13,0,24,506,46824506
35371,67,1799700,1,13,0,24,573,46824573
35372,69,1799700,1,13,0,24,642,46824642
35373,168,1799700,1,13,0,24,810,46824810
35374,5,1799700,1,13,0,24,815,46824815
35375,1,1799600,2,13,0,24,816,46824816
35376,90,1799700,1,13,0,24,906,46824906
35377,155,1799700,1,13,0,25,61,46825061
35379,0,1799600,4,13,0,25,61,46825061
35380,74,1799600,1,13,0,25,135,46825135
35381,805,1799600,1,13,0,25,940,46825940
35382,4116,1799700,1,13,0,30,56,46830056
35383,483,1799700,1,13,0,30,539,46830539
35384,219,1799700,2,13,0,30,758,46830758
35385,233,1799800,1,13,0,30,991,46830991
35386,0,1799800,5,13,0,30,991,46830991
35387,30,1799800,2,13,0,31,21,46831021
35388,2200,1799700,1,13,0,33,221,46833221
35389,1137,1799700,1,13,0,34,358,46834358
35390,1386,1799800,1,13,0,35,744,46835744
35391,1670,1799800,1,13,0,37,414,46837414
35392,91,1799800,1,13,0,37,505,46837505
35393,3124,1799700,5,13,0,40,629,46840629
35394,8179,1799700,1,13,0,48,808,46848808
35395,3,1799700,5,13,0,48,811,46848811
35396,6,1799600,8,13,0,48,817,46848817
35397,2,1799500,8,13,0,48,819,46848819
35398,49,1799400,2,13,0,48,868,46848868
35399,26,1799500,2,13,0,48,894,46848894
35400,54,1799500,2,13,0,48,948,46848948
35401,183,1799400,1,13,0,49,131,46849131
35402,167,1799400,1,13,0,49,298,46849298
35403,268,1799400,3,13,0,49,566,46849566
35404,2935,1799300,2,13,0,52,501,46852501
35405,100,1799300,1,13,0,52,601,46852601
35406,76,1799300,1,13,0,52,677,46852677
35407,366,1799400,1,13,0,53,43,46853043
35408,104,1799300,1,13,0,53,147,46853147
35409,337,1799300,1,13,0,53,484,46853484
35410,720,1799300,1,13,0,54,204,46854204
35411,5,1799300,1,13,0,54,209,46854209
35412,168,1799300,1,13,0,54,377,46854377
35413,878,1799200,2,13,0,55,255,46855255
35414,404,1799200,2,13,0,55,659,46855659
35415,436,1799200,1,13,0,56,95,46856095
35416,862,1799200,1,13,0,56,957,46856957
35417,934,1799300,1,13,0,57,891,46857891
35418,642,1799300,1,13,0,58,533,46858533
35419,1988,1799400,1,13,1,0,521,46860521
35420,787,1799400,1,13,1,1,308,46861308
35421,250,1799400,1,13,1,1,558,46861558
35422,174,1799300,3,13,1,1,732,46861732
35423,50,1799300,1,13,1,1,782,46861782
35424,23,1799300,1,13,1,1,805,46861805
35425,4,1799200,1,13,1,1,809,46861809
35426,45,1799200,1,13,1,1,854,46861854
35427,111,1799400,1,13,1,1,965,46861965
35428,99,1799300,1,13,1,2,64,46862064
35429,111,1799400,1,13,1,2,175,46862175
35430,1193,1799400,1,13,1,3,368,46863368
35431,0,1799400,1,13,1,3,368,46863368
35432,1,1799400,7,13,1,3,369,46863369
35433,951,1799500,2,13,1,4,320,46864320
35434,894,1799500,1,13,1,5,214,46865214
35435,64,1799600,1,13,1,5,278,46865278
35436,1272,1799600,2,13,1,6,550,46866550
35437,2,1799500,1,13,1,6,552,46866552
35438,0,1799500,1,13,1,6,552,46866552
35439,0,1799500,1,13,1,6,552,46866552
35440,300,1799500,1,13,1,6,852,46866852
35441,4206,1799500,1,13,1,11,58,46871058
35442,5242,1799500,1,13,1,16,300,46876300
35443,1829,1799500,4,13,1,18,129,46878129
35444,77,1799500,1,13,1,18,206,46878206
35445,4337,1799500,1,13,1,22,543,46882543
35446,832,1799400,1,13,1,23,375,46883375
35447,1,1799400,4,13,1,23,376,46883376
35448,0,1799300,8,13,1,23,376,46883376
35449,3673,1799200,1,13,1,27,49,46887049
35450,1452,1799200,4,13,1,28,501,46888501
35451,1747,1799300,4,13,1,30,248,46890248
35452,610,1799400,2,13,1,30,858,46890858
35453,1020,1799400,1,13,1,31,878,46891878
35454,1632,1799500,1,13,1,33,510,46893510
35455,1048,1799400,3,13,1,34,558,46894558
35456,2157,1799400,1,13,1,36,715,46896715
35458,406,1799400,1,13,1,37,121,46897121
35459,406,1799400,9,13,1,37,527,46897527
35460,881,1799500,1,13,1,38,408,46898408
35461,0,1799500,2,13,1,38,408,46898408
35462,1281,1799500,3,13,1,39,689,46899689
35464,6474,1799500,2,13,1,46,163,46906163
35465,433,1799500,1,13,1,46,596,46906596
35466,276,1799500,2,13,1,46,872,46906872
35467,1796,1799500,2,13,1,48,668,46908668
35468,0,1799500,2,13,1,48,668,46908668
35469,0,1799500,1,13,1,48,668,46908668
35470,2404,1799600,1,13,1,51,72,46911072
35471,4598,1799500,1,13,1,55,670,46915670
35472,9,1799400,10,13,1,55,679,46915679
35473,243,1799500,5,13,1,55,922,46915922
35474,213,1799400,3,13,1,56,135,46916135
35475,60,1799300,3,13,1,56,195,46916195
35476,4472,1799600,2,13,2,0,667,46920667
35477,417,1799500,3,13,2,1,84,46921084
35478,46,1799600,1,13,2,1,130,46921130
35479,396,1799500,1,13,2,1,526,46921526
35480,569,1799500,1,13,2,2,95,46922095
35481,870,1799400,3,13,2,2,965,46922965
35482,130,1799400,1,13,2,3,95,46923095
35483,6995,1799300,2,13,2,10,90,46930090
35484,2032,1799300,1,13,2,12,122,46932122
35485,883,1799300,2,13,2,13,5,46933005
35486,1,1799300,1,13,2,13,6,46933006
35487,2708,1799300,1,13,2,15,714,46935714
35488,601,1799300,3,13,2,16,315,46936315
35489,1054,1799300,1,13,2,17,369,46937369
35490,2828,1799300,1,13,2,20,197,46940197
35491,300,1799400,1,13,2,20,497,46940497
35492,815,1799400,1,13,2,21,312,46941312
35493,1835,1799400,1,13,2,23,147,46943147
35494,783,1799300,1,13,2,23,930,46943930
35495,419,1799300,1,13,2,24,349,46944349
35496,3083,1799400,1,13,2,27,432,46947432
35497,858,1799400,1,13,2,28,290,46948290
35498,1467,1799400,3,13,2,29,757,46949757
35500,72,1799300,1,13,2,29,829,46949829
35501,2087,1799400,1,13,2,31,916,46951916
35502,155,1799400,1,13,2,32,71,46952071
35503,492,1799300,1,13,2,32,563,46952563
35504,148,1799300,1,13,2,32,711,46952711
35505,852,1799400,2,13,2,33,563,46953563
35506,1431,1799300,17,13,2,34,994,46954994
35507,74,1799300,1,13,2,35,68,46955068
35508,29,1799300,1,13,2,35,97,46955097
35509,352,1799300,1,13,2,35,449,46955449
35510,154,1799400,2,13,2,35,603,46955603
35511,887,1799400,2,13,2,36,490,46956490
35512,1,1799400,1,13,2,36,491,46956491
35513,0,1799400,1,13,2,36,491,46956491
35514,4611,1799400,1,13,2,41,102,46961102
35515,751,1799400,1,13,2,41,853,46961853
35516,1180,1799400,3,13,2,43,33,46963033
35517,144,1799400,3,13,2,43,177,46963177
35518,1681,1799400,1,13,2,44,858,46964858
35520,1800,1799400,1,13,2,46,658,46966658
35521,1750,1799400,1,13,2,48,408,46968408
35522,3066,1799500,3,13,2,51,474,46971474
35523,1,1799400,1,13,2,51,475,46971475
35524,1072,1799400,1,13,2,52,547,46972547
35525,3833,1799400,1,13,2,56,380,46976380
35526,83,1799400,1,13,2,56,463,46976463
35527,914,1799400,2,13,2,57,377,46977377
35528,3,1799400,1,13,2,57,380,46977380
35529,1861,1799400,1,13,2,59,241,46979241
35530,697,1799500,1,13,2,59,938,46979938
35531,365,1799400,1,13,3,0,303,46980303
35532,755,1799500,1,13,3,1,58,46981058
35533,0,1799500,1,13,3,1,58,46981058
35534,0,1799500,4,13,3,1,58,46981058
35535,0,1799500,1,13,3,1,58,46981058
35536,34,1799400,2,13,3,1,92,46981092
35537,39,1799400,1,13,3,1,131,46981131
35538,545,1799400,1,13,3,1,676,46981676
35539,821,1799400,1,13,3,2,497,46982497
35540,1327,1799400,1,13,3,3,824,46983824
35541,2048,1799300,1,13,3,5,872,46985872
35542,1452,1799400,1,13,3,7,324,46987324
35543,1538,1799400,7,13,3,8,862,46988862
35544,99,1799500,1,13,3,8,961,46988961
35545,1184,1799400,4,13,3,10,145,46990145
35546,192,1799500,1,13,3,10,337,46990337
35547,147,1799500,1,13,3,10,484,46990484
35548,2703,1799400,1,13,3,13,187,46993187
35549,8124,1799400,1,13,3,21,311,47001311
35550,1,1799400,6,13,3,21,312,47001312
35551,100,1799400,2,13,3,21,412,47001412
35552,1703,1799400,1,13,3,23,115,47003115
35553,0,1799400,1,13,3,23,115,47003115
35554,0,1799400,1,13,3,23,115,47003115
35555,3926,1799300,15,13,3,27,41,47007041
35556,0,1799300,1,13,3,27,41,47007041
35557,167,1799300,3,13,3,27,208,47007208
35558,450,1799300,1,13,3,27,658,47007658
35559,226,1799200,1,13,3,27,884,47007884
35560,202,1799200,5,13,3,28,86,47008086
35561,75,1799200,2,13,3,28,161,47008161
35562,0,1799200,26,13,3,28,161,47008161
35563,554,1799200,1,13,3,28,715,47008715
35564,491,1799100,1,13,3,29,206,47009206
35565,88,1799100,1,13,3,29,294,47009294
35566,472,1799100,1,13,3,29,766,47009766
35567,1088,1799100,15,13,3,30,854,47010854
35568,0,1799100,15,13,3,30,854,47010854
35569,2,1799000,4,13,3,30,856,47010856
35570,191,1799000,1,13,3,31,47,47011047
35571,41,1799000,1,13,3,31,88,47011088
35572,36,1799100,1,13,3,31,124,47011124
35573,32,1799000,1,13,3,31,156,47011156
35574,623,1799000,1,13,3,31,779,47011779
35575,81,1799000,2,13,3,31,860,47011860
35576,0,1799000,1,13,3,31,860,47011860
35577,1,1799000,3,13,3,31,861,47011861
35578,0,1799000,6,13,3,31,861,47011861
35579,0,1799000,1,13,3,31,861,47011861
35580,0,1799000,13,13,3,31,861,47011861
35581,790,1798900,1,13,3,32,651,47012651
35582,140,1798900,1,13,3,32,791,47012791
35583,83,1798900,1,13,3,32,874,47012874
35584,161,1798900,1,13,3,33,35,47013035
35585,121,1798900,5,13,3,33,156,47013156
35586,6,1798900,1,13,3,33,162,47013162
35587,480,1798900,5,13,3,33,642,47013642
35588,43,1798900,3,13,3,33,685,47013685
35589,512,1798900,1,13,3,34,197,47014197
35590,56,1798800,8,13,3,34,253,47014253
35591,1,1798800,1,13,3,34,254,47014254
35592,0,1798800,1,13,3,34,254,47014254
35593,0,1798800,7,13,3,34,254,47014254
35594,0,1798800,19,13,3,34,254,47014254
35595,1,1798700,1,13,3,34,255,47014255
35596,1,1798700,5,13,3,34,256,47014256
35597,0,1798700,1,13,3,34,256,47014256
35598,0,1798700,2,13,3,34,256,47014256
35599,25,1798600,6,13,3,34,281,47014281
35600,145,1798600,1,13,3,34,426,47014426
35601,18,1798600,1,13,3,34,444,47014444
35602,92,1798600,2,13,3,34,536,47014536
35603,16,1798600,2,13,3,34,552,47014552
35604,40,1798600,1,13,3,34,592,47014592
35605,9,1798600,4,13,3,34,601,47014601
35606,1,1798600,5,13,3,34,602,47014602
35607,0,1798600,1,13,3,34,602,47014602
35608,6,1798500,2,13,3,34,608,47014608
35609,53,1798500,1,13,3,34,661,47014661
35610,98,1798500,1,13,3,34,759,47014759
35611,10,1798500,2,13,3,34,769,47014769
35612,21,1798500,1,13,3,34,790,47014790
35613,13,1798500,1,13,3,34,803,47014803
35614,61,1798600,1,13,3,34,864,47014864
35615,40,1798500,1,13,3,34,904,47014904
35616,3,1798500,1,13,3,34,907,47014907
35617,76,1798500,1,13,3,34,983,47014983
35618,54,1798500,1,13,3,35,37,47015037
35619,29,1798500,1,13,3,35,66,47015066
35620,9,1798500,9,13,3,35,75,47015075
35621,14,1798600,1,13,3,35,89,47015089
35622,12,1798400,1,13,3,35,101,47015101
35623,86,1798400,3,13,3,35,187,47015187
35624,44,1798400,6,13,3,35,231,47015231
35625,6,1798500,1,13,3,35,237,47015237
35626,68,1798400,4,13,3,35,305,47015305
35627,54,1798400,1,13,3,35,359,47015359
35628,50,1798400,1,13,3,35,409,47015409
35629,15,1798400,1,13,3,35,424,47015424
35630,0,1798500,1,13,3,35,424,47015424
35631,2,1798500,1,13,3,35,426,47015426
35632,41,1798400,1,13,3,35,467,47015467
35633,5,1798400,1,13,3,35,472,47015472
35634,37,1798400,1,13,3,35,509,47015509
35635,22,1798500,1,13,3,35,531,47015531
35636,57,1798500,1,13,3,35,588,47015588
35637,13,1798400,3,13,3,35,601,47015601
35638,13,1798400,1,13,3,35,614,47015614
35639,10,1798400,4,13,3,35,624,47015624
35640,2,1798400,1,13,3,35,626,47015626
35641,62,1798400,1,13,3,35,688,47015688
35642,7,1798400,2,13,3,35,695,47015695
35643,7,1798400,1,13,3,35,702,47015702
35644,56,1798400,1,13,3,35,758,47015758
35645,42,1798400,4,13,3,35,800,47015800
35646,9,1798500,1,13,3,35,809,47015809
35648,18,1798400,2,13,3,35,827,47015827
35649,9,1798400,5,13,3,35,836,47015836
35650,142,1798600,1,13,3,35,978,47015978
35651,44,1798400,5,13,3,36,22,47016022
35652,25,1798400,1,13,3,36,47,47016047
35653,48,1798400,1,13,3,36,95,47016095
35654,12,1798400,4,13,3,36,107,47016107
35655,35,1798400,4,13,3,36,142,47016142
35656,25,1798500,1,13,3,36,167,47016167
35657,173,1798500,1,13,3,36,340,47016340
35658,8,1798600,3,13,3,36,348,47016348
35659,138,1798600,1,13,3,36,486,47016486
35660,121,1798500,1,13,3,36,607,47016607
35661,0,1798500,1,13,3,36,607,47016607
35662,3,1798500,1,13,3,36,610,47016610
35663,1,1798500,1,13,3,36,611,47016611
35664,8,1798500,1,13,3,36,619,47016619
35665,435,1798500,1,13,3,37,54,47017054
35666,0,1798500,1,13,3,37,54,47017054
35667,66,1798600,4,13,3,37,120,47017120
35668,158,1798600,1,13,3,37,278,47017278
35669,157,1798600,1,13,3,37,435,47017435
35670,751,1798500,1,13,3,38,186,47018186
35671,54,1798500,1,13,3,38,240,47018240
35672,46,1798500,1,13,3,38,286,47018286
35673,367,1798500,1,13,3,38,653,47018653
35674,1,1798600,2,13,3,38,654,47018654
35675,22,1798700,1,13,3,38,676,47018676
35676,17,1798600,1,13,3,38,693,47018693
35678,630,1798600,1,13,3,39,323,47019323
35679,26,1798500,2,13,3,39,349,47019349
35680,9,1798600,1,13,3,39,358,47019358
35681,132,1798500,2,13,3,39,490,47019490
35682,206,1798500,2,13,3,39,696,47019696
35683,51,1798500,1,13,3,39,747,47019747
35684,154,1798500,4,13,3,39,901,47019901
35685,532,1798400,2,13,3,40,433,47020433
35686,15,1798400,1,13,3,40,448,47020448
35687,37,1798400,1,13,3,40,485,47020485
35688,166,1798400,1,13,3,40,651,47020651
35689,199,1798400,1,13,3,40,850,47020850
35690,190,1798400,1,13,3,41,40,47021040
35691,43,1798400,2,13,3,41,83,47021083
35692,309,1798300,1,13,3,41,392,47021392
35693,8,1798300,1,13,3,41,400,47021400
35694,23,1798400,1,13,3,41,423,47021423
35695,8,1798300,1,13,3,41,431,47021431
35696,1,1798300,1,13,3,41,432,47021432
35697,46,1798300,2,13,3,41,478,47021478
35698,2,1798300,1,13,3,41,480,47021480
35699,0,1798300,1,13,3,41,480,47021480
35700,1,1798300,1,13,3,41,481,47021481
35701,0,1798300,1,13,3,41,481,47021481
35702,12,1798300,1,13,3,41,493,47021493
35703,6,1798300,2,13,3,41,499,47021499
35704,6,1798300,2,13,3,41,505,47021505
35705,1,1798300,1,13,3,41,506,47021506
35706,1,1798300,1,13,3,41,507,47021507
35707,10,1798300,2,13,3,41,517,47021517
35708,12,1798300,2,13,3,41,529,47021529
35709,30,1798300,1,13,3,41,559,47021559
35710,14,1798300,1,13,3,41,573,47021573
35711,13,1798300,1,13,3,41,586,47021586
35712,1,1798300,1,13,3,41,587,47021587
35713,145,1798300,3,13,3,41,732,47021732
35714,7,1798300,1,13,3,41,739,47021739
35715,91,1798300,1,13,3,41,830,47021830
35716,15,1798300,1,13,3,41,845,47021845
35717,220,1798400,2,13,3,42,65,47022065
35718,137,1798300,1,13,3,42,202,47022202
35719,117,1798300,2,13,3,42,319,47022319
35720,153,1798300,1,13,3,42,472,47022472
35721,95,1798300,1,13,3,42,567,47022567
35722,188,1798300,1,13,3,42,755,47022755
35723,143,1798400,1,13,3,42,898,47022898
35724,27,1798300,1,13,3,42,925,47022925
35725,50,1798400,1,13,3,42,975,47022975
35726,429,1798300,1,13,3,43,404,47023404
35727,167,1798400,1,13,3,43,571,47023571
35728,308,1798300,1,13,3,43,879,47023879
35729,369,1798300,1,13,3,44,248,47024248
35730,13,1798300,1,13,3,44,261,47024261
35731,13,1798200,1,13,3,44,274,47024274
35732,98,1798200,1,13,3,44,372,47024372
35733,1,1798200,1,13,3,44,373,47024373
35734,10,1798200,1,13,3,44,383,47024383
35735,16,1798400,2,13,3,44,399,47024399
35736,79,1798400,1,13,3,44,478,47024478
35737,36,1798300,1,13,3,44,514,47024514
35738,16,1798200,1,13,3,44,530,47024530
35739,64,1798400,1,13,3,44,594,47024594
35740,261,1798400,1,13,3,44,855,47024855
35741,62,1798400,1,13,3,44,917,47024917
35742,49,1798300,1,13,3,44,966,47024966
35743,441,1798300,1,13,3,45,407,47025407
35744,30,1798400,1,13,3,45,437,47025437
35745,386,1798400,2,13,3,45,823,47025823
35746,85,1798300,4,13,3,45,908,47025908
35747,244,1798400,1,13,3,46,152,47026152
35748,1374,1798300,1,13,3,47,526,47027526
35749,328,1798400,1,13,3,47,854,47027854
35750,39,1798300,1,13,3,47,893,47027893
35751,487,1798400,3,13,3,48,380,47028380
35753,277,1798300,3,13,3,48,657,47028657
35754,501,1798300,1,13,3,49,158,47029158
35755,468,1798300,1,13,3,49,626,47029626
35756,207,1798200,1,13,3,49,833,47029833
35757,60,1798300,6,13,3,49,893,47029893
35758,39,1798200,1,13,3,49,932,47029932
35759,1856,1798200,1,13,3,51,788,47031788
35760,61,1798200,1,13,3,51,849,47031849
35761,18,1798200,1,13,3,51,867,47031867
35762,73,1798300,2,13,3,51,940,47031940
35763,781,1798200,1,13,3,52,721,47032721
35764,1026,1798200,2,13,3,53,747,47033747
35765,604,1798200,6,13,3,54,351,47034351
35766,19,1798200,1,13,3,54,370,47034370
35767,368,1798100,1,13,3,54,738,47034738
35768,128,1798100,10,13,3,54,866,47034866
35769,0,1798100,28,13,3,54,866,47034866
35770,3,1798000,3,13,3,54,869,47034869
35771,0,1798000,1,13,3,54,869,47034869
35772,0,1798000,1,13,3,54,869,47034869
35773,0,1798000,1,13,3,54,869,47034869
35774,0,1798000,1,13,3,54,869,47034869
35775,0,1798000,2,13,3,54,869,47034869
35776,1,1798000,3,13,3,54,870,47034870
35777,17,1798100,1,13,3,54,887,47034887
35778,89,1798000,12,13,3,54,976,47034976
35779,0,1798000,1,13,3,54,976,47034976
35780,1,1798000,1,13,3,54,977,47034977
35781,0,1798000,1,13,3,54,977,47034977
35782,0,1798000,8,13,3,54,977,47034977
35783,0,1798000,1,13,3,54,977,47034977
35784,0,1798000,2,13,3,54,977,47034977
35785,0,1798000,16,13,3,54,977,47034977
35786,0,1798000,1,13,3,54,977,47034977
35787,0,1798000,8,13,3,54,977,47034977
35788,0,1798000,2,13,3,54,977,47034977
35789,1,1798000,4,13,3,54,978,47034978
35790,0,1798000,14,13,3,54,978,47034978
35791,0,1798000,1,13,3,54,978,47034978
35792,1,1798100,1,13,3,54,979,47034979
35793,0,1798000,1,13,3,54,979,47034979
35794,0,1798000,1,13,3,54,979,47034979
35795,83,1798000,1,13,3,55,62,47035062
35796,15,1798000,2,13,3,55,77,47035077
35797,2,1798000,2,13,3,55,79,47035079
35798,2,1797900,2,13,3,55,81,47035081
35799,2,1797900,2,13,3,55,83,47035083
35800,2,1797900,2,13,3,55,85,47035085
35801,18,1797900,2,13,3,55,103,47035103
35802,49,1797900,3,13,3,55,152,47035152
35803,146,1797900,1,13,3,55,298,47035298
35804,64,1797900,1,13,3,55,362,47035362
35805,42,1798000,1,13,3,55,404,47035404
35806,1,1798000,5,13,3,55,405,47035405
35807,31,1798000,1,13,3,55,436,47035436
35808,87,1798000,1,13,3,55,523,47035523
35809,108,1798000,2,13,3,55,631,47035631
35810,14,1797900,1,13,3,55,645,47035645
35811,38,1797900,2,13,3,55,683,47035683
35812,0,1797900,1,13,3,55,683,47035683
35813,24,1798000,1,13,3,55,707,47035707
35814,64,1798000,1,13,3,55,771,47035771
35815,17,1798000,1,13,3,55,788,47035788
35816,153,1797900,1,13,3,55,941,47035941
35817,16,1798000,1,13,3,55,957,47035957
35818,37,1797900,1,13,3,55,994,47035994
35819,49,1797900,1,13,3,56,43,47036043
35820,21,1797900,1,13,3,56,64,47036064
35821,145,1797800,4,13,3,56,209,47036209
35822,60,1797800,1,13,3,56,269,47036269
35823,1,1798000,1,13,3,56,270,47036270
35824,55,1797800,3,13,3,56,325,47036325
35825,2,1798000,3,13,3,56,327,47036327
35826,174,1797800,1,13,3,56,501,47036501
35827,58,1797800,2,13,3,56,559,47036559
35828,10,1797800,3,13,3,56,569,47036569
35829,33,1797800,1,13,3,56,602,47036602
35830,14,1797800,10,13,3,56,616,47036616
35831,1,1797800,1,13,3,56,617,47036617
35832,0,1797800,1,13,3,56,617,47036617
35833,0,1797800,1,13,3,56,617,47036617
35834,0,1797800,1,13,3,56,617,47036617
35835,1,1797800,1,13,3,56,618,47036618
35836,94,1797800,1,13,3,56,712,47036712
35837,10,1797800,1,13,3,56,722,47036722
35838,24,1797800,1,13,3,56,746,47036746
35839,154,1797900,1,13,3,56,900,47036900
35840,269,1797700,2,13,3,57,169,47037169
35841,9,1797700,4,13,3,57,178,47037178
35842,74,1797700,1,13,3,57,252,47037252
35843,7,1797700,3,13,3,57,259,47037259
35844,15,1797700,1,13,3,57,274,47037274
35845,12,1797800,1,13,3,57,286,47037286
35846,113,1797700,4,13,3,57,399,47037399
35847,31,1797800,1,13,3,57,430,47037430
35848,57,1797700,1,13,3,57,487,47037487
35849,74,1797700,1,13,3,57,561,47037561
35850,0,1797700,4,13,3,57,561,47037561
35851,1,1797700,3,13,3,57,562,47037562
35852,11,1797600,1,13,3,57,573,47037573
35853,3,1797600,1,13,3,57,576,47037576
35854,77,1797600,1,13,3,57,653,47037653
35855,54,1797600,4,13,3,57,707,47037707
35856,0,1797600,1,13,3,57,707,47037707
35857,11,1797700,5,13,3,57,718,47037718
35858,41,1797600,2,13,3,57,759,47037759
35859,0,1797600,2,13,3,57,759,47037759
35860,20,1797600,1,13,3,57,779,47037779
35861,156,1797700,2,13,3,57,935,47037935
35862,110,1797600,1,13,3,58,45,47038045
35863,40,1797600,1,13,3,58,85,47038085
35864,120,1797600,1,13,3,58,205,47038205
35865,79,1797600,1,13,3,58,284,47038284
35866,128,1797600,1,13,3,58,412,47038412
35867,172,1797600,1,13,3,58,584,47038584
35868,45,1797600,1,13,3,58,629,47038629
35869,21,1797700,1,13,3,58,650,47038650
35870,174,1797600,1,13,3,58,824,47038824
35871,41,1797600,1,13,3,58,865,47038865
35872,75,1797600,2,13,3,58,940,47038940
35873,16,1797600,2,13,3,58,956,47038956
35874,17,1797600,2,13,3,58,973,47038973
35875,2,1797600,1,13,3,58,975,47038975
35876,69,1797500,1,13,3,59,44,47039044
35877,13,1797500,1,13,3,59,57,47039057
35878,79,1797500,1,13,3,59,136,47039136
35879,8,1797500,1,13,3,59,144,47039144
35880,151,1797500,2,13,3,59,295,47039295
35881,44,1797500,1,13,3,59,339,47039339
35882,2,1797500,1,13,3,59,341,47039341
35883,23,1797700,1,13,3,59,364,47039364
35884,184,1797500,1,13,3,59,548,47039548
35885,34,1797500,1,13,3,59,582,47039582
35886,10,1797500,1,13,3,59,592,47039592
35887,10,1797500,1,13,3,59,602,47039602
35888,39,1797500,1,13,3,59,641,47039641
35889,5,1797500,2,13,3,59,646,47039646
35890,8,1797600,4,13,3,59,654,47039654
35891,42,1797700,1,13,3,59,696,47039696
35892,23,1797700,4,13,3,59,719,47039719
35893,101,1797700,1,13,3,59,820,47039820
35894,0,1797700,1,13,3,59,820,47039820
35895,115,1797700,1,13,3,59,935,47039935
35896,59,1797700,1,13,3,59,994,47039994
35897,95,1797700,2,13,4,0,89,47040089
35899,9,1797800,2,13,4,0,98,47040098
35900,7,1797700,1,13,4,0,105,47040105
35902,161,1797700,1,13,4,0,266,47040266
35903,56,1797700,1,13,4,0,322,47040322
35904,73,1797700,2,13,4,0,395,47040395
35905,47,1797700,1,13,4,0,442,47040442
35906,22,1797700,1,13,4,0,464,47040464
35907,40,1797700,1,13,4,0,504,47040504
35908,18,1797700,1,13,4,0,522,47040522
35909,51,1797700,1,13,4,0,573,47040573
35910,2,1797700,1,13,4,0,575,47040575
35911,23,1797700,1,13,4,0,598,47040598
35912,11,1797700,1,13,4,0,609,47040609
35913,8,1797700,1,13,4,0,617,47040617
35914,16,1797700,1,13,4,0,633,47040633
35915,27,1797800,4,13,4,0,660,47040660
35916,31,1797700,1,13,4,0,691,47040691
35917,24,1797700,1,13,4,0,715,47040715
35918,29,1797700,1,13,4,0,744,47040744
35919,82,1797700,7,13,4,0,826,47040826
35920,0,1797700,1,13,4,0,826,47040826
35921,17,1797600,1,13,4,0,843,47040843
35922,5,1797600,1,13,4,0,848,47040848
35923,60,1797600,1,13,4,0,908,47040908
35924,170,1797600,1,13,4,1,78,47041078
35925,23,1797500,1,13,4,1,101,47041101
35926,246,1797500,1,13,4,1,347,47041347
35927,1,1797500,9,13,4,1,348,47041348
35928,1,1797400,1,13,4,1,349,47041349
35929,1,1797400,1,13,4,1,350,47041350
35930,0,1797400,1,13,4,1,350,47041350
35931,1,1797400,1,13,4,1,351,47041351
35932,0,1797400,1,13,4,1,351,47041351
35933,0,1797400,1,13,4,1,351,47041351
35934,1,1797400,1,13,4,1,352,47041352
35935,0,1797400,1,13,4,1,352,47041352
35936,17,1797300,1,13,4,1,369,47041369
35937,45,1797300,1,13,4,1,414,47041414
35938,55,1797300,1,13,4,1,469,47041469
35939,8,1797300,5,13,4,1,477,47041477
35941,2,1797200,1,13,4,1,479,47041479
35942,1,1797100,4,13,4,1,480,47041480
35943,0,1797100,1,13,4,1,480,47041480
35944,1,1797100,4,13,4,1,481,47041481
35945,0,1797100,7,13,4,1,481,47041481
35946,3,1797000,7,13,4,1,484,47041484
35947,0,1797000,1,13,4,1,484,47041484
35948,0,1797000,1,13,4,1,484,47041484
35949,0,1797000,1,13,4,1,484,47041484
35950,0,1797000,1,13,4,1,484,47041484
35951,1,1797000,7,13,4,1,485,47041485
35952,0,1797000,8,13,4,1,485,47041485
35953,0,1797000,1,13,4,1,485,47041485
35954,1,1796900,1,13,4,1,486,47041486
35955,0,1796900,1,13,4,1,486,47041486
35956,9,1796900,1,13,4,1,495,47041495
35957,47,1797000,1,13,4,1,542,47041542
35958,41,1796900,1,13,4,1,583,47041583
35959,24,1796900,2,13,4,1,607,47041607
35961,1,1796900,1,13,4,1,608,47041608
35962,0,1796900,1,13,4,1,608,47041608
35963,4,1796900,2,13,4,1,612,47041612
35964,1,1796900,2,13,4,1,613,47041613
35965,0,1796900,1,13,4,1,613,47041613
35967,3,1796900,2,13,4,1,616,47041616
35968,2,1796900,1,13,4,1,618,47041618
35970,0,1797000,2,13,4,1,618,47041618
35971,1,1796800,1,13,4,1,619,47041619
35972,0,1796900,4,13,4,1,619,47041619
35973,7,1796800,1,13,4,1,626,47041626
35974,6,1796800,2,13,4,1,632,47041632
35975,11,1796800,1,13,4,1,643,47041643
35976,2,1796900,1,13,4,1,645,47041645
35977,10,1797000,1,13,4,1,655,47041655
35978,0,1797000,1,13,4,1,655,47041655
35979,1,1797100,1,13,4,1,656,47041656
35980,19,1797000,1,13,4,1,675,47041675
35981,2,1797000,1,13,4,1,677,47041677
35982,18,1797100,1,13,4,1,695,47041695
35983,2,1797000,1,13,4,1,697,47041697
35984,3,1797000,1,13,4,1,700,47041700
35985,21,1797000,3,13,4,1,721,47041721
35987,7,1796900,1,13,4,1,728,47041728
35988,37,1797100,1,13,4,1,765,47041765
35989,1,1797000,3,13,4,1,766,47041766
35990,12,1797000,1,13,4,1,778,47041778
35991,1,1797000,3,13,4,1,779,47041779
35993,3,1797000,1,13,4,1,782,47041782
35994,2,1797000,1,13,4,1,784,47041784
35996,2,1796900,1,13,4,1,786,47041786
35997,17,1796900,1,13,4,1,803,47041803
35998,5,1796900,1,13,4,1,808,47041808
35999,0,1796900,1,13,4,1,808,47041808
36000,0,1796900,1,13,4,1,808,47041808
36001,0,1796900,1,13,4,1,808,47041808
36002,15,1797000,1,13,4,1,823,47041823
36003,0,1796900,1,13,4,1,823,47041823
36004,1,1796900,1,13,4,1,824,47041824
36005,0,1796900,1,13,4,1,824,47041824
36006,4,1796900,1,13,4,1,828,47041828
36007,7,1796900,1,13,4,1,835,47041835
36008,18,1796900,1,13,4,1,853,47041853
36009,1,1796900,1,13,4,1,854,47041854
36010,5,1796900,3,13,4,1,859,47041859
36012,7,1796900,2,13,4,1,866,47041866
36013,8,1797000,1,13,4,1,874,47041874
36014,2,1796900,1,13,4,1,876,47041876
36015,59,1796900,3,13,4,1,935,47041935
36016,36,1796900,1,13,4,1,971,47041971
36017,5,1796900,1,13,4,1,976,47041976
36018,26,1796900,1,13,4,2,2,47042002
36019,122,1797100,1,13,4,2,124,47042124
36020,26,1797100,1,13,4,2,150,47042150
36022,28,1797200,5,13,4,2,178,47042178
36023,122,1797100,1,13,4,2,300,47042300
36024,13,1797200,2,13,4,2,313,47042313
36025,3,1797200,1,13,4,2,316,47042316
36026,89,1797200,1,13,4,2,405,47042405
36027,11,1797100,2,13,4,2,416,47042416
36029,49,1797000,1,13,4,2,465,47042465
36030,0,1797000,1,13,4,2,465,47042465
36031,9,1797000,1,13,4,2,474,47042474
36032,3,1797000,1,13,4,2,477,47042477
36033,14,1797000,5,13,4,2,491,47042491
36034,49,1797100,1,13,4,2,540,47042540
36035,12,1797000,2,13,4,2,552,47042552
36036,10,1797200,4,13,4,2,562,47042562
36037,0,1797200,1,13,4,2,562,47042562
36038,1,1797100,1,13,4,2,563,47042563
36040,133,1797000,1,13,4,2,696,47042696
36041,49,1797000,1,13,4,2,745,47042745
36042,90,1796900,1,13,4,2,835,47042835
36043,10,1797000,1,13,4,2,845,47042845
36045,29,1797000,1,13,4,2,874,47042874
36046,1,1797100,1,13,4,2,875,47042875
36047,31,1797000,1,13,4,2,906,47042906
36048,20,1797000,7,13,4,2,926,47042926
36049,7,1797100,1,13,4,2,933,47042933
36051,65,1797000,1,13,4,2,998,47042998
36052,130,1797300,5,13,4,3,128,47043128
36053,41,1797300,1,13,4,3,169,47043169
36054,56,1797300,1,13,4,3,225,47043225
36055,32,1797300,1,13,4,3,257,47043257
36056,11,1797200,1,13,4,3,268,47043268
36057,0,1797200,1,13,4,3,268,47043268
36058,81,1797200,2,13,4,3,349,47043349
36059,23,1797200,1,13,4,3,372,47043372
36060,51,1797400,1,13,4,3,423,47043423
36061,25,1797200,1,13,4,3,448,47043448
36062,9,1797200,2,13,4,3,457,47043457
36064,31,1797200,1,13,4,3,488,47043488
36065,20,1797100,1,13,4,3,508,47043508
36066,47,1797100,2,13,4,3,555,47043555
36067,140,1797100,3,13,4,3,695,47043695
36069,1,1797100,1,13,4,3,696,47043696
36070,79,1797200,2,13,4,3,775,47043775
36071,146,1797100,1,13,4,3,921,47043921
36072,185,1797100,5,13,4,4,106,47044106
36073,1,1797100,5,13,4,4,107,47044107
36074,93,1797000,2,13,4,4,200,47044200
36075,158,1797200,1,13,4,4,358,47044358
36076,255,1797200,1,13,4,4,613,47044613
36077,0,1797200,1,13,4,4,613,47044613
36078,0,1797200,1,13,4,4,613,47044613
36079,0,1797200,1,13,4,4,613,47044613
36080,424,1797100,1,13,4,5,37,47045037
36081,32,1797100,2,13,4,5,69,47045069
36082,523,1797100,2,13,4,5,592,47045592
36083,0,1797100,3,13,4,5,592,47045592
36084,36,1797200,1,13,4,5,628,47045628
36085,105,1797100,1,13,4,5,733,47045733
36086,236,1797100,1,13,4,5,969,47045969
36087,396,1797100,1,13,4,6,365,47046365
36088,117,1797000,4,13,4,6,482,47046482
36089,166,1797100,1,13,4,6,648,47046648
36090,227,1797100,1,13,4,6,875,47046875
36091,7,1797100,1,13,4,6,882,47046882
36092,359,1797200,1,13,4,7,241,47047241
36093,56,1797100,1,13,4,7,297,47047297
36094,59,1797100,2,13,4,7,356,47047356
36095,61,1797200,1,13,4,7,417,47047417
36096,2,1797000,1,13,4,7,419,47047419
36097,74,1797000,2,13,4,7,493,47047493
36098,50,1797100,1,13,4,7,543,47047543
36099,20,1797100,1,13,4,7,563,47047563
36100,573,1797100,1,13,4,8,136,47048136
36101,31,1797000,1,13,4,8,167,47048167
36102,140,1797100,2,13,4,8,307,47048307
36103,195,1797100,1,13,4,8,502,47048502
36104,140,1797000,3,13,4,8,642,47048642
36105,15,1796900,1,13,4,8,657,47048657
36106,11,1796900,1,13,4,8,668,47048668
36107,17,1796900,3,13,4,8,685,47048685
36108,1,1796900,1,13,4,8,686,47048686
36109,84,1796800,1,13,4,8,770,47048770
36110,0,1796800,2,13,4,8,770,47048770
36111,44,1796800,4,13,4,8,814,47048814
36113,104,1796900,2,13,4,8,918,47048918
36114,6,1796900,3,13,4,8,924,47048924
36116,172,1796800,2,13,4,9,96,47049096
36117,130,1797000,1,13,4,9,226,47049226
36118,51,1797000,1,13,4,9,277,47049277
36119,351,1797000,2,13,4,9,628,47049628
36120,221,1797000,1,13,4,9,849,47049849
36121,129,1796900,1,13,4,9,978,47049978
36122,349,1797100,1,13,4,10,327,47050327
36123,49,1797000,1,13,4,10,376,47050376
36124,19,1797000,1,13,4,10,395,47050395
36125,46,1797000,1,13,4,10,441,47050441
36126,35,1796900,4,13,4,10,476,47050476
36127,0,1796900,4,13,4,10,476,47050476
36128,12,1796900,1,13,4,10,488,47050488
36129,119,1796800,5,13,4,10,607,47050607
36130,12,1796800,1,13,4,10,619,47050619
36131,114,1796700,5,13,4,10,733,47050733
36132,13,1796800,1,13,4,10,746,47050746
36133,112,1796700,1,13,4,10,858,47050858
36134,36,1796700,2,13,4,10,894,47050894
36135,55,1796800,1,13,4,10,949,47050949
36136,21,1796700,1,13,4,10,970,47050970
36137,1,1796700,32,13,4,10,971,47050971
36138,35,1796600,1,13,4,11,6,47051006
36139,21,1796700,1,13,4,11,27,47051027
36140,77,1796700,1,13,4,11,104,47051104
36141,104,1796600,1,13,4,11,208,47051208
36142,8,1796700,2,13,4,11,216,47051216
36143,24,1796700,2,13,4,11,240,47051240
36144,62,1796600,1,13,4,11,302,47051302
36145,29,1796600,1,13,4,11,331,47051331
36146,17,1796700,1,13,4,11,348,47051348
36148,217,1796600,2,13,4,11,565,47051565
36149,59,1796600,1,13,4,11,624,47051624
36150,18,1796600,1,13,4,11,642,47051642
36151,48,1796600,1,13,4,11,690,47051690
36152,137,1796700,1,13,4,11,827,47051827
36153,71,1796600,1,13,4,11,898,47051898
36155,46,1796600,1,13,4,11,944,47051944
36156,33,1796600,1,13,4,11,977,47051977
36157,31,1796500,1,13,4,12,8,47052008
36158,4,1796500,1,13,4,12,12,47052012
36159,11,1796500,1,13,4,12,23,47052023
36160,110,1796500,2,13,4,12,133,47052133
36161,10,1796500,1,13,4,12,143,47052143
36162,9,1796500,1,13,4,12,152,47052152
36163,22,1796500,1,13,4,12,174,47052174
36164,0,1796700,1,13,4,12,174,47052174
36165,254,1796500,4,13,4,12,428,47052428
36167,77,1796500,2,13,4,12,505,47052505
36168,1,1796500,2,13,4,12,506,47052506
36169,71,1796500,1,13,4,12,577,47052577
36170,5,1796500,1,13,4,12,582,47052582
36171,22,1796400,1,13,4,12,604,47052604
36172,4,1796400,1,13,4,12,608,47052608
36173,0,1796400,1,13,4,12,608,47052608
36174,2,1796400,2,13,4,12,610,47052610
36175,0,1796400,1,13,4,12,610,47052610
36176,1,1796400,1,13,4,12,611,47052611
36177,18,1796400,2,13,4,12,629,47052629
36178,2,1796400,2,13,4,12,631,47052631
36179,18,1796400,1,13,4,12,649,47052649
36180,9,1796400,1,13,4,12,658,47052658
36181,12,1796500,1,13,4,12,670,47052670
36182,114,1796600,1,13,4,12,784,47052784
36183,15,1796600,4,13,4,12,799,47052799
36184,50,1796600,1,13,4,12,849,47052849
36185,106,1796600,1,13,4,12,955,47052955
36186,56,1796600,1,13,4,13,11,47053011
36187,22,1796600,1,13,4,13,33,47053033
36189,60,1796500,1,13,4,13,93,47053093
36190,86,1796500,1,13,4,13,179,47053179
36191,63,1796500,1,13,4,13,242,47053242
36192,24,1796700,1,13,4,13,266,47053266
36193,53,1796500,1,13,4,13,319,47053319
36194,383,1796700,1,13,4,13,702,47053702
36195,0,1796700,1,13,4,13,702,47053702
36196,76,1796700,1,13,4,13,778,47053778
36197,27,1796700,1,13,4,13,805,47053805
36198,71,1796600,2,13,4,13,876,47053876
36199,115,1796600,1,13,4,13,991,47053991
36200,949,1796700,1,13,4,14,940,47054940
36201,167,1796800,1,13,4,15,107,47055107
36202,206,1796700,3,13,4,15,313,47055313
36203,215,1796800,1,13,4,15,528,47055528
36204,261,1796800,7,13,4,15,789,47055789
36206,81,1796800,1,13,4,15,870,47055870
36207,46,1796900,1,13,4,15,916,47055916
36208,14,1796700,1,13,4,15,930,47055930
36209,230,1796700,1,13,4,16,160,47056160
36210,356,1796900,1,13,4,16,516,47056516
36211,558,1796900,1,13,4,17,74,47057074
36212,161,1796900,1,13,4,17,235,47057235
36213,0,1796900,5,13,4,17,235,47057235
36214,164,1797000,1,13,4,17,399,47057399
36215,5,1796900,1,13,4,17,404,47057404
36216,35,1796900,1,13,4,17,439,47057439
36217,168,1796900,1,13,4,17,607,47057607
36218,373,1797000,1,13,4,17,980,47057980
36219,140,1796900,1,13,4,18,120,47058120
36220,801,1796900,1,13,4,18,921,47058921
36221,5,1797000,5,13,4,18,926,47058926
36222,71,1797000,1,13,4,18,997,47058997
36223,29,1796900,1,13,4,19,26,47059026
36224,223,1797100,1,13,4,19,249,47059249
36225,66,1797000,1,13,4,19,315,47059315
36226,20,1797000,2,13,4,19,335,47059335
36227,173,1796900,2,13,4,19,508,47059508
36228,7,1797000,1,13,4,19,515,47059515
36229,167,1797100,1,13,4,19,682,47059682
36230,374,1796900,1,13,4,20,56,47060056
36231,19,1796900,1,13,4,20,75,47060075
36232,10,1796900,1,13,4,20,85,47060085
36233,2054,1796900,1,13,4,22,139,47062139
36234,466,1797000,1,13,4,22,605,47062605
36235,387,1796900,1,13,4,22,992,47062992
36236,35,1796900,1,13,4,23,27,47063027
36237,0,1796900,8,13,4,23,27,47063027
36238,1,1796800,4,13,4,23,28,47063028
36239,6,1796800,3,13,4,23,34,47063034
36240,0,1796800,1,13,4,23,34,47063034
36241,0,1796800,1,13,4,23,34,47063034
36242,139,1796800,1,13,4,23,173,47063173
36243,207,1796800,4,13,4,23,380,47063380
36245,68,1796800,1,13,4,23,448,47063448
36247,1,1796800,1,13,4,23,449,47063449
36248,334,1796700,3,13,4,23,783,47063783
36249,0,1796700,2,13,4,23,783,47063783
36250,0,1796700,1,13,4,23,783,47063783
36251,1,1796700,1,13,4,23,784,47063784
36252,50,1796700,1,13,4,23,834,47063834
36253,617,1796700,1,13,4,24,451,47064451
36254,587,1796600,1,13,4,25,38,47065038
36255,0,1796600,1,13,4,25,38,47065038
36256,0,1796600,1,13,4,25,38,47065038
36257,0,1796600,3,13,4,25,38,47065038
36258,0,1796600,1,13,4,25,38,47065038
36259,0,1796600,1,13,4,25,38,47065038
36260,0,1796600,3,13,4,25,38,47065038
36261,511,1796500,2,13,4,25,549,47065549
36262,6,1796500,1,13,4,25,555,47065555
36263,342,1796600,1,13,4,25,897,47065897
36264,1,1796600,1,13,4,25,898,47065898
36265,44,1796700,1,13,4,25,942,47065942
36266,240,1796500,1,13,4,26,182,47066182
36267,195,1796600,2,13,4,26,377,47066377
36268,0,1796600,1,13,4,26,377,47066377
36269,129,1796500,3,13,4,26,506,47066506
36270,35,1796500,1,13,4,26,541,47066541
36271,53,1796600,3,13,4,26,594,47066594
36272,415,1796500,2,13,4,27,9,47067009
36274,33,1796600,2,13,4,27,42,47067042
36275,499,1796600,1,13,4,27,541,47067541
36276,828,1796700,1,13,4,28,369,47068369
36277,121,1796700,2,13,4,28,490,47068490
36278,0,1796700,1,13,4,28,490,47068490
36279,468,1796500,1,13,4,28,958,47068958
36280,0,1796500,4,13,4,28,958,47068958
36281,78,1796600,1,13,4,29,36,47069036
36282,137,1796600,1,13,4,29,173,47069173
36283,49,1796600,1,13,4,29,222,47069222
36284,76,1796700,2,13,4,29,298,47069298
36285,33,1796600,1,13,4,29,331,47069331
36286,6,1796600,1,13,4,29,337,47069337
36287,164,1796600,3,13,4,29,501,47069501
36289,88,1796500,1,13,4,29,589,47069589
36290,177,1796700,2,13,4,29,766,47069766
36291,349,1796600,1,13,4,30,115,47070115
36292,220,1796600,1,13,4,30,335,47070335
36293,97,1796600,1,13,4,30,432,47070432
36294,322,1796700,1,13,4,30,754,47070754
36295,205,1796600,3,13,4,30,959,47070959
36296,144,1796600,1,13,4,31,103,47071103
36298,399,1796500,2,13,4,31,502,47071502
36299,262,1796700,2,13,4,31,764,47071764
36300,38,1796700,3,13,4,31,802,47071802
36301,318,1796500,2,13,4,32,120,47072120
36302,0,1796500,1,13,4,32,120,47072120
36303,12,1796500,1,13,4,32,132,47072132
36304,19,1796600,1,13,4,32,151,47072151
36305,5,1796400,1,13,4,32,156,47072156
36306,130,1796400,1,13,4,32,286,47072286
36307,479,1796500,1,13,4,32,765,47072765
36308,127,1796300,2,13,4,32,892,47072892
36309,204,1796300,1,13,4,33,96,47073096
36310,79,1796300,2,13,4,33,175,47073175
36311,8,1796300,2,13,4,33,183,47073183
36312,14,1796400,1,13,4,33,197,47073197
36313,90,1796400,1,13,4,33,287,47073287
36314,89,1796300,2,13,4,33,376,47073376
36315,69,1796300,2,13,4,33,445,47073445
36316,34,1796300,1,13,4,33,479,47073479
36317,84,1796300,1,13,4,33,563,47073563
36318,9,1796200,1,13,4,33,572,47073572
36319,4,1796200,1,13,4,33,576,47073576
36320,97,1796300,1,13,4,33,673,47073673
36321,0,1796200,1,13,4,33,673,47073673
36322,7,1796200,1,13,4,33,680,47073680
36323,18,1796200,1,13,4,33,698,47073698
36324,96,1796300,1,13,4,33,794,47073794
36325,17,1796200,2,13,4,33,811,47073811
36326,4,1796300,1,13,4,33,815,47073815
36327,23,1796200,1,13,4,33,838,47073838
36328,51,1796200,3,13,4,33,889,47073889
36329,40,1796200,1,13,4,33,929,47073929
36330,1,1796400,1,13,4,33,930,47073930
36331,13,1796200,1,13,4,33,943,47073943
36332,9,1796200,1,13,4,33,952,47073952
36333,41,1796200,1,13,4,33,993,47073993
36334,3,1796200,1,13,4,33,996,47073996
36335,73,1796200,1,13,4,34,69,47074069
36336,1,1796200,2,13,4,34,70,47074070
36337,59,1796100,1,13,4,34,129,47074129
36338,1,1796100,1,13,4,34,130,47074130
36339,74,1796200,1,13,4,34,204,47074204
36340,1,1796200,1,13,4,34,205,47074205
36341,24,1796100,1,13,4,34,229,47074229
36342,0,1796100,1,13,4,34,229,47074229
36343,1,1796100,1,13,4,34,230,47074230
36344,1,1796100,1,13,4,34,231,47074231
36345,6,1796300,1,13,4,34,237,47074237
36346,74,1796100,1,13,4,34,311,47074311
36347,65,1796100,1,13,4,34,376,47074376
36348,0,1796100,1,13,4,34,376,47074376
36349,24,1796100,1,13,4,34,400,47074400
36350,73,1796200,1,13,4,34,473,47074473
36351,18,1796300,1,13,4,34,491,47074491
36352,13,1796200,1,13,4,34,504,47074504
36353,2,1796200,1,13,4,34,506,47074506
36354,0,1796100,1,13,4,34,506,47074506
36355,95,1796100,1,13,4,34,601,47074601
36356,26,1796100,1,13,4,34,627,47074627
36357,31,1796200,1,13,4,34,658,47074658
36358,79,1796100,3,13,4,34,737,47074737
36359,61,1796200,1,13,4,34,798,47074798
36360,127,1796200,1,13,4,34,925,47074925
36361,25,1796100,3,13,4,34,950,47074950
36362,145,1796200,1,13,4,35,95,47075095
36363,111,1796100,1,13,4,35,206,47075206
36364,151,1796100,1,13,4,35,357,47075357
36365,74,1796100,1,13,4,35,431,47075431
36366,379,1796100,1,13,4,35,810,47075810
36367,169,1796200,1,13,4,35,979,47075979
36368,20,1796000,1,13,4,35,999,47075999
36369,12,1796000,1,13,4,36,11,47076011
36370,83,1796100,1,13,4,36,94,47076094
36371,30,1796000,1,13,4,36,124,47076124
36372,1,1796200,1,13,4,36,125,47076125
36373,79,1796100,1,13,4,36,204,47076204
36374,87,1796000,4,13,4,36,291,47076291
36375,105,1796200,3,13,4,36,396,47076396
36376,16,1796100,1,13,4,36,412,47076412
36378,36,1796000,1,13,4,36,448,47076448
36379,69,1796000,1,13,4,36,517,47076517
36380,106,1796000,1,13,4,36,623,47076623
36381,93,1796000,2,13,4,36,716,47076716
36382,19,1796000,1,13,4,36,735,47076735
36383,16,1796000,1,13,4,36,751,47076751
36384,30,1796000,8,13,4,36,781,47076781
36385,105,1796000,1,13,4,36,886,47076886
36386,30,1796200,1,13,4,36,916,47076916
36387,21,1796000,2,13,4,36,937,47076937
36388,225,1796100,1,13,4,37,162,47077162
36389,68,1796200,2,13,4,37,230,47077230
36390,580,1796100,1,13,4,37,810,47077810
36391,94,1796100,1,13,4,37,904,47077904
36392,60,1796000,2,13,4,37,964,47077964
36393,17,1796000,1,13,4,37,981,47077981
36394,5,1796200,5,13,4,37,986,47077986
36395,139,1796100,1,13,4,38,125,47078125
36396,0,1796100,1,13,4,38,125,47078125
36397,297,1796000,1,13,4,38,422,47078422
36398,82,1796000,2,13,4,38,504,47078504
36399,291,1796100,1,13,4,38,795,47078795
36400,70,1796000,1,13,4,38,865,47078865
36401,237,1796000,1,13,4,39,102,47079102
36402,119,1796000,10,13,4,39,221,47079221
36403,100,1796000,1,13,4,39,321,47079321
36404,69,1796000,4,13,4,39,390,47079390
36405,68,1796000,1,13,4,39,458,47079458
36406,68,1796000,1,13,4,39,526,47079526
36407,367,1796100,1,13,4,39,893,47079893
36408,120,1795900,4,13,4,40,13,47080013
36409,30,1796000,1,13,4,40,43,47080043
36410,67,1795900,1,13,4,40,110,47080110
36411,17,1795900,2,13,4,40,127,47080127
36412,2,1795900,2,13,4,40,129,47080129
36413,3,1795900,2,13,4,40,132,47080132
36414,26,1795900,1,13,4,40,158,47080158
36415,7,1795900,2,13,4,40,165,47080165
36416,18,1795900,1,13,4,40,183,47080183
36417,0,1796000,3,13,4,40,183,47080183
36418,89,1795900,1,13,4,40,272,47080272
36419,1,1795900,10,13,4,40,273,47080273
36420,0,1795900,8,13,4,40,273,47080273
36421,0,1795900,1,13,4,40,273,47080273
36422,1,1795900,1,13,4,40,274,47080274
36423,0,1795900,3,13,4,40,274,47080274
36424,15,1795800,1,13,4,40,289,47080289
36425,55,1795900,3,13,4,40,344,47080344
36426,136,1795900,2,13,4,40,480,47080480
36427,0,1795900,1,13,4,40,480,47080480
36428,34,1795900,1,13,4,40,514,47080514
36430,73,1795800,1,13,4,40,587,47080587
36431,138,1796000,1,13,4,40,725,47080725
36432,126,1796000,3,13,4,40,851,47080851
36433,64,1796000,2,13,4,40,915,47080915
36434,79,1795900,2,13,4,40,994,47080994
36435,57,1796000,1,13,4,41,51,47081051
36436,137,1796000,1,13,4,41,188,47081188
36437,8,1795900,1,13,4,41,196,47081196
36438,31,1796000,1,13,4,41,227,47081227
36439,171,1796100,1,13,4,41,398,47081398
36440,27,1796100,1,13,4,41,425,47081425
36441,427,1796200,2,13,4,41,852,47081852
36442,1,1796200,3,13,4,41,853,47081853
36443,124,1796200,1,13,4,41,977,47081977
36444,39,1796200,2,13,4,42,16,47082016
36445,137,1796200,1,13,4,42,153,47082153
36446,32,1796200,3,13,4,42,185,47082185
36447,287,1796100,3,13,4,42,472,47082472
36448,23,1796100,1,13,4,42,495,47082495
36449,87,1796100,1,13,4,42,582,47082582
36450,20,1796300,1,13,4,42,602,47082602
36451,14,1796100,1,13,4,42,616,47082616
36452,46,1796100,1,13,4,42,662,47082662
36454,124,1796100,1,13,4,42,786,47082786
36455,202,1796100,2,13,4,42,988,47082988
36456,130,1796100,1,13,4,43,118,47083118
36457,294,1796100,1,13,4,43,412,47083412
36458,80,1796200,1,13,4,43,492,47083492
36459,547,1796100,1,13,4,44,39,47084039
36460,158,1796000,1,13,4,44,197,47084197
36461,58,1796000,1,13,4,44,255,47084255
36462,207,1796100,1,13,4,44,462,47084462
36463,78,1796100,1,13,4,44,540,47084540
36464,187,1796100,1,13,4,44,727,47084727
36465,564,1796000,1,13,4,45,291,47085291
36466,96,1796000,1,13,4,45,387,47085387
36467,34,1796000,2,13,4,45,421,47085421
36468,89,1796000,2,13,4,45,510,47085510
36469,81,1796000,1,13,4,45,591,47085591
36470,149,1796100,2,13,4,45,740,47085740
36471,275,1796000,1,13,4,46,15,47086015
36472,35,1795900,1,13,4,46,50,47086050
36473,545,1795900,3,13,4,46,595,47086595
36474,162,1795900,6,13,4,46,757,47086757
36475,18,1795900,1,13,4,46,775,47086775
36476,724,1795800,1,13,4,47,499,47087499
36477,0,1795800,9,13,4,47,499,47087499
36478,0,1795800,1,13,4,47,499,47087499
36479,0,1795800,3,13,4,47,499,47087499
36480,3,1795700,1,13,4,47,502,47087502
36481,0,1795700,1,13,4,47,502,47087502
36482,0,1795700,1,13,4,47,502,47087502
36483,17,1795700,1,13,4,47,519,47087519
36484,4,1795700,1,13,4,47,523,47087523
36485,0,1795700,1,13,4,47,523,47087523
36486,91,1795700,1,13,4,47,614,47087614
36487,43,1795800,1,13,4,47,657,47087657
36488,17,1795800,1,13,4,47,674,47087674
36489,56,1795700,1,13,4,47,730,47087730
36490,59,1795700,1,13,4,47,789,47087789
36492,6,1795800,1,13,4,47,795,47087795
36493,47,1795600,1,13,4,47,842,47087842
36494,179,1795600,2,13,4,48,21,47088021
36495,44,1795600,1,13,4,48,65,47088065
36496,58,1795600,1,13,4,48,123,47088123
36497,4,1795600,1,13,4,48,127,47088127
36498,109,1795800,2,13,4,48,236,47088236
36499,10,1795700,2,13,4,48,246,47088246
36501,25,1795600,1,13,4,48,271,47088271
36502,101,1795700,1,13,4,48,372,47088372
36503,16,1795600,1,13,4,48,388,47088388
36504,47,1795600,1,13,4,48,435,47088435
36505,31,1795600,3,13,4,48,466,47088466
36506,123,1795600,1,13,4,48,589,47088589
36507,25,1795500,1,13,4,48,614,47088614
36508,20,1795500,1,13,4,48,634,47088634
36509,105,1795600,1,13,4,48,739,47088739
36510,108,1795500,2,13,4,48,847,47088847
36511,64,1795500,1,13,4,48,911,47088911
36512,2,1795500,1,13,4,48,913,47088913
36513,90,1795600,1,13,4,49,3,47089003
36514,13,1795600,1,13,4,49,16,47089016
36515,56,1795600,1,13,4,49,72,47089072
36516,22,1795500,1,13,4,49,94,47089094
36517,33,1795600,1,13,4,49,127,47089127
36518,68,1795600,1,13,4,49,195,47089195
36519,66,1795500,2,13,4,49,261,47089261
36520,100,1795500,5,13,4,49,361,47089361
36521,21,1795600,2,13,4,49,382,47089382
36522,24,1795600,1,13,4,49,406,47089406
36523,57,1795500,1,13,4,49,463,47089463
36524,55,1795600,2,13,4,49,518,47089518
36525,198,1795700,1,13,4,49,716,47089716
36526,111,1795600,1,13,4,49,827,47089827
36527,92,1795600,1,13,4,49,919,47089919
36528,20,1795700,2,13,4,49,939,47089939
36529,68,1795600,4,13,4,50,7,47090007
36531,47,1795600,3,13,4,50,54,47090054
36532,315,1795600,1,13,4,50,369,47090369
36533,3,1795600,1,13,4,50,372,47090372
36534,102,1795500,1,13,4,50,474,47090474
36535,3,1795500,2,13,4,50,477,47090477
36536,2,1795600,1,13,4,50,479,47090479
36537,240,1795600,3,13,4,50,719,47090719
36538,80,1795600,1,13,4,50,799,47090799
36539,29,1795600,1,13,4,50,828,47090828
36540,58,1795500,2,13,4,50,886,47090886
36541,87,1795600,1,13,4,50,973,47090973
36542,315,1795500,2,13,4,51,288,47091288
36543,0,1795500,3,13,4,51,288,47091288
36544,158,1795500,1,13,4,51,446,47091446
36545,97,1795500,1,13,4,51,543,47091543
36546,1,1795500,5,13,4,51,544,47091544
36548,52,1795400,1,13,4,51,596,47091596
36549,39,1795300,2,13,4,51,635,47091635
36550,16,1795500,1,13,4,51,651,47091651
36551,6,1795400,1,13,4,51,657,47091657
36553,2,1795300,2,13,4,51,659,47091659
36554,2,1795300,2,13,4,51,661,47091661
36555,88,1795300,1,13,4,51,749,47091749
36556,8,1795500,1,13,4,51,757,47091757
36557,27,1795500,2,13,4,51,784,47091784
36558,106,1795400,1,13,4,51,890,47091890
36559,9,1795500,2,13,4,51,899,47091899
36560,33,1795400,2,13,4,51,932,47091932
36561,59,1795500,1,13,4,51,991,47091991
36562,9,1795500,1,13,4,52,0,47092000
36563,17,1795400,1,13,4,52,17,47092017
36564,28,1795400,1,13,4,52,45,47092045
36565,151,1795600,1,13,4,52,196,47092196
36566,20,1795500,1,13,4,52,216,47092216
36567,66,1795500,1,13,4,52,282,47092282
36569,193,1795700,9,13,4,52,475,47092475
36570,139,1795600,1,13,4,52,614,47092614
36571,4,1795700,1,13,4,52,618,47092618
36572,254,1795600,1,13,4,52,872,47092872
36573,9,1795600,1,13,4,52,881,47092881
36574,188,1795800,5,13,4,53,69,47093069
36575,237,1795700,2,13,4,53,306,47093306
36576,36,1795700,1,13,4,53,342,47093342
36577,69,1795800,1,13,4,53,411,47093411
36578,24,1795800,1,13,4,53,435,47093435
36579,323,1795700,1,13,4,53,758,47093758
36580,67,1795700,2,13,4,53,825,47093825
36581,148,1795700,1,13,4,53,973,47093973
36582,80,1795700,1,13,4,54,53,47094053
36583,130,1795700,1,13,4,54,183,47094183
36584,175,1795600,1,13,4,54,358,47094358
36585,0,1795600,1,13,4,54,358,47094358
36586,1,1795600,1,13,4,54,359,47094359
36587,12,1795600,1,13,4,54,371,47094371
36588,63,1795500,1,13,4,54,434,47094434
36589,601,1795500,4,13,4,55,35,47095035
36591,90,1795400,1,13,4,55,125,47095125
36592,26,1795400,1,13,4,55,151,47095151
36593,2,1795400,1,13,4,55,153,47095153
36594,0,1795400,1,13,4,55,153,47095153
36595,0,1795400,1,13,4,55,153,47095153
36596,0,1795400,1,13,4,55,153,47095153
36597,1,1795300,1,13,4,55,154,47095154
36598,26,1795400,1,13,4,55,180,47095180
36599,3,1795500,1,13,4,55,183,47095183
36600,21,1795600,1,13,4,55,204,47095204
36601,32,1795600,2,13,4,55,236,47095236
36602,13,1795700,5,13,4,55,249,47095249
36603,293,1795600,1,13,4,55,542,47095542
36604,138,1795600,1,13,4,55,680,47095680
36605,571,1795600,1,13,4,56,251,47096251
36606,140,1795500,1,13,4,56,391,47096391
36607,108,1795500,6,13,4,56,499,47096499
36608,329,1795500,4,13,4,56,828,47096828
36609,31,1795500,1,13,4,56,859,47096859
36610,107,1795500,1,13,4,56,966,47096966
36611,196,1795600,1,13,4,57,162,47097162
36612,333,1795600,1,13,4,57,495,47097495
36613,11,1795400,1,13,4,57,506,47097506
36614,235,1795500,2,13,4,57,741,47097741
36615,290,1795500,2,13,4,58,31,47098031
36616,0,1795400,1,13,4,58,31,47098031
36617,343,1795600,1,13,4,58,374,47098374
36618,119,1795600,1,13,4,58,493,47098493
36619,235,1795500,1,13,4,58,728,47098728
36620,77,1795600,1,13,4,58,805,47098805
36621,508,1795700,1,13,4,59,313,47099313
36622,274,1795600,1,13,4,59,587,47099587
36624,245,1795700,1,13,4,59,832,47099832
36625,97,1795600,2,13,4,59,929,47099929
36626,1,1795600,5,13,4,59,930,47099930
36627,89,1795600,4,13,5,0,19,47100019
36629,32,1795500,6,13,5,0,51,47100051
36631,1,1795500,1,13,5,0,52,47100052
36632,50,1795600,1,13,5,0,102,47100102
36634,0,1795500,5,13,5,0,102,47100102
36635,0,1795400,1,13,5,0,102,47100102
36636,0,1795400,1,13,5,0,102,47100102
36637,1,1795400,2,13,5,0,103,47100103
36638,0,1795500,1,13,5,0,103,47100103
36639,0,1795400,1,13,5,0,103,47100103
36640,0,1795300,2,13,5,0,103,47100103
36641,4,1795500,1,13,5,0,107,47100107
36642,114,1795400,1,13,5,0,221,47100221
36644,16,1795300,1,13,5,0,237,47100237
36645,20,1795400,3,13,5,0,257,47100257
36647,90,1795400,1,13,5,0,347,47100347
36648,16,1795300,1,13,5,0,363,47100363
36649,6,1795300,4,13,5,0,369,47100369
36650,16,1795400,1,13,5,0,385,47100385
36651,66,1795400,1,13,5,0,451,47100451
36652,26,1795300,2,13,5,0,477,47100477
36653,17,1795400,2,13,5,0,494,47100494
36654,42,1795500,1,13,5,0,536,47100536
36655,101,1795400,1,13,5,0,637,47100637
36656,222,1795300,1,13,5,0,859,47100859
36657,62,1795400,1,13,5,0,921,47100921
36658,27,1795300,1,13,5,0,948,47100948
36659,43,1795200,1,13,5,0,991,47100991
36660,93,1795200,1,13,5,1,84,47101084
36661,10,1795200,1,13,5,1,94,47101094
36662,7,1795200,1,13,5,1,101,47101101
36663,0,1795200,1,13,5,1,101,47101101
36664,0,1795200,1,13,5,1,101,47101101
36665,0,1795200,1,13,5,1,101,47101101
36666,0,1795200,1,13,5,1,101,47101101
36667,0,1795200,1,13,5,1,101,47101101
36668,0,1795200,1,13,5,1,101,47101101
36669,0,1795200,1,13,5,1,101,47101101
36670,0,1795100,1,13,5,1,101,47101101
36671,0,1795100,1,13,5,1,101,47101101
36672,0,1795100,1,13,5,1,101,47101101
36673,0,1795100,1,13,5,1,101,47101101
36674,1,1795100,1,13,5,1,102,47101102
36675,0,1795100,1,13,5,1,102,47101102
36676,24,1795100,1,13,5,1,126,47101126
36677,14,1795300,1,13,5,1,140,47101140
36678,7,1795100,1,13,5,1,147,47101147
36679,6,1795100,1,13,5,1,153,47101153
36680,26,1795100,1,13,5,1,179,47101179
36681,3,1795100,1,13,5,1,182,47101182
36682,20,1795100,1,13,5,1,202,47101202
36683,9,1795100,1,13,5,1,211,47101211
36684,11,1795300,1,13,5,1,222,47101222
36685,29,1795300,1,13,5,1,251,47101251
36686,91,1795300,1,13,5,1,342,47101342
36687,9,1795300,1,13,5,1,351,47101351
36689,56,1795200,1,13,5,1,407,47101407
36690,5,1795200,1,13,5,1,412,47101412
36691,23,1795200,1,13,5,1,435,47101435
36692,34,1795200,1,13,5,1,469,47101469
36693,45,1795200,1,13,5,1,514,47101514
36694,15,1795200,1,13,5,1,529,47101529
36695,22,1795200,1,13,5,1,551,47101551
36696,3,1795400,1,13,5,1,554,47101554
36697,5,1795200,1,13,5,1,559,47101559
36698,1,1795200,1,13,5,1,560,47101560
36699,30,1795200,1,13,5,1,590,47101590
36700,74,1795400,1,13,5,1,664,47101664
36701,20,1795400,4,13,5,1,684,47101684
36702,44,1795500,1,13,5,1,728,47101728
36703,50,1795300,1,13,5,1,778,47101778
36704,29,1795500,1,13,5,1,807,47101807
36705,108,1795500,1,13,5,1,915,47101915
36706,122,1795400,2,13,5,2,37,47102037
36707,72,1795500,13,13,5,2,109,47102109
36708,98,1795500,1,13,5,2,207,47102207
36710,18,1795600,4,13,5,2,225,47102225
36711,1,1795600,1,13,5,2,226,47102226
36712,0,1795600,1,13,5,2,226,47102226
36713,40,1795600,1,13,5,2,266,47102266
36714,5,1795500,1,13,5,2,271,47102271
36715,301,1795700,1,13,5,2,572,47102572
36716,20,1795600,2,13,5,2,592,47102592
36717,61,1795700,1,13,5,2,653,47102653
36718,100,1795600,1,13,5,2,753,47102753
36719,83,1795700,1,13,5,2,836,47102836
36720,61,1795500,1,13,5,2,897,47102897
36721,52,1795600,1,13,5,2,949,47102949
36722,183,1795600,4,13,5,3,132,47103132
36723,71,1795700,2,13,5,3,203,47103203
36724,16,1795700,1,13,5,3,219,47103219
36725,9,1795700,3,13,5,3,228,47103228
36726,0,1795700,1,13,5,3,228,47103228
36727,63,1795600,3,13,5,3,291,47103291
36728,14,1795700,1,13,5,3,305,47103305
36729,85,1795800,2,13,5,3,390,47103390
36730,75,1795600,1,13,5,3,465,47103465
36731,8,1795600,2,13,5,3,473,47103473
36732,595,1795800,2,13,5,4,68,47104068
36733,79,1795800,1,13,5,4,147,47104147
36734,31,1795800,1,13,5,4,178,47104178
36735,0,1795800,1,13,5,4,178,47104178
36736,1,1795800,1,13,5,4,179,47104179
36737,365,1795700,1,13,5,4,544,47104544
36738,45,1795700,1,13,5,4,589,47104589
36739,56,1795900,1,13,5,4,645,47104645
36740,4,1795900,1,13,5,4,649,47104649
36741,106,1795900,5,13,5,4,755,47104755
36742,135,1795900,1,13,5,4,890,47104890
36743,129,1795900,8,13,5,5,19,47105019
36744,73,1795900,1,13,5,5,92,47105092
36745,1,1795900,1,13,5,5,93,47105093
36746,1,1795900,1,13,5,5,94,47105094
36747,53,1795700,1,13,5,5,147,47105147
36748,59,1795700,1,13,5,5,206,47105206
36749,19,1795900,5,13,5,5,225,47105225
36750,12,1795900,1,13,5,5,237,47105237
36751,61,1795800,2,13,5,5,298,47105298
36753,184,1796000,14,13,5,5,482,47105482
36754,387,1796000,1,13,5,5,869,47105869
36755,1,1796000,4,13,5,5,870,47105870
36756,126,1795900,1,13,5,5,996,47105996
36757,306,1795900,2,13,5,6,302,47106302
36758,3,1795900,2,13,5,6,305,47106305
36759,3,1796000,1,13,5,6,308,47106308
36760,107,1795800,4,13,5,6,415,47106415
36762,1,1795900,1,13,5,6,416,47106416
36763,101,1795800,1,13,5,6,517,47106517
36764,37,1795900,1,13,5,6,554,47106554
36765,10,1795700,5,13,5,6,564,47106564
36766,223,1795800,1,13,5,6,787,47106787
36767,133,1795800,1,13,5,6,920,47106920
36768,232,1795700,1,13,5,7,152,47107152
36769,73,1795600,1,13,5,7,225,47107225
36770,0,1795600,1,13,5,7,225,47107225
36771,0,1795600,1,13,5,7,225,47107225
36772,1,1795600,1,13,5,7,226,47107226
36773,0,1795600,1,13,5,7,226,47107226
36774,0,1795600,1,13,5,7,226,47107226
36775,1,1795600,1,13,5,7,227,47107227
36776,44,1795700,2,13,5,7,271,47107271
36777,268,1795700,1,13,5,7,539,47107539
36778,45,1795700,2,13,5,7,584,47107584
36779,88,1795700,2,13,5,7,672,47107672
36780,114,1795700,1,13,5,7,786,47107786
36781,131,1795700,2,13,5,7,917,47107917
36782,92,1795800,1,13,5,8,9,47108009
36783,202,1795700,1,13,5,8,211,47108211
36784,18,1795700,1,13,5,8,229,47108229
36785,495,1795700,1,13,5,8,724,47108724
36786,147,1795600,1,13,5,8,871,47108871
36787,22,1795600,3,13,5,8,893,47108893
36788,29,1795500,5,13,5,8,922,47108922
36789,149,1795500,2,13,5,9,71,47109071
36791,47,1795500,1,13,5,9,118,47109118
36792,109,1795400,1,13,5,9,227,47109227
36793,317,1795400,1,13,5,9,544,47109544
36794,1,1795400,2,13,5,9,545,47109545
36795,285,1795500,2,13,5,9,830,47109830
36796,446,1795600,1,13,5,10,276,47110276
36797,74,1795400,4,13,5,10,350,47110350
36798,774,1795600,1,13,5,11,124,47111124
36799,1153,1795500,1,13,5,12,277,47112277
36800,1,1795600,1,13,5,12,278,47112278
36801,108,1795600,1,13,5,12,386,47112386
36802,311,1795700,3,13,5,12,697,47112697
36803,0,1795700,1,13,5,12,697,47112697
36804,501,1795800,3,13,5,13,198,47113198
36806,77,1795800,2,13,5,13,275,47113275
36807,9,1795600,6,13,5,13,284,47113284
36808,31,1795700,1,13,5,13,315,47113315
36809,467,1795700,1,13,5,13,782,47113782
36810,389,1795900,2,13,5,14,171,47114171
36811,49,1795700,2,13,5,14,220,47114220
36812,1,1795700,1,13,5,14,221,47114221
36813,131,1795900,1,13,5,14,352,47114352
36814,761,1795900,2,13,5,15,113,47115113
36815,271,1795700,4,13,5,15,384,47115384
36817,1,1795700,1,13,5,15,385,47115385
36818,47,1795800,1,13,5,15,432,47115432
36819,289,1795700,1,13,5,15,721,47115721
36820,447,1795800,1,13,5,16,168,47116168
36821,189,1795800,1,13,5,16,357,47116357
36822,197,1795800,1,13,5,16,554,47116554
36823,54,1795800,1,13,5,16,608,47116608
36824,602,1795900,1,13,5,17,210,47117210
36825,0,1795900,1,13,5,17,210,47117210
36826,0,1795900,1,13,5,17,210,47117210
36827,15,1795800,1,13,5,17,225,47117225
36828,1,1795800,1,13,5,17,226,47117226
36829,0,1795800,1,13,5,17,226,47117226
36830,0,1795800,1,13,5,17,226,47117226
36831,0,1795800,1,13,5,17,226,47117226
36832,0,1795700,1,13,5,17,226,47117226
36833,5,1795900,3,13,5,17,231,47117231
36834,48,1795900,1,13,5,17,279,47117279
36835,294,1795900,1,13,5,17,573,47117573
36836,456,1796000,1,13,5,18,29,47118029
36837,442,1796000,4,13,5,18,471,47118471
36838,1,1796000,2,13,5,18,472,47118472
36839,270,1796100,1,13,5,18,742,47118742
36840,1,1796100,1,13,5,18,743,47118743
36841,133,1796100,1,13,5,18,876,47118876
36842,65,1796100,2,13,5,18,941,47118941
36843,35,1796200,1,13,5,18,976,47118976
36844,731,1796100,1,13,5,19,707,47119707
36845,371,1796000,1,13,5,20,78,47120078
36846,302,1796000,1,13,5,20,380,47120380
36847,0,1796000,4,13,5,20,380,47120380
36848,0,1796000,1,13,5,20,380,47120380
36849,575,1796000,2,13,5,20,955,47120955
36850,69,1796000,1,13,5,21,24,47121024
36851,296,1796000,1,13,5,21,320,47121320
36852,256,1796100,2,13,5,21,576,47121576
36853,23,1796000,3,13,5,21,599,47121599
36854,1,1796000,3,13,5,21,600,47121600
36855,76,1796000,1,13,5,21,676,47121676
36856,386,1796000,5,13,5,22,62,47122062
36858,78,1796000,1,13,5,22,140,47122140
36859,88,1795900,1,13,5,22,228,47122228
36860,92,1795900,1,13,5,22,320,47122320
36861,453,1796000,1,13,5,22,773,47122773
36862,206,1796000,1,13,5,22,979,47122979
36864,348,1796100,2,13,5,23,327,47123327
36865,545,1796000,1,13,5,23,872,47123872
36866,307,1796100,1,13,5,24,179,47124179
36867,0,1796100,2,13,5,24,179,47124179
36868,187,1796200,1,13,5,24,366,47124366
36869,954,1796100,1,13,5,25,320,47125320
36870,571,1796000,1,13,5,25,891,47125891
36871,1112,1796200,5,13,5,27,3,47127003
36872,49,1796200,1,13,5,27,52,47127052
36873,142,1796100,2,13,5,27,194,47127194
36874,178,1796100,1,13,5,27,372,47127372
36875,0,1796100,2,13,5,27,372,47127372
36876,1052,1796100,1,13,5,28,424,47128424
36877,51,1795900,1,13,5,28,475,47128475
36878,0,1795900,1,13,5,28,475,47128475
36879,0,1795900,1,13,5,28,475,47128475
36880,0,1795900,1,13,5,28,475,47128475
36881,0,1795900,1,13,5,28,475,47128475
36882,1,1795900,1,13,5,28,476,47128476
36883,0,1795900,1,13,5,28,476,47128476
36884,0,1795900,1,13,5,28,476,47128476
36885,0,1795900,1,13,5,28,476,47128476
36886,0,1795900,1,13,5,28,476,47128476
36887,0,1795900,1,13,5,28,476,47128476
36888,0,1795900,1,13,5,28,476,47128476
36889,0,1795900,1,13,5,28,476,47128476
36890,0,1795900,1,13,5,28,476,47128476
36891,0,1795900,1,13,5,28,476,47128476
36892,1,1795900,1,13,5,28,477,47128477
36893,398,1796000,5,13,5,28,875,47128875
36894,270,1796000,1,13,5,29,145,47129145
36895,305,1796000,1,13,5,29,450,47129450
36896,414,1796100,5,13,5,29,864,47129864
36897,887,1796000,3,13,5,30,751,47130751
36899,180,1795900,1,13,5,30,931,47130931
36900,850,1796100,1,13,5,31,781,47131781
36901,123,1796100,1,13,5,31,904,47131904
36902,103,1796100,2,13,5,32,7,47132007
36903,493,1796000,1,13,5,32,500,47132500
36904,683,1796100,1,13,5,33,183,47133183
36905,96,1796200,2,13,5,33,279,47133279
36906,152,1796100,1,13,5,33,431,47133431
36907,117,1796100,2,13,5,33,548,47133548
36908,454,1796100,4,13,5,34,2,47134002
36910,355,1796100,1,13,5,34,357,47134357
36911,143,1796100,2,13,5,34,500,47134500
36912,1208,1796200,2,13,5,35,708,47135708
36913,163,1796200,1,13,5,35,871,47135871
36914,1204,1796000,2,13,5,37,75,47137075
36915,0,1796000,1,13,5,37,75,47137075
36916,0,1796000,5,13,5,37,75,47137075
36917,29,1796000,1,13,5,37,104,47137104
36918,38,1796100,1,13,5,37,142,47137142
36919,94,1796100,5,13,5,37,236,47137236
36920,1610,1796000,1,13,5,38,846,47138846
36921,4,1795900,1,13,5,38,850,47138850
36922,0,1795900,1,13,5,38,850,47138850
36923,0,1795900,1,13,5,38,850,47138850
36924,191,1796000,1,13,5,39,41,47139041
36925,153,1796000,1,13,5,39,194,47139194
36926,213,1796000,2,13,5,39,407,47139407
36927,888,1796000,3,13,5,40,295,47140295
36928,0,1796000,7,13,5,40,295,47140295
36929,528,1796000,1,13,5,40,823,47140823
36930,954,1795900,1,13,5,41,777,47141777
36931,918,1796000,1,13,5,42,695,47142695
36932,70,1796000,1,13,5,42,765,47142765
36933,518,1795900,1,13,5,43,283,47143283
36934,907,1796000,1,13,5,44,190,47144190
36935,201,1796100,1,13,5,44,391,47144391
36936,104,1796000,1,13,5,44,495,47144495
36937,184,1796000,2,13,5,44,679,47144679
36938,3,1796000,1,13,5,44,682,47144682
36939,832,1796000,2,13,5,45,514,47145514
36940,18,1796100,1,13,5,45,532,47145532
36941,1112,1796100,1,13,5,46,644,47146644
36942,191,1795900,1,13,5,46,835,47146835
36943,1783,1796000,1,13,5,48,618,47148618
36945,2675,1796000,1,13,5,51,293,47151293
36946,650,1796000,1,13,5,51,943,47151943
36948,2,1795900,2,13,5,51,945,47151945
36949,59,1796000,1,13,5,52,4,47152004
36950,843,1795900,2,13,5,52,847,47152847
36951,1144,1795800,1,13,5,53,991,47153991
36952,1,1795800,7,13,5,53,992,47153992
36953,9,1795700,1,13,5,54,1,47154001
36954,0,1795700,2,13,5,54,1,47154001
36955,1,1795700,1,13,5,54,2,47154002
36956,184,1795800,1,13,5,54,186,47154186
36957,1894,1795700,1,13,5,56,80,47156080
36958,0,1795700,3,13,5,56,80,47156080
36959,194,1795600,3,13,5,56,274,47156274
36960,1,1795600,1,13,5,56,275,47156275
36961,0,1795600,6,13,5,56,275,47156275
36962,64,1795500,4,13,5,56,339,47156339
36963,43,1795500,1,13,5,56,382,47156382
36964,431,1795600,1,13,5,56,813,47156813
36965,4,1795600,2,13,5,56,817,47156817
36967,2,1795700,1,13,5,56,819,47156819
36968,117,1795600,1,13,5,56,936,47156936
36969,66,1795600,1,13,5,57,2,47157002
36970,98,1795600,1,13,5,57,100,47157100
36971,1081,1795700,1,13,5,58,181,47158181
36972,87,1795600,1,13,5,58,268,47158268
36973,688,1795600,1,13,5,58,956,47158956
36975,1875,1795600,1,13,6,0,831,47160831
36976,95,1795600,3,13,6,0,926,47160926
36978,57,1795500,1,13,6,0,983,47160983
36979,21,1795500,4,13,6,1,4,47161004
36980,12,1795600,1,13,6,1,16,47161016
36981,41,1795500,9,13,6,1,57,47161057
36982,1,1795500,1,13,6,1,58,47161058
36983,0,1795500,23,13,6,1,58,47161058
36984,12,1795400,1,13,6,1,70,47161070
36985,2,1795500,1,13,6,1,72,47161072
36986,5,1795500,1,13,6,1,77,47161077
36987,4,1795400,1,13,6,1,81,47161081
36988,4,1795400,1,13,6,1,85,47161085
36989,5,1795400,2,13,6,1,90,47161090
36990,10,1795400,1,13,6,1,100,47161100
36991,13,1795400,2,13,6,1,113,47161113
36992,1,1795500,1,13,6,1,114,47161114
36993,0,1795400,1,13,6,1,114,47161114
36994,13,1795500,1,13,6,1,127,47161127
36995,225,1795400,1,13,6,1,352,47161352
36996,2,1795400,1,13,6,1,354,47161354
36997,19,1795400,1,13,6,1,373,47161373
36998,6,1795400,1,13,6,1,379,47161379
36999,88,1795500,1,13,6,1,467,47161467
37000,27,1795300,1,13,6,1,494,47161494
37001,26,1795300,1,13,6,1,520,47161520
37002,64,1795300,1,13,6,1,584,47161584
37003,87,1795500,1,13,6,1,671,47161671
37004,12,1795500,1,13,6,1,683,47161683
37005,235,1795300,1,13,6,1,918,47161918
37006,110,1795300,1,13,6,2,28,47162028
37007,76,1795300,1,13,6,2,104,47162104
37008,24,1795500,1,13,6,2,128,47162128
37009,61,1795400,4,13,6,2,189,47162189
37010,89,1795300,1,13,6,2,278,47162278
37011,267,1795300,5,13,6,2,545,47162545
37012,0,1795300,1,13,6,2,545,47162545
37013,248,1795200,1,13,6,2,793,47162793
37014,31,1795400,1,13,6,2,824,47162824
37015,292,1795200,1,13,6,3,116,47163116
37016,67,1795400,1,13,6,3,183,47163183
37017,88,1795400,1,13,6,3,271,47163271
37018,68,1795400,1,13,6,3,339,47163339
37019,488,1795500,1,13,6,3,827,47163827
37020,0,1795500,5,13,6,3,827,47163827
37021,14,1795500,3,13,6,3,841,47163841
37023,298,1795400,1,13,6,4,139,47164139
37024,58,1795500,1,13,6,4,197,47164197
37025,209,1795500,1,13,6,4,406,47164406
37026,238,1795400,1,13,6,4,644,47164644
37027,72,1795500,1,13,6,4,716,47164716
37028,114,1795500,1,13,6,4,830,47164830
37029,95,1795400,1,13,6,4,925,47164925
37030,134,1795500,1,13,6,5,59,47165059
37031,0,1795500,1,13,6,5,59,47165059
37032,191,1795500,1,13,6,5,250,47165250
37033,1146,1795600,1,13,6,6,396,47166396
37034,261,1795500,3,13,6,6,657,47166657
37036,2,1795400,2,13,6,6,659,47166659
37037,568,1795500,2,13,6,7,227,47167227
37039,543,1795500,1,13,6,7,770,47167770
37040,579,1795400,1,13,6,8,349,47168349
37041,85,1795600,1,13,6,8,434,47168434
37042,36,1795400,1,13,6,8,470,47168470
37043,702,1795500,1,13,6,9,172,47169172
37044,148,1795600,1,13,6,9,320,47169320
37045,713,1795500,1,13,6,10,33,47170033
37046,610,1795600,1,13,6,10,643,47170643
37047,100,1795500,1,13,6,10,743,47170743
37048,369,1795600,1,13,6,11,112,47171112
37049,1482,1795500,2,13,6,12,594,47172594
37050,567,1795400,1,13,6,13,161,47173161
37051,148,1795300,1,13,6,13,309,47173309
37052,120,1795300,2,13,6,13,429,47173429
37053,0,1795300,1,13,6,13,429,47173429
37054,0,1795300,4,13,6,13,429,47173429
37055,152,1795200,5,13,6,13,581,47173581
37056,52,1795200,7,13,6,13,633,47173633
37057,157,1795100,2,13,6,13,790,47173790
37058,66,1795100,1,13,6,13,856,47173856
37059,6,1795100,1,13,6,13,862,47173862
37060,8,1795100,7,13,6,13,870,47173870
37061,1,1795100,3,13,6,13,871,47173871
37062,0,1795100,4,13,6,13,871,47173871
37063,13,1795100,1,13,6,13,884,47173884
37064,74,1795100,1,13,6,13,958,47173958
37065,35,1795100,2,13,6,13,993,47173993
37066,58,1795000,5,13,6,14,51,47174051
37067,47,1795000,5,13,6,14,98,47174098
37068,50,1795000,1,13,6,14,148,47174148
37069,33,1795000,1,13,6,14,181,47174181
37070,0,1795000,1,13,6,14,181,47174181
37071,8,1795000,22,13,6,14,189,47174189
37072,1,1795000,14,13,6,14,190,47174190
37073,0,1795000,1,13,6,14,190,47174190
37074,0,1795000,1,13,6,14,190,47174190
37075,1,1795000,1,13,6,14,191,47174191
37076,0,1795000,2,13,6,14,191,47174191
37077,4,1794900,1,13,6,14,195,47174195
37078,5,1794900,1,13,6,14,200,47174200
37079,50,1794900,1,13,6,14,250,47174250
37080,29,1794900,1,13,6,14,279,47174279
37081,53,1794900,1,13,6,14,332,47174332
37082,1,1794900,2,13,6,14,333,47174333
37083,60,1795000,1,13,6,14,393,47174393
37084,11,1795000,3,13,6,14,404,47174404
37085,31,1794900,1,13,6,14,435,47174435
37086,0,1794900,1,13,6,14,435,47174435
37087,3,1794900,1,13,6,14,438,47174438
37088,6,1794900,1,13,6,14,444,47174444
37089,1,1794900,1,13,6,14,445,47174445
37090,0,1794900,1,13,6,14,445,47174445
37091,1,1794800,1,13,6,14,446,47174446
37092,1,1794800,1,13,6,14,447,47174447
37093,0,1794800,1,13,6,14,447,47174447
37094,15,1794800,2,13,6,14,462,47174462
37095,6,1794800,1,13,6,14,468,47174468
37096,11,1795000,1,13,6,14,479,47174479
37097,210,1795000,1,13,6,14,689,47174689
37098,33,1794900,1,13,6,14,722,47174722
37099,0,1794900,2,13,6,14,722,47174722
37100,45,1795000,1,13,6,14,767,47174767
37101,379,1794900,1,13,6,15,146,47175146
37102,98,1795100,1,13,6,15,244,47175244
37103,292,1795100,2,13,6,15,536,47175536
37104,14,1795100,1,13,6,15,550,47175550
37105,55,1795000,2,13,6,15,605,47175605
37106,481,1795200,1,13,6,16,86,47176086
37107,231,1795100,1,13,6,16,317,47176317
37108,233,1795100,1,13,6,16,550,47176550
37109,174,1795100,1,13,6,16,724,47176724
37110,228,1795100,5,13,6,16,952,47176952
37112,362,1795200,1,13,6,17,314,47177314
37114,37,1795200,1,13,6,17,351,47177351
37115,0,1795100,1,13,6,17,351,47177351
37116,614,1795200,1,13,6,17,965,47177965
37117,544,1795200,1,13,6,18,509,47178509
37118,41,1795200,1,13,6,18,550,47178550
37119,18,1795200,1,13,6,18,568,47178568
37120,275,1795100,1,13,6,18,843,47178843
37121,313,1795100,1,13,6,19,156,47179156
37122,222,1795100,1,13,6,19,378,47179378
37123,163,1795100,1,13,6,19,541,47179541
37124,374,1795200,1,13,6,19,915,47179915
37125,138,1795100,1,13,6,20,53,47180053
37126,0,1795100,3,13,6,20,53,47180053
37127,0,1795000,4,13,6,20,53,47180053
37128,60,1795000,2,13,6,20,113,47180113
37129,374,1794900,4,13,6,20,487,47180487
37130,1,1794800,5,13,6,20,488,47180488
37131,0,1794800,1,13,6,20,488,47180488
37132,14,1794900,1,13,6,20,502,47180502
37133,359,1794900,1,13,6,20,861,47180861
37134,140,1794900,1,13,6,21,1,47181001
37135,728,1794900,1,13,6,21,729,47181729
37136,392,1794900,1,13,6,22,121,47182121
37137,313,1794900,1,13,6,22,434,47182434
37138,86,1794900,3,13,6,22,520,47182520
37139,276,1794800,10,13,6,22,796,47182796
37140,0,1794800,1,13,6,22,796,47182796
37141,56,1794700,1,13,6,22,852,47182852
37142,95,1794700,2,13,6,22,947,47182947
37143,25,1794800,1,13,6,22,972,47182972
37144,4,1794700,1,13,6,22,976,47182976
37145,1,1794700,18,13,6,22,977,47182977
37146,1,1794700,1,13,6,22,978,47182978
37147,26,1794700,1,13,6,23,4,47183004
37148,28,1794700,1,13,6,23,32,47183032
37149,29,1794600,2,13,6,23,61,47183061
37150,41,1794700,1,13,6,23,102,47183102
37151,102,1794600,2,13,6,23,204,47183204
37152,5,1794600,1,13,6,23,209,47183209
37153,26,1794600,1,13,6,23,235,47183235
37154,7,1794600,1,13,6,23,242,47183242
37155,21,1794800,1,13,6,23,263,47183263
37156,128,1794700,1,13,6,23,391,47183391
37157,15,1794600,1,13,6,23,406,47183406
37158,35,1794600,1,13,6,23,441,47183441
37159,151,1794600,1,13,6,23,592,47183592
37160,459,1794700,1,13,6,24,51,47184051
37161,112,1794700,2,13,6,24,163,47184163
37163,54,1794700,1,13,6,24,217,47184217
37165,39,1794600,1,13,6,24,256,47184256
37166,0,1794600,1,13,6,24,256,47184256
37167,9,1794600,1,13,6,24,265,47184265
37168,14,1794600,1,13,6,24,279,47184279
37169,22,1794800,1,13,6,24,301,47184301
37170,44,1794800,1,13,6,24,345,47184345
37171,58,1794700,1,13,6,24,403,47184403
37172,83,1794600,4,13,6,24,486,47184486
37173,1,1794600,1,13,6,24,487,47184487
37174,29,1794600,1,13,6,24,516,47184516
37175,0,1794600,1,13,6,24,516,47184516
37176,27,1794500,9,13,6,24,543,47184543
37177,21,1794600,1,13,6,24,564,47184564
37178,65,1794500,1,13,6,24,629,47184629
37179,49,1794600,1,13,6,24,678,47184678
37180,1,1794500,1,13,6,24,679,47184679
37181,15,1794500,2,13,6,24,694,47184694
37182,33,1794500,2,13,6,24,727,47184727
37183,28,1794500,2,13,6,24,755,47184755
37184,5,1794600,1,13,6,24,760,47184760
37185,74,1794500,1,13,6,24,834,47184834
37186,40,1794700,1,13,6,24,874,47184874
37187,0,1794600,2,13,6,24,874,47184874
37189,122,1794700,2,13,6,24,996,47184996
37190,34,1794500,1,13,6,25,30,47185030
37191,8,1794500,1,13,6,25,38,47185038
37192,85,1794500,1,13,6,25,123,47185123
37193,41,1794500,1,13,6,25,164,47185164
37194,174,1794500,1,13,6,25,338,47185338
37195,13,1794600,1,13,6,25,351,47185351
37196,2,1794600,1,13,6,25,353,47185353
37197,141,1794600,1,13,6,25,494,47185494
37199,12,1794500,2,13,6,25,506,47185506
37200,54,1794500,2,13,6,25,560,47185560
37201,17,1794400,1,13,6,25,577,47185577
37202,218,1794500,1,13,6,25,795,47185795
37203,31,1794400,1,13,6,25,826,47185826
37204,25,1794500,1,13,6,25,851,47185851
37205,8,1794400,1,13,6,25,859,47185859
37206,138,1794400,1,13,6,25,997,47185997
37207,2,1794400,10,13,6,25,999,47185999
37208,7,1794400,1,13,6,26,6,47186006
37209,16,1794300,1,13,6,26,22,47186022
37210,22,1794300,1,13,6,26,44,47186044
37211,15,1794400,1,13,6,26,59,47186059
37212,20,1794500,1,13,6,26,79,47186079
37213,89,1794500,1,13,6,26,168,47186168
37214,31,1794400,1,13,6,26,199,47186199
37215,104,1794400,1,13,6,26,303,47186303
37216,24,1794400,3,13,6,26,327,47186327
37218,1,1794300,1,13,6,26,328,47186328
37219,13,1794300,1,13,6,26,341,47186341
37220,2,1794300,1,13,6,26,343,47186343
37221,62,1794300,5,13,6,26,405,47186405
37223,7,1794200,1,13,6,26,412,47186412
37224,11,1794200,5,13,6,26,423,47186423
37225,42,1794300,1,13,6,26,465,47186465
37226,24,1794300,1,13,6,26,489,47186489
37227,45,1794300,1,13,6,26,534,47186534
37229,22,1794300,1,13,6,26,556,47186556
37230,5,1794200,1,13,6,26,561,47186561
37231,2,1794200,1,13,6,26,563,47186563
37232,48,1794200,1,13,6,26,611,47186611
37233,1,1794200,1,13,6,26,612,47186612
37234,13,1794200,1,13,6,26,625,47186625
37235,0,1794100,1,13,6,26,625,47186625
37236,10,1794100,1,13,6,26,635,47186635
37237,21,1794100,1,13,6,26,656,47186656
37238,24,1794100,1,13,6,26,680,47186680
37239,17,1794100,1,13,6,26,697,47186697
37240,8,1794300,2,13,6,26,705,47186705
37241,0,1794100,1,13,6,26,705,47186705
37242,19,1794100,1,13,6,26,724,47186724
37243,0,1794100,1,13,6,26,724,47186724
37244,4,1794100,5,13,6,26,728,47186728
37246,11,1794100,1,13,6,26,739,47186739
37248,3,1794000,12,13,6,26,742,47186742
37250,3,1793900,1,13,6,26,745,47186745
37251,0,1793900,1,13,6,26,745,47186745
37252,1,1793800,2,13,6,26,746,47186746
37253,2,1793800,1,13,6,26,748,47186748
37254,3,1793800,1,13,6,26,751,47186751
37255,0,1793800,5,13,6,26,751,47186751
37256,0,1793800,1,13,6,26,751,47186751
37257,1,1793800,2,13,6,26,752,47186752
37258,3,1793800,1,13,6,26,755,47186755
37259,18,1793900,2,13,6,26,773,47186773
37260,32,1793900,1,13,6,26,805,47186805
37261,17,1793800,1,13,6,26,822,47186822
37262,1,1793800,1,13,6,26,823,47186823
37263,33,1794100,1,13,6,26,856,47186856
37264,25,1794000,2,13,6,26,881,47186881
37265,27,1794000,1,13,6,26,908,47186908
37266,0,1794000,1,13,6,26,908,47186908
37268,2,1793900,1,13,6,26,910,47186910
37269,26,1793900,1,13,6,26,936,47186936
37270,32,1793800,1,13,6,26,968,47186968
37271,2,1794000,1,13,6,26,970,47186970
37272,6,1794100,2,13,6,26,976,47186976
37273,14,1794000,1,13,6,26,990,47186990
37274,3,1794200,1,13,6,26,993,47186993
37275,14,1794000,1,13,6,27,7,47187007
37277,0,1794100,3,13,6,27,7,47187007
37279,34,1794100,1,13,6,27,41,47187041
37280,11,1794100,1,13,6,27,52,47187052
37281,22,1794100,1,13,6,27,74,47187074
37282,18,1794100,1,13,6,27,92,47187092
37283,16,1794300,1,13,6,27,108,47187108
37284,16,1794200,3,13,6,27,124,47187124
37285,13,1794100,1,13,6,27,137,47187137
37286,16,1794100,1,13,6,27,153,47187153
37287,19,1794100,1,13,6,27,172,47187172
37288,108,1794200,1,13,6,27,280,47187280
37289,39,1794200,2,13,6,27,319,47187319
37290,0,1794200,2,13,6,27,319,47187319
37292,2,1794100,1,13,6,27,321,47187321
37293,153,1794100,1,13,6,27,474,47187474
37294,88,1794100,2,13,6,27,562,47187562
37295,44,1794100,1,13,6,27,606,47187606
37296,13,1794100,1,13,6,27,619,47187619
37297,12,1794100,1,13,6,27,631,47187631
37298,27,1794200,1,13,6,27,658,47187658
37299,31,1794300,1,13,6,27,689,47187689
37300,31,1794200,1,13,6,27,720,47187720
37301,68,1794200,1,13,6,27,788,47187788
37302,12,1794100,1,13,6,27,800,47187800
37303,3,1794100,1,13,6,27,803,47187803
37304,181,1794300,1,13,6,27,984,47187984
37305,65,1794400,1,13,6,28,49,47188049
37306,5,1794300,2,13,6,28,54,47188054
37307,184,1794300,1,13,6,28,238,47188238
37308,102,1794300,1,13,6,28,340,47188340
37309,10,1794400,1,13,6,28,350,47188350
37310,37,1794200,2,13,6,28,387,47188387
37311,50,1794200,1,13,6,28,437,47188437
37312,33,1794200,1,13,6,28,470,47188470
37313,5,1794100,1,13,6,28,475,47188475
37314,63,1794200,1,13,6,28,538,47188538
37315,9,1794200,1,13,6,28,547,47188547
37316,21,1794100,1,13,6,28,568,47188568
37317,75,1794100,1,13,6,28,643,47188643
37318,70,1794100,2,13,6,28,713,47188713
37319,121,1794100,2,13,6,28,834,47188834
37320,11,1794100,2,13,6,28,845,47188845
37322,55,1794100,1,13,6,28,900,47188900
37323,85,1794000,1,13,6,28,985,47188985
37324,19,1794000,1,13,6,29,4,47189004
37325,104,1794000,1,13,6,29,108,47189108
37326,16,1793900,3,13,6,29,124,47189124
37328,132,1793900,1,13,6,29,256,47189256
37329,61,1794000,1,13,6,29,317,47189317
37330,46,1793900,1,13,6,29,363,47189363
37331,121,1793900,1,13,6,29,484,47189484
37332,103,1793900,3,13,6,29,587,47189587
37333,67,1793900,1,13,6,29,654,47189654
37334,30,1793900,1,13,6,29,684,47189684
37335,61,1793900,1,13,6,29,745,47189745
37336,115,1794000,1,13,6,29,860,47189860
37337,36,1794100,2,13,6,29,896,47189896
37338,166,1793900,2,13,6,30,62,47190062
37339,33,1793900,2,13,6,30,95,47190095
37340,91,1794000,2,13,6,30,186,47190186
37341,59,1793800,1,13,6,30,245,47190245
37342,193,1794000,4,13,6,30,438,47190438
37343,98,1793900,1,13,6,30,536,47190536
37344,4,1793900,1,13,6,30,540,47190540
37345,92,1793800,1,13,6,30,632,47190632
37346,294,1793900,1,13,6,30,926,47190926
37347,1,1793900,9,13,6,30,927,47190927
37348,194,1793900,1,13,6,31,121,47191121
37349,98,1794000,2,13,6,31,219,47191219
37350,51,1793900,1,13,6,31,270,47191270
37351,231,1794000,1,13,6,31,501,47191501
37352,126,1793900,5,13,6,31,627,47191627
37354,542,1794000,1,13,6,32,169,47192169
37355,66,1794000,1,13,6,32,235,47192235
37356,573,1794100,1,13,6,32,808,47192808
37357,124,1794100,5,13,6,32,932,47192932
37358,129,1794000,1,13,6,33,61,47193061
37359,314,1794000,1,13,6,33,375,47193375
37360,94,1793900,1,13,6,33,469,47193469
37361,115,1794100,2,13,6,33,584,47193584
37362,120,1794100,1,13,6,33,704,47193704
37363,43,1794100,2,13,6,33,747,47193747
37364,25,1794200,1,13,6,33,772,47193772
37365,42,1794100,1,13,6,33,814,47193814
37366,67,1794100,1,13,6,33,881,47193881
37367,77,1794100,1,13,6,33,958,47193958
37368,404,1794300,1,13,6,34,362,47194362
37369,183,1794100,2,13,6,34,545,47194545
37370,379,1794200,2,13,6,34,924,47194924
37371,285,1794300,1,13,6,35,209,47195209
37372,19,1794300,4,13,6,35,228,47195228
37373,71,1794200,1,13,6,35,299,47195299
37374,32,1794200,1,13,6,35,331,47195331
37375,270,1794200,1,13,6,35,601,47195601
37376,462,1794300,4,13,6,36,63,47196063
37377,129,1794200,2,13,6,36,192,47196192
37378,481,1794300,1,13,6,36,673,47196673
37379,603,1794200,1,13,6,37,276,47197276
37380,36,1794300,1,13,6,37,312,47197312
37381,39,1794200,1,13,6,37,351,47197351
37382,57,1794200,1,13,6,37,408,47197408
37383,341,1794200,2,13,6,37,749,47197749
37384,1075,1794100,6,13,6,38,824,47198824
37385,42,1794000,1,13,6,38,866,47198866
37386,1259,1794100,5,13,6,40,125,47200125
37387,1,1794100,4,13,6,40,126,47200126
37388,0,1794100,1,13,6,40,126,47200126
37389,255,1794000,1,13,6,40,381,47200381
37390,123,1794000,1,13,6,40,504,47200504
37391,353,1794000,1,13,6,40,857,47200857
37392,98,1794000,1,13,6,40,955,47200955
37393,328,1793900,1,13,6,41,283,47201283
37394,212,1794000,2,13,6,41,495,47201495
37395,36,1794100,1,13,6,41,531,47201531
37396,387,1794100,1,13,6,41,918,47201918
37397,137,1793900,1,13,6,42,55,47202055
37398,217,1794100,2,13,6,42,272,47202272
37399,52,1794200,1,13,6,42,324,47202324
37400,266,1794100,1,13,6,42,590,47202590
37401,73,1794100,1,13,6,42,663,47202663
37403,106,1794000,1,13,6,42,769,47202769
37404,195,1794000,1,13,6,42,964,47202964
37405,166,1794200,5,13,6,43,130,47203130
37406,84,1794100,2,13,6,43,214,47203214
37407,49,1794100,2,13,6,43,263,47203263
37408,87,1794300,5,13,6,43,350,47203350
37409,0,1794300,1,13,6,43,350,47203350
37410,1,1794300,3,13,6,43,351,47203351
37411,0,1794300,1,13,6,43,351,47203351
37412,1,1794300,1,13,6,43,352,47203352
37413,0,1794300,1,13,6,43,352,47203352
37414,14,1794500,2,13,6,43,366,47203366
37415,60,1794400,1,13,6,43,426,47203426
37416,1,1794500,5,13,6,43,427,47203427
37417,0,1794500,2,13,6,43,427,47203427
37418,119,1794400,2,13,6,43,546,47203546
37419,515,1794500,1,13,6,44,61,47204061
37420,8,1794400,1,13,6,44,69,47204069
37421,126,1794500,1,13,6,44,195,47204195
37422,34,1794500,2,13,6,44,229,47204229
37423,16,1794500,2,13,6,44,245,47204245
37424,0,1794500,1,13,6,44,245,47204245
37425,0,1794500,5,13,6,44,245,47204245
37426,312,1794300,1,13,6,44,557,47204557
37427,496,1794600,4,13,6,45,53,47205053
37428,29,1794500,2,13,6,45,82,47205082
37429,372,1794600,1,13,6,45,454,47205454
37431,42,1794500,1,13,6,45,496,47205496
37432,1528,1794700,5,13,6,47,24,47207024
37433,408,1794800,5,13,6,47,432,47207432
37434,238,1794800,1,13,6,47,670,47207670
37435,186,1794800,1,13,6,47,856,47207856
37436,587,1794900,1,13,6,48,443,47208443
37437,487,1794900,1,13,6,48,930,47208930
37438,1,1794700,3,13,6,48,931,47208931
37440,28,1794900,1,13,6,48,959,47208959
37441,271,1794700,1,13,6,49,230,47209230
37442,121,1794800,1,13,6,49,351,47209351
37443,168,1794800,2,13,6,49,519,47209519
37444,1888,1794700,1,13,6,51,407,47211407
37445,41,1794600,1,13,6,51,448,47211448
37446,331,1794700,1,13,6,51,779,47211779
37447,365,1794700,1,13,6,52,144,47212144
37448,1226,1794700,1,13,6,53,370,47213370
37449,31,1794700,1,13,6,53,401,47213401
37450,1002,1794600,1,13,6,54,403,47214403
37451,570,1794700,1,13,6,54,973,47214973
37452,13,1794800,2,13,6,54,986,47214986
37453,358,1794700,1,13,6,55,344,47215344
37454,189,1794800,1,13,6,55,533,47215533
37455,312,1794600,2,13,6,55,845,47215845
37456,301,1794700,1,13,6,56,146,47216146
37457,256,1794600,1,13,6,56,402,47216402
37458,79,1794600,1,13,6,56,481,47216481
37459,825,1794700,1,13,6,57,306,47217306
37460,216,1794700,1,13,6,57,522,47217522
37462,239,1794800,1,13,6,57,761,47217761
37463,26,1794800,3,13,6,57,787,47217787
37464,4,1794800,1,13,6,57,791,47217791
37465,1642,1794800,1,13,6,59,433,47219433
37466,657,1794700,3,13,7,0,90,47220090
37467,9,1794700,3,13,7,0,99,47220099
37468,92,1794800,1,13,7,0,191,47220191
37469,52,1794800,1,13,7,0,243,47220243
37470,477,1794700,1,13,7,0,720,47220720
37471,0,1794700,1,13,7,0,720,47220720
37472,219,1794700,4,13,7,0,939,47220939
37473,0,1794700,1,13,7,0,939,47220939
37474,0,1794700,1,13,7,0,939,47220939
37475,51,1794600,5,13,7,0,990,47220990
37476,0,1794600,12,13,7,0,990,47220990
37477,1,1794500,6,13,7,0,991,47220991
37478,0,1794500,6,13,7,0,991,47220991
37479,1,1794600,2,13,7,0,992,47220992
37480,18,1794600,1,13,7,1,10,47221010
37481,630,1794700,1,13,7,1,640,47221640
37482,235,1794600,1,13,7,1,875,47221875
37483,524,1794500,1,13,7,2,399,47222399
37484,130,1794400,1,13,7,2,529,47222529
37485,27,1794400,5,13,7,2,556,47222556
37486,156,1794500,1,13,7,2,712,47222712
37487,12,1794500,1,13,7,2,724,47222724
37488,69,1794400,2,13,7,2,793,47222793
37489,556,1794500,1,13,7,3,349,47223349
37490,1,1794500,1,13,7,3,350,47223350
37491,150,1794500,1,13,7,3,500,47223500
37492,286,1794300,1,13,7,3,786,47223786
37493,422,1794500,1,13,7,4,208,47224208
37494,307,1794600,1,13,7,4,515,47224515
37495,634,1794300,1,13,7,5,149,47225149
37496,1036,1794500,2,13,7,6,185,47226185
37498,270,1794600,2,13,7,6,455,47226455
37499,470,1794600,1,13,7,6,925,47226925
37500,479,1794500,2,13,7,7,404,47227404
37501,1500,1794500,1,13,7,8,904,47228904
37502,770,1794500,1,13,7,9,674,47229674
37503,39,1794600,1,13,7,9,713,47229713
37504,348,1794600,1,13,7,10,61,47230061
37505,42,1794500,2,13,7,10,103,47230103
37506,153,1794500,2,13,7,10,256,47230256
37507,1032,1794500,3,13,7,11,288,47231288
37508,1924,1794600,1,13,7,13,212,47233212
37509,146,1794500,1,13,7,13,358,47233358
37510,1,1794500,5,13,7,13,359,47233359
37511,430,1794600,1,13,7,13,789,47233789
37512,138,1794600,1,13,7,13,927,47233927
37513,1,1794500,1,13,7,13,928,47233928
37514,144,1794500,1,13,7,14,72,47234072
37515,341,1794600,1,13,7,14,413,47234413
37516,577,1794600,1,13,7,14,990,47234990
37517,835,1794600,1,13,7,15,825,47235825
37518,1231,1794600,2,13,7,17,56,47237056
37519,27,1794700,2,13,7,17,83,47237083
37520,319,1794600,1,13,7,17,402,47237402
37521,0,1794600,1,13,7,17,402,47237402
37522,333,1794700,1,13,7,17,735,47237735
37523,131,1794700,1,13,7,17,866,47237866
37524,0,1794700,4,13,7,17,866,47237866
37525,791,1794800,1,13,7,18,657,47238657
37526,147,1794700,2,13,7,18,804,47238804
37527,0,1794700,1,13,7,18,804,47238804
37528,794,1794700,1,13,7,19,598,47239598
37529,387,1794700,1,13,7,19,985,47239985
37530,13,1794700,1,13,7,19,998,47239998
37531,1,1794600,3,13,7,19,999,47239999
37532,0,1794600,9,13,7,19,999,47239999
37533,73,1794700,1,13,7,20,72,47240072
37534,804,1794700,2,13,7,20,876,47240876
37535,220,1794700,1,13,7,21,96,47241096
37536,84,1794600,1,13,7,21,180,47241180
37537,645,1794800,5,13,7,21,825,47241825
37538,416,1794600,1,13,7,22,241,47242241
37539,1,1794600,2,13,7,22,242,47242242
37540,71,1794600,1,13,7,22,313,47242313
37541,39,1794600,2,13,7,22,352,47242352
37542,420,1794700,1,13,7,22,772,47242772
37543,906,1794600,1,13,7,23,678,47243678
37544,490,1794700,2,13,7,24,168,47244168
37545,29,1794500,3,13,7,24,197,47244197
37546,1,1794600,1,13,7,24,198,47244198
37547,71,1794600,2,13,7,24,269,47244269
37548,546,1794500,1,13,7,24,815,47244815
37549,823,1794500,2,13,7,25,638,47245638
37550,0,1794500,2,13,7,25,638,47245638
37551,0,1794500,1,13,7,25,638,47245638
37552,0,1794500,1,13,7,25,638,47245638
37553,1,1794500,2,13,7,25,639,47245639
37554,0,1794500,1,13,7,25,639,47245639
37555,30,1794400,3,13,7,25,669,47245669
37556,36,1794500,1,13,7,25,705,47245705
37557,63,1794400,1,13,7,25,768,47245768
37558,0,1794400,1,13,7,25,768,47245768
37559,0,1794400,1,13,7,25,768,47245768
37560,0,1794400,1,13,7,25,768,47245768
37561,0,1794400,1,13,7,25,768,47245768
37562,43,1794300,6,13,7,25,811,47245811
37563,483,1794400,4,13,7,26,294,47246294
37565,264,1794500,2,13,7,26,558,47246558
37566,1687,1794300,2,13,7,28,245,47248245
37567,983,1794200,4,13,7,29,228,47249228
37568,501,1794100,1,13,7,29,729,47249729
37569,10,1794100,1,13,7,29,739,47249739
37570,361,1794100,2,13,7,30,100,47250100
37571,85,1794000,1,13,7,30,185,47250185
37572,0,1794100,1,13,7,30,185,47250185
37573,101,1794200,2,13,7,30,286,47250286
37574,220,1794200,1,13,7,30,506,47250506
37575,166,1794200,2,13,7,30,672,47250672
37576,73,1794000,1,13,7,30,745,47250745
37577,388,1794000,18,13,7,31,133,47251133
37578,2,1793900,2,13,7,31,135,47251135
37579,0,1793900,1,13,7,31,135,47251135
37580,201,1793800,1,13,7,31,336,47251336
37581,282,1793800,1,13,7,31,618,47251618
37582,161,1793800,4,13,7,31,779,47251779
37583,130,1793800,1,13,7,31,909,47251909
37584,86,1793800,1,13,7,31,995,47251995
37585,2,1793900,1,13,7,31,997,47251997
37586,162,1793700,3,13,7,32,159,47252159
37587,77,1793700,3,13,7,32,236,47252236
37588,34,1793700,1,13,7,32,270,47252270
37589,26,1793700,1,13,7,32,296,47252296
37590,74,1793700,1,13,7,32,370,47252370
37591,87,1793700,1,13,7,32,457,47252457
37592,40,1793800,1,13,7,32,497,47252497
37593,7,1793700,1,13,7,32,504,47252504
37594,120,1793700,1,13,7,32,624,47252624
37595,8,1793800,1,13,7,32,632,47252632
37596,87,1793700,1,13,7,32,719,47252719
37597,218,1793700,1,13,7,32,937,47252937
37598,164,1793700,1,13,7,33,101,47253101
37599,156,1793700,3,13,7,33,257,47253257
37601,124,1793600,1,13,7,33,381,47253381
37602,145,1793700,1,13,7,33,526,47253526
37603,21,1793600,1,13,7,33,547,47253547
37604,36,1793700,1,13,7,33,583,47253583
37605,73,1793600,3,13,7,33,656,47253656
37606,44,1793700,1,13,7,33,700,47253700
37608,384,1793800,2,13,7,34,84,47254084
37609,96,1793700,1,13,7,34,180,47254180
37610,274,1793700,1,13,7,34,454,47254454
37611,68,1793800,3,13,7,34,522,47254522
37612,5,1793800,5,13,7,34,527,47254527
37613,0,1793800,1,13,7,34,527,47254527
37614,107,1794000,1,13,7,34,634,47254634
37615,640,1793800,1,13,7,35,274,47255274
37616,1,1793800,2,13,7,35,275,47255275
37617,478,1793800,1,13,7,35,753,47255753
37618,468,1794000,1,13,7,36,221,47256221
37619,90,1794000,1,13,7,36,311,47256311
37620,316,1794000,1,13,7,36,627,47256627
37621,55,1793800,1,13,7,36,682,47256682
37622,578,1794000,1,13,7,37,260,47257260
37623,133,1794000,5,13,7,37,393,47257393
37624,103,1793900,1,13,7,37,496,47257496
37625,33,1793900,1,13,7,37,529,47257529
37627,62,1793900,1,13,7,37,591,47257591
37628,158,1794000,1,13,7,37,749,47257749
37629,355,1793900,4,13,7,38,104,47258104
37631,61,1793800,1,13,7,38,165,47258165
37632,289,1794000,5,13,7,38,454,47258454
37633,390,1794000,1,13,7,38,844,47258844
37634,211,1794100,3,13,7,39,55,47259055
37636,44,1794100,1,13,7,39,99,47259099
37637,100,1794000,1,13,7,39,199,47259199
37638,176,1794200,1,13,7,39,375,47259375
37639,459,1794100,2,13,7,39,834,47259834
37641,384,1794100,1,13,7,40,218,47260218
37642,52,1794100,1,13,7,40,270,47260270
37644,0,1794000,3,13,7,40,270,47260270
37645,709,1794100,1,13,7,40,979,47260979
37646,49,1794100,1,13,7,41,28,47261028
37647,456,1794000,1,13,7,41,484,47261484
37648,212,1794000,1,13,7,41,696,47261696
37649,1167,1794000,1,13,7,42,863,47262863
37650,948,1794000,3,13,7,43,811,47263811
37651,18,1794000,2,13,7,43,829,47263829
37652,465,1794000,2,13,7,44,294,47264294
37653,1,1794000,2,13,7,44,295,47264295
37654,0,1793900,4,13,7,44,295,47264295
37655,0,1793900,1,13,7,44,295,47264295
37656,100,1794000,2,13,7,44,395,47264395
37657,1176,1793900,1,13,7,45,571,47265571
37658,459,1793900,2,13,7,46,30,47266030
37659,1227,1793900,2,13,7,47,257,47267257
37660,276,1794000,1,13,7,47,533,47267533
37661,12,1794000,2,13,7,47,545,47267545
37662,645,1794000,1,13,7,48,190,47268190
37663,919,1794000,1,13,7,49,109,47269109
37664,507,1794000,2,13,7,49,616,47269616
37665,1719,1794000,1,13,7,51,335,47271335
37666,265,1793900,1,13,7,51,600,47271600
37667,0,1793900,1,13,7,51,600,47271600
37668,0,1793900,4,13,7,51,600,47271600
37669,1,1793800,2,13,7,51,601,47271601
37670,0,1793800,8,13,7,51,601,47271601
37671,0,1793900,2,13,7,51,601,47271601
37672,121,1793800,1,13,7,51,722,47271722
37673,0,1793800,1,13,7,51,722,47271722
37674,478,1793800,1,13,7,52,200,47272200
37675,280,1793700,1,13,7,52,480,47272480
37676,0,1793700,3,13,7,52,480,47272480
37677,224,1793800,1,13,7,52,704,47272704
37678,634,1793800,2,13,7,53,338,47273338
37679,29,1793800,1,13,7,53,367,47273367
37680,137,1793900,4,13,7,53,504,47273504
37682,3,1794100,2,13,7,53,507,47273507
37683,0,1794100,1,13,7,53,507,47273507
37684,0,1794100,5,13,7,53,507,47273507
37685,0,1794000,2,13,7,53,507,47273507
37686,1,1794100,1,13,7,53,508,47273508
37688,0,1794200,1,13,7,53,508,47273508
37689,1,1794200,1,13,7,53,509,47273509
37690,0,1794200,4,13,7,53,509,47273509
37691,1,1794100,1,13,7,53,510,47273510
37692,6,1794200,1,13,7,53,516,47273516
37693,70,1794200,1,13,7,53,586,47273586
37694,3,1794200,1,13,7,53,589,47273589
37695,3,1794200,1,13,7,53,592,47273592
37696,7,1794300,2,13,7,53,599,47273599
37697,32,1794300,1,13,7,53,631,47273631
37698,89,1794200,1,13,7,53,720,47273720
37700,121,1794300,1,13,7,53,841,47273841
37701,662,1794100,1,13,7,54,503,47274503
37702,587,1794200,1,13,7,55,90,47275090
37703,200,1794200,2,13,7,55,290,47275290
37704,0,1794200,1,13,7,55,290,47275290
37705,63,1794100,4,13,7,55,353,47275353
37706,5,1794100,1,13,7,55,358,47275358
37707,257,1794200,1,13,7,55,615,47275615
37708,686,1794100,3,13,7,56,301,47276301
37709,132,1794100,4,13,7,56,433,47276433
37710,172,1794300,1,13,7,56,605,47276605
37711,58,1794100,5,13,7,56,663,47276663
37712,105,1794200,1,13,7,56,768,47276768
37713,480,1794300,5,13,7,57,248,47277248
37714,1,1794300,1,13,7,57,249,47277249
37715,500,1794200,1,13,7,57,749,47277749
37716,217,1794300,1,13,7,57,966,47277966
37717,665,1794300,1,13,7,58,631,47278631
37718,233,1794300,1,13,7,58,864,47278864
37719,47,1794400,1,13,7,58,911,47278911
37720,157,1794300,1,13,7,59,68,47279068
37721,508,1794300,2,13,7,59,576,47279576
37722,356,1794300,2,13,7,59,932,47279932
37723,40,1794400,1,13,7,59,972,47279972
37724,10,1794300,1,13,7,59,982,47279982
37726,15,1794200,1,13,7,59,997,47279997
37727,4,1794200,2,13,8,0,1,47280001
37728,103,1794200,1,13,8,0,104,47280104
37729,309,1794200,3,13,8,0,413,47280413
37730,701,1794300,1,13,8,1,114,47281114
37731,111,1794100,1,13,8,1,225,47281225
37732,0,1794100,1,13,8,1,225,47281225
37733,1,1794100,1,13,8,1,226,47281226
37734,232,1794100,1,13,8,1,458,47281458
37735,2199,1794200,1,13,8,3,657,47283657
37736,202,1794100,1,13,8,3,859,47283859
37737,34,1794200,1,13,8,3,893,47283893
37738,168,1794100,1,13,8,4,61,47284061
37739,198,1794100,1,13,8,4,259,47284259
37740,417,1794200,1,13,8,4,676,47284676
37741,279,1794200,2,13,8,4,955,47284955
37742,246,1794100,1,13,8,5,201,47285201
37743,721,1794300,2,13,8,5,922,47285922
37744,1,1794300,1,13,8,5,923,47285923
37745,0,1794300,1,13,8,5,923,47285923
37746,0,1794300,1,13,8,5,923,47285923
37747,0,1794300,5,13,8,5,923,47285923
37748,0,1794300,7,13,8,5,923,47285923
37749,758,1794400,7,13,8,6,681,47286681
37750,106,1794500,7,13,8,6,787,47286787
37751,107,1794500,1,13,8,6,894,47286894
37752,70,1794500,1,13,8,6,964,47286964
37753,856,1794200,2,13,8,7,820,47287820
37754,30,1794200,1,13,8,7,850,47287850
37755,0,1794100,1,13,8,7,850,47287850
37756,27,1794300,1,13,8,7,877,47287877
37757,99,1794100,7,13,8,7,976,47287976
37758,336,1794300,5,13,8,8,312,47288312
37759,625,1794300,2,13,8,8,937,47288937
37761,212,1794200,1,13,8,9,149,47289149
37762,216,1794200,1,13,8,9,365,47289365
37763,797,1794300,1,13,8,10,162,47290162
37764,114,1794300,1,13,8,10,276,47290276
37765,245,1794200,2,13,8,10,521,47290521
37766,258,1794400,1,13,8,10,779,47290779
37767,1219,1794300,1,13,8,11,998,47291998
37769,284,1794300,1,13,8,12,282,47292282
37770,697,1794400,1,13,8,12,979,47292979
37771,208,1794200,1,13,8,13,187,47293187
37772,385,1794400,1,13,8,13,572,47293572
37773,129,1794500,2,13,8,13,701,47293701
37774,62,1794300,1,13,8,13,763,47293763
37775,400,1794300,2,13,8,14,163,47294163
37776,1415,1794500,6,13,8,15,578,47295578
37777,115,1794600,2,13,8,15,693,47295693
37778,104,1794500,1,13,8,15,797,47295797
37779,125,1794500,2,13,8,15,922,47295922
37780,791,1794400,5,13,8,16,713,47296713
37781,162,1794400,1,13,8,16,875,47296875
37782,95,1794600,1,13,8,16,970,47296970
37783,263,1794600,4,13,8,17,233,47297233
37785,117,1794500,1,13,8,17,350,47297350
37786,0,1794500,1,13,8,17,350,47297350
37787,1,1794500,1,13,8,17,351,47297351
37788,0,1794400,1,13,8,17,351,47297351
37789,1,1794500,4,13,8,17,352,47297352
37790,60,1794600,2,13,8,17,412,47297412
37791,3,1794700,5,13,8,17,415,47297415
37792,134,1794600,1,13,8,17,549,47297549
37793,1699,1794600,2,13,8,19,248,47299248
37794,513,1794500,1,13,8,19,761,47299761
37795,243,1794400,1,13,8,20,4,47300004
37796,305,1794500,1,13,8,20,309,47300309
37797,399,1794400,1,13,8,20,708,47300708
37798,800,1794400,1,13,8,21,508,47301508
37799,330,1794500,1,13,8,21,838,47301838
37800,195,1794600,5,13,8,22,33,47302033
37801,1528,1794400,1,13,8,23,561,47303561
37802,79,1794300,1,13,8,23,640,47303640
37803,672,1794500,1,13,8,24,312,47304312
37804,465,1794400,1,13,8,24,777,47304777
37805,412,1794400,5,13,8,25,189,47305189
37806,98,1794500,1,13,8,25,287,47305287
37807,0,1794500,1,13,8,25,287,47305287
37808,0,1794500,1,13,8,25,287,47305287
37809,0,1794500,2,13,8,25,287,47305287
37810,1,1794500,1,13,8,25,288,47305288
37811,196,1794500,1,13,8,25,484,47305484
37812,392,1794500,1,13,8,25,876,47305876
37813,611,1794500,2,13,8,26,487,47306487
37815,216,1794600,1,13,8,26,703,47306703
37816,293,1794500,1,13,8,26,996,47306996
37817,296,1794500,1,13,8,27,292,47307292
37818,58,1794400,1,13,8,27,350,47307350
37819,1,1794400,1,13,8,27,351,47307351
37820,1628,1794500,1,13,8,28,979,47308979
37821,188,1794500,1,13,8,29,167,47309167
37822,143,1794400,1,13,8,29,310,47309310
37823,827,1794400,1,13,8,30,137,47310137
37824,2119,1794500,1,13,8,32,256,47312256
37825,124,1794400,1,13,8,32,380,47312380
37826,582,1794400,2,13,8,32,962,47312962
37827,1115,1794400,3,13,8,34,77,47314077
37828,0,1794400,1,13,8,34,77,47314077
37829,63,1794400,1,13,8,34,140,47314140
37830,334,1794400,1,13,8,34,474,47314474
37831,2439,1794400,1,13,8,36,913,47316913
37832,39,1794400,1,13,8,36,952,47316952
37833,560,1794400,1,13,8,37,512,47317512
37834,0,1794400,5,13,8,37,512,47317512
37835,0,1794400,2,13,8,37,512,47317512
37836,1,1794400,1,13,8,37,513,47317513
37837,0,1794400,1,13,8,37,513,47317513
37838,87,1794400,1,13,8,37,600,47317600
37839,0,1794400,1,13,8,37,600,47317600
37840,0,1794400,1,13,8,37,600,47317600
37841,0,1794400,1,13,8,37,600,47317600
37842,0,1794400,1,13,8,37,600,47317600
37843,691,1794500,1,13,8,38,291,47318291
37844,89,1794500,6,13,8,38,380,47318380
37845,1,1794500,1,13,8,38,381,47318381
37846,1894,1794500,1,13,8,40,275,47320275
37847,802,1794400,1,13,8,41,77,47321077
37848,1320,1794500,1,13,8,42,397,47322397
37849,18,1794400,1,13,8,42,415,47322415
37850,97,1794400,2,13,8,42,512,47322512
37851,36,1794400,1,13,8,42,548,47322548
37852,16,1794400,1,13,8,42,564,47322564
37853,759,1794500,1,13,8,43,323,47323323
37854,0,1794500,1,13,8,43,323,47323323
37855,486,1794500,2,13,8,43,809,47323809
37856,350,1794500,1,13,8,44,159,47324159
37857,1,1794500,1,13,8,44,160,47324160
37858,1218,1794400,1,13,8,45,378,47325378
37859,1259,1794400,5,13,8,46,637,47326637
37860,1689,1794500,1,13,8,48,326,47328326
37862,265,1794500,1,13,8,48,591,47328591
37863,212,1794600,1,13,8,48,803,47328803
37864,106,1794400,1,13,8,48,909,47328909
37865,38,1794400,1,13,8,48,947,47328947
37866,16,1794600,1,13,8,48,963,47328963
37867,428,1794400,1,13,8,49,391,47329391
37868,1742,1794500,1,13,8,51,133,47331133
37869,654,1794500,1,13,8,51,787,47331787
37870,322,1794500,1,13,8,52,109,47332109
37871,821,1794500,1,13,8,52,930,47332930
37872,311,1794500,4,13,8,53,241,47333241
37874,1384,1794500,1,13,8,54,625,47334625
37875,1,1794500,1,13,8,54,626,47334626
37876,771,1794500,1,13,8,55,397,47335397
37877,479,1794500,1,13,8,55,876,47335876
37878,363,1794400,3,13,8,56,239,47336239
37879,408,1794400,2,13,8,56,647,47336647
37880,52,1794400,1,13,8,56,699,47336699
37882,348,1794500,1,13,8,57,47,47337047
37883,2158,1794600,10,13,8,59,205,47339205
37884,1,1794500,1,13,8,59,206,47339206
37885,5,1794400,1,13,8,59,211,47339211
37886,0,1794400,1,13,8,59,211,47339211
37887,153,1794300,3,13,8,59,364,47339364
37888,1,1794300,7,13,8,59,365,47339365
37889,125,1794300,3,13,8,59,490,47339490
37890,555,1794300,1,13,9,0,45,47340045
37891,57,1794300,1,13,9,0,102,47340102
37892,0,1794200,1,13,9,0,102,47340102
37893,0,1794200,1,13,9,0,102,47340102
37894,0,1794200,1,13,9,0,102,47340102
37895,0,1794200,1,13,9,0,102,47340102
37896,0,1794200,3,13,9,0,102,47340102
37897,0,1794200,1,13,9,0,102,47340102
37898,27,1794200,3,13,9,0,129,47340129
37900,21,1794300,1,13,9,0,150,47340150
37901,263,1794200,1,13,9,0,413,47340413
37902,471,1794100,1,13,9,0,884,47340884
37903,289,1794300,1,13,9,1,173,47341173
37904,52,1794100,1,13,9,1,225,47341225
37905,0,1794100,1,13,9,1,225,47341225
37906,1,1794100,1,13,9,1,226,47341226
37907,0,1794100,1,13,9,1,226,47341226
37908,0,1794100,1,13,9,1,226,47341226
37909,0,1794100,1,13,9,1,226,47341226
37910,1,1794100,1,13,9,1,227,47341227
37911,231,1794100,1,13,9,1,458,47341458
37912,59,1794200,4,13,9,1,517,47341517
37914,159,1794100,1,13,9,1,676,47341676
37915,46,1794100,1,13,9,1,722,47341722
37916,3,1794100,3,13,9,1,725,47341725
37917,8,1794100,1,13,9,1,733,47341733
37918,408,1794100,1,13,9,2,141,47342141
37919,630,1794000,5,13,9,2,771,47342771
37920,80,1794000,1,13,9,2,851,47342851
37921,1479,1794000,1,13,9,4,330,47344330
37922,239,1794000,3,13,9,4,569,47344569
37923,93,1794000,1,13,9,4,662,47344662
37924,993,1794100,1,13,9,5,655,47345655
37925,291,1794100,1,13,9,5,946,47345946
37926,8,1794100,2,13,9,5,954,47345954
37927,41,1794100,1,13,9,5,995,47345995
37928,10,1794100,1,13,9,6,5,47346005
37929,119,1794100,1,13,9,6,124,47346124
37930,717,1794200,2,13,9,6,841,47346841
37931,3021,1794200,2,13,9,9,862,47349862
37933,113,1794100,1,13,9,9,975,47349975
37934,1,1794100,1,13,9,9,976,47349976
37935,0,1794100,1,13,9,9,976,47349976
37936,0,1794100,1,13,9,9,976,47349976
37937,0,1794100,1,13,9,9,976,47349976
37938,1,1794100,1,13,9,9,977,47349977
37939,94,1794100,1,13,9,10,71,47350071
37940,584,1794000,3,13,9,10,655,47350655
37941,498,1794100,1,13,9,11,153,47351153
37942,26,1794200,1,13,9,11,179,47351179
37943,91,1794200,1,13,9,11,270,47351270
37944,34,1794200,1,13,9,11,304,47351304
37945,1613,1794300,1,13,9,12,917,47352917
37946,0,1794300,1,13,9,12,917,47352917
37947,0,1794300,4,13,9,12,917,47352917
37948,0,1794300,3,13,9,12,917,47352917
37949,404,1794400,1,13,9,13,321,47353321
37950,900,1794500,1,13,9,14,221,47354221
37951,1950,1794500,5,13,9,16,171,47356171
37952,262,1794500,1,13,9,16,433,47356433
37953,194,1794500,1,13,9,16,627,47356627
37954,1466,1794400,1,13,9,18,93,47358093
37955,7,1794300,1,13,9,18,100,47358100
37956,1,1794300,1,13,9,18,101,47358101
37957,1677,1794400,1,13,9,19,778,47359778
37958,1307,1794500,1,13,9,21,85,47361085
37959,154,1794500,1,13,9,21,239,47361239
37960,438,1794300,3,13,9,21,677,47361677
37961,754,1794300,2,13,9,22,431,47362431
37962,1,1794300,1,13,9,22,432,47362432
37963,116,1794400,1,13,9,22,548,47362548
37964,564,1794200,1,13,9,23,112,47363112
37965,0,1794200,2,13,9,23,112,47363112
37966,176,1794200,1,13,9,23,288,47363288
37967,193,1794200,1,13,9,23,481,47363481
37968,19,1794200,1,13,9,23,500,47363500
37969,22,1794100,1,13,9,23,522,47363522
37970,103,1794200,1,13,9,23,625,47363625
37971,265,1794200,1,13,9,23,890,47363890
37972,3565,1794200,1,13,9,27,455,47367455
37973,173,1794200,2,13,9,27,628,47367628
37974,1286,1794200,1,13,9,28,914,47368914
37975,15,1794300,1,13,9,28,929,47368929
37976,47,1794200,1,13,9,28,976,47368976
37977,0,1794200,1,13,9,28,976,47368976
37978,0,1794200,1,13,9,28,976,47368976
37979,558,1794300,1,13,9,29,534,47369534
37981,179,1794200,1,13,9,29,713,47369713
37982,2208,1794300,1,13,9,31,921,47371921
37983,33,1794200,1,13,9,31,954,47371954
37984,0,1794200,1,13,9,31,954,47371954
37985,77,1794100,1,13,9,32,31,47372031
37986,228,1794100,2,13,9,32,259,47372259
37987,496,1794200,1,13,9,32,755,47372755
37988,2264,1794200,2,13,9,35,19,47375019
37990,26,1794100,1,13,9,35,45,47375045
37991,178,1794100,1,13,9,35,223,47375223
37992,2539,1794100,4,13,9,37,762,47377762
37993,440,1794300,1,13,9,38,202,47378202
37994,24,1794100,1,13,9,38,226,47378226
37995,166,1794100,1,13,9,38,392,47378392
37996,2197,1794100,4,13,9,40,589,47380589
37997,114,1794100,1,13,9,40,703,47380703
37998,1,1794100,1,13,9,40,704,47380704
37999,614,1794200,1,13,9,41,318,47381318
38000,2109,1794100,1,13,9,43,427,47383427
38001,786,1794100,1,13,9,44,213,47384213
38002,519,1794200,2,13,9,44,732,47384732
38003,321,1794200,1,13,9,45,53,47385053
38004,203,1794200,1,13,9,45,256,47385256
38005,700,1794300,2,13,9,45,956,47385956
38006,584,1794200,1,13,9,46,540,47386540
38007,118,1794200,1,13,9,46,658,47386658
38008,1228,1794300,1,13,9,47,886,47387886
38009,22,1794300,1,13,9,47,908,47387908
38010,113,1794400,4,13,9,48,21,47388021
38011,762,1794500,6,13,9,48,783,47388783
38012,2010,1794500,1,13,9,50,793,47390793
38013,229,1794400,1,13,9,51,22,47391022
38014,1788,1794600,1,13,9,52,810,47392810
38015,954,1794600,1,13,9,53,764,47393764
38016,280,1794600,1,13,9,54,44,47394044
38017,956,1794500,5,13,9,55,0,47395000
38018,0,1794500,1,13,9,55,0,47395000
38019,1438,1794500,1,13,9,56,438,47396438
38020,131,1794500,1,13,9,56,569,47396569
38021,1297,1794500,1,13,9,57,866,47397866
38022,4052,1794400,1,13,10,1,918,47401918
38023,54,1794500,1,13,10,1,972,47401972
38024,6,1794400,1,13,10,1,978,47401978
38025,0,1794400,1,13,10,1,978,47401978
38026,0,1794400,2,13,10,1,978,47401978
38027,0,1794400,1,13,10,1,978,47401978
38029,0,1794300,1,13,10,1,978,47401978
38030,0,1794300,1,13,10,1,978,47401978
38031,1,1794300,1,13,10,1,979,47401979
38032,0,1794300,1,13,10,1,979,47401979
38033,1,1794300,1,13,10,1,980,47401980
38034,1,1794300,1,13,10,1,981,47401981
38035,0,1794300,1,13,10,1,981,47401981
38036,0,1794300,1,13,10,1,981,47401981
38037,0,1794300,1,13,10,1,981,47401981
38039,0,1794200,3,13,10,1,981,47401981
38040,2,1794400,1,13,10,1,983,47401983
38041,504,1794300,1,13,10,2,487,47402487
38042,6,1794400,1,13,10,2,493,47402493
38044,107,1794300,1,13,10,2,600,47402600
38045,0,1794300,1,13,10,2,600,47402600
38046,1,1794300,1,13,10,2,601,47402601
38047,1148,1794400,2,13,10,3,749,47403749
38048,0,1794400,2,13,10,3,749,47403749
38049,562,1794500,2,13,10,4,311,47404311
38050,303,1794500,2,13,10,4,614,47404614
38051,67,1794500,4,13,10,4,681,47404681
38052,0,1794500,3,13,10,4,681,47404681
38053,268,1794600,4,13,10,4,949,47404949
38054,104,1794500,1,13,10,5,53,47405053
38055,91,1794600,2,13,10,5,144,47405144
38056,1,1794600,3,13,10,5,145,47405145
38057,0,1794600,9,13,10,5,145,47405145
38058,315,1794600,1,13,10,5,460,47405460
38059,328,1794700,1,13,10,5,788,47405788
38060,124,1794700,5,13,10,5,912,47405912
38061,0,1794700,3,13,10,5,912,47405912
38062,0,1794700,1,13,10,5,912,47405912
38063,1,1794700,2,13,10,5,913,47405913
38064,1001,1794700,1,13,10,6,914,47406914
38065,271,1794700,1,13,10,7,185,47407185
38066,40,1794700,1,13,10,7,225,47407225
38067,1,1794700,1,13,10,7,226,47407226
38068,0,1794700,1,13,10,7,226,47407226
38069,0,1794700,1,13,10,7,226,47407226
38070,218,1794800,1,13,10,7,444,47407444
38071,562,1794700,2,13,10,8,6,47408006
38072,393,1794700,1,13,10,8,399,47408399
38073,294,1794800,1,13,10,8,693,47408693
38074,428,1794800,1,13,10,9,121,47409121
38075,24,1794800,1,13,10,9,145,47409145
38076,951,1794800,2,13,10,10,96,47410096
38077,449,1794800,3,13,10,10,545,47410545
38078,146,1794900,2,13,10,10,691,47410691
38079,37,1794900,4,13,10,10,728,47410728
38081,54,1794800,1,13,10,10,782,47410782
38082,174,1795000,1,13,10,10,956,47410956
38083,35,1795000,2,13,10,10,991,47410991
38084,434,1794800,1,13,10,11,425,47411425
38085,0,1794800,1,13,10,11,425,47411425
38086,164,1794900,1,13,10,11,589,47411589
38087,85,1794800,1,13,10,11,674,47411674
38088,161,1794800,1,13,10,11,835,47411835
38089,272,1794700,1,13,10,12,107,47412107
38090,394,1794800,1,13,10,12,501,47412501
38091,251,1794900,1,13,10,12,752,47412752
38092,345,1794900,1,13,10,13,97,47413097
38093,571,1794900,1,13,10,13,668,47413668
38095,728,1795000,1,13,10,14,396,47414396
38096,446,1794900,1,13,10,14,842,47414842
38097,48,1795000,4,13,10,14,890,47414890
38098,444,1795000,1,13,10,15,334,47415334
38099,14,1795000,2,13,10,15,348,47415348
38100,0,1795000,19,13,10,15,348,47415348
38101,1,1795000,3,13,10,15,349,47415349
38102,0,1795000,2,13,10,15,349,47415349
38103,0,1795000,3,13,10,15,349,47415349
38104,1,1795000,4,13,10,15,350,47415350
38105,33,1795100,3,13,10,15,383,47415383
38106,175,1795100,1,13,10,15,558,47415558
38107,195,1795100,1,13,10,15,753,47415753
38108,366,1795100,3,13,10,16,119,47416119
38109,69,1795100,2,13,10,16,188,47416188
38110,84,1795000,2,13,10,16,272,47416272
38111,221,1795200,10,13,10,16,493,47416493
38112,33,1795200,1,13,10,16,526,47416526
38113,92,1795200,1,13,10,16,618,47416618
38114,59,1795000,1,13,10,16,677,47416677
38115,138,1795000,1,13,10,16,815,47416815
38116,161,1795200,1,13,10,16,976,47416976
38117,196,1795200,1,13,10,17,172,47417172
38118,53,1795100,1,13,10,17,225,47417225
38119,0,1795100,1,13,10,17,225,47417225
38120,0,1795100,1,13,10,17,225,47417225
38121,0,1795000,1,13,10,17,225,47417225
38122,0,1795000,1,13,10,17,225,47417225
38123,1,1795000,1,13,10,17,226,47417226
38124,388,1794900,1,13,10,17,614,47417614
38125,343,1794900,1,13,10,17,957,47417957
38126,0,1795100,3,13,10,17,957,47417957
38127,186,1795100,2,13,10,18,143,47418143
38129,107,1795200,1,13,10,18,250,47418250
38130,477,1795300,1,13,10,18,727,47418727
38131,3,1795100,1,13,10,18,730,47418730
38132,622,1795100,1,13,10,19,352,47419352
38133,133,1795300,1,13,10,19,485,47419485
38134,595,1795100,1,13,10,20,80,47420080
38135,181,1795100,1,13,10,20,261,47420261
38136,944,1795100,1,13,10,21,205,47421205
38137,735,1795100,1,13,10,21,940,47421940
38138,37,1795200,1,13,10,21,977,47421977
38139,83,1795000,1,13,10,22,60,47422060
38140,285,1795100,1,13,10,22,345,47422345
38141,913,1795100,3,13,10,23,258,47423258
38142,812,1795100,1,13,10,24,70,47424070
38143,69,1795100,2,13,10,24,139,47424139
38144,310,1795100,1,13,10,24,449,47424449
38145,685,1795100,1,13,10,25,134,47425134
38146,306,1795100,1,13,10,25,440,47425440
38147,480,1795100,1,13,10,25,920,47425920
38148,441,1795200,5,13,10,26,361,47426361
38149,266,1795200,1,13,10,26,627,47426627
38150,753,1795100,1,13,10,27,380,47427380
38151,76,1795200,1,13,10,27,456,47427456
38153,19,1795100,1,13,10,27,475,47427475
38154,0,1795100,1,13,10,27,475,47427475
38155,0,1795100,1,13,10,27,475,47427475
38156,0,1795100,1,13,10,27,475,47427475
38157,1,1795000,1,13,10,27,476,47427476
38158,0,1795000,1,13,10,27,476,47427476
38159,1,1795000,1,13,10,27,477,47427477
38160,523,1795100,1,13,10,28,0,47428000
38161,257,1795000,1,13,10,28,257,47428257
38162,496,1795100,1,13,10,28,753,47428753
38163,440,1795100,1,13,10,29,193,47429193
38164,764,1795000,1,13,10,29,957,47429957
38165,2,1795000,1,13,10,29,959,47429959
38166,0,1795000,9,13,10,29,959,47429959
38167,175,1795000,1,13,10,30,134,47430134
38168,2270,1794900,4,13,10,32,404,47432404
38169,1240,1795000,1,13,10,33,644,47433644
38170,92,1794900,1,13,10,33,736,47433736
38171,821,1794900,1,13,10,34,557,47434557
38172,2739,1795000,2,13,10,37,296,47437296
38173,445,1795000,1,13,10,37,741,47437741
38174,28,1795100,2,13,10,37,769,47437769
38176,1750,1795200,1,13,10,39,519,47439519
38177,81,1795100,1,13,10,39,600,47439600
38178,1,1795100,1,13,10,39,601,47439601
38179,2207,1795200,1,13,10,41,808,47441808
38180,441,1795100,3,13,10,42,249,47442249
38181,1293,1795100,1,13,10,43,542,47443542
38182,554,1795200,2,13,10,44,96,47444096
38183,1253,1795200,1,13,10,45,349,47445349
38184,310,1795100,1,13,10,45,659,47445659
38185,951,1795200,1,13,10,46,610,47446610
38186,768,1795100,2,13,10,47,378,47447378
38187,1,1795100,1,13,10,47,379,47447379
38188,0,1795100,1,13,10,47,379,47447379
38189,0,1795100,2,13,10,47,379,47447379
38190,97,1795000,1,13,10,47,476,47447476
38191,172,1795200,1,13,10,47,648,47447648
38192,59,1795000,1,13,10,47,707,47447707
38193,1571,1795100,1,13,10,49,278,47449278
38195,1036,1795000,1,13,10,50,314,47450314
38196,0,1795000,2,13,10,50,314,47450314
38197,0,1795000,1,13,10,50,314,47450314
38198,0,1795000,2,13,10,50,314,47450314
38199,0,1795000,7,13,10,50,314,47450314
38200,42,1794900,6,13,10,50,356,47450356
38201,544,1795000,1,13,10,50,900,47450900
38202,1295,1794900,2,13,10,52,195,47452195
38203,153,1794900,1,13,10,52,348,47452348
38204,671,1794900,1,13,10,53,19,47453019
38205,164,1794900,1,13,10,53,183,47453183
38206,1823,1795000,1,13,10,55,6,47455006
38207,1079,1795000,1,13,10,56,85,47456085
38208,541,1794900,1,13,10,56,626,47456626
38209,1495,1795000,1,13,10,58,121,47458121
38210,1137,1795000,3,13,10,59,258,47459258
38211,91,1795100,1,13,10,59,349,47459349
38212,348,1795000,2,13,10,59,697,47459697
38213,760,1795000,1,13,11,0,457,47460457
38214,198,1795100,1,13,11,0,655,47460655
38215,446,1795000,1,13,11,1,101,47461101
38216,562,1795000,1,13,11,1,663,47461663
38217,1181,1795000,1,13,11,2,844,47462844
38218,671,1795000,1,13,11,3,515,47463515
38219,340,1795000,1,13,11,3,855,47463855
38220,0,1795000,7,13,11,3,855,47463855
38221,81,1795000,2,13,11,3,936,47463936
38222,1152,1795000,4,13,11,5,88,47465088
38223,1,1795000,6,13,11,5,89,47465089
38224,23,1794900,1,13,11,5,112,47465112
38225,267,1795000,2,13,11,5,379,47465379
38226,1126,1795000,1,13,11,6,505,47466505
38227,0,1795000,3,13,11,6,505,47466505
38228,219,1794900,15,13,11,6,724,47466724
38230,2,1794800,28,13,11,6,726,47466726
38231,41,1794800,1,13,11,6,767,47466767
38232,4,1794800,1,13,11,6,771,47466771
38233,40,1794900,1,13,11,6,811,47466811
38234,139,1794900,1,13,11,6,950,47466950
38235,1264,1794800,1,13,11,8,214,47468214
38236,1667,1795000,4,13,11,9,881,47469881
38237,64,1795000,1,13,11,9,945,47469945
38238,1047,1795100,20,13,11,10,992,47470992
38239,46,1795200,2,13,11,11,38,47471038
38240,1,1795200,4,13,11,11,39,47471039
38241,2514,1795100,8,13,11,13,553,47473553
38242,1217,1795000,1,13,11,14,770,47474770
38243,529,1795000,2,13,11,15,299,47475299
38244,63,1795100,1,13,11,15,362,47475362
38245,2521,1795200,1,13,11,17,883,47477883
38246,168,1795200,1,13,11,18,51,47478051
38248,1897,1795200,1,13,11,19,948,47479948
38249,105,1795300,1,13,11,20,53,47480053
38250,253,1795100,8,13,11,20,306,47480306
38251,0,1795100,8,13,11,20,306,47480306
38252,0,1795100,8,13,11,20,306,47480306
38254,67,1794800,1,13,11,20,373,47480373
38255,547,1794800,1,13,11,20,920,47480920
38256,1182,1795000,1,13,11,22,102,47482102
38257,86,1794900,1,13,11,22,188,47482188
38258,717,1794800,4,13,11,22,905,47482905
38259,189,1794900,1,13,11,23,94,47483094
38260,222,1794800,1,13,11,23,316,47483316
38261,1056,1794800,4,13,11,24,372,47484372
38262,2,1794700,2,13,11,24,374,47484374
38263,1,1794700,8,13,11,24,375,47484375
38264,0,1794700,10,13,11,24,375,47484375
38265,41,1794700,1,13,11,24,416,47484416
38266,3013,1794800,1,13,11,27,429,47487429
38267,1,1794800,1,13,11,27,430,47487430
38268,0,1794800,1,13,11,27,430,47487430
38269,60,1794800,1,13,11,27,490,47487490
38270,1,1794900,5,13,11,27,491,47487491
38271,2181,1794800,1,13,11,29,672,47489672
38272,3823,1794700,1,13,11,33,495,47493495
38273,0,1794700,5,13,11,33,495,47493495
38274,387,1794700,1,13,11,33,882,47493882
38275,0,1794700,1,13,11,33,882,47493882
38276,1397,1794700,1,13,11,35,279,47495279
38278,1237,1794800,1,13,11,36,516,47496516
38279,81,1794800,1,13,11,36,597,47496597
38280,245,1794700,1,13,11,36,842,47496842
38281,3317,1794800,1,13,11,40,159,47500159
38282,0,1794800,1,13,11,40,159,47500159
38283,0,1794800,1,13,11,40,159,47500159
38284,2,1794800,1,13,11,40,161,47500161
38285,1141,1794900,1,13,11,41,302,47501302
38286,1090,1794800,1,13,11,42,392,47502392
38287,102,1794800,1,13,11,42,494,47502494
38288,2959,1794700,1,13,11,45,453,47505453
38289,2132,1794900,2,13,11,47,585,47507585
38290,77,1794900,1,13,11,47,662,47507662
38291,129,1794800,1,13,11,47,791,47507791
38292,740,1794800,1,13,11,48,531,47508531
38293,2848,1794800,1,13,11,51,379,47511379
38294,126,1794800,1,13,11,51,505,47511505
38295,306,1794800,1,13,11,51,811,47511811
38297,714,1794700,1,13,11,52,525,47512525
38298,1428,1794800,1,13,11,53,953,47513953
38299,1902,1794800,1,13,11,55,855,47515855
38300,1733,1794700,1,13,11,57,588,47517588
38301,391,1794800,4,13,11,57,979,47517979
38303,512,1794700,1,13,11,58,491,47518491
38304,72,1794700,2,13,11,58,563,47518563
38306,64,1794600,7,13,11,58,627,47518627
38307,42,1794600,1,13,11,58,669,47518669
38308,95,1794700,1,13,11,58,764,47518764
38309,330,1794700,1,13,11,59,94,47519094
38310,890,1794800,1,13,11,59,984,47519984
38311,1709,1794700,4,13,12,1,693,47521693
38312,894,1794700,1,13,12,2,587,47522587
38313,3156,1794700,1,13,12,5,743,47525743
38314,45,1794800,1,13,12,5,788,47525788
38315,2168,1794800,1,13,12,7,956,47527956
38316,914,1794800,6,13,12,8,870,47528870
38317,39,1794700,1,13,12,8,909,47528909
38318,649,1794800,1,13,12,9,558,47529558
38319,1,1794800,1,13,12,9,559,47529559
38320,0,1794800,1,13,12,9,559,47529559
38321,1610,1794900,2,13,12,11,169,47531169
38322,0,1794900,1,13,12,11,169,47531169
38323,0,1794900,2,13,12,11,169,47531169
38324,315,1795000,4,13,12,11,484,47531484
38325,137,1795100,5,13,12,11,621,47531621
38326,1011,1794900,2,13,12,12,632,47532632
38327,209,1794900,1,13,12,12,841,47532841
38328,511,1795000,1,13,12,13,352,47533352
38329,2907,1795000,1,13,12,16,259,47536259
38330,469,1795000,1,13,12,16,728,47536728
38331,2824,1794900,1,13,12,19,552,47539552
38332,695,1794900,1,13,12,20,247,47540247
38333,1,1794900,1,13,12,20,248,47540248
38334,0,1794900,7,13,12,20,248,47540248
38335,0,1794900,1,13,12,20,248,47540248
38336,42,1794800,1,13,12,20,290,47540290
38337,0,1794800,1,13,12,20,290,47540290
38338,0,1794700,4,13,12,20,290,47540290
38339,1100,1794800,1,13,12,21,390,47541390
38340,3666,1794900,1,13,12,25,56,47545056
38341,0,1794900,6,13,12,25,56,47545056
38342,91,1795000,1,13,12,25,147,47545147
38343,318,1795000,2,13,12,25,465,47545465
38344,1556,1795100,4,13,12,27,21,47547021
38345,191,1795200,4,13,12,27,212,47547212
38346,1195,1795000,1,13,12,28,407,47548407
38347,217,1795000,1,13,12,28,624,47548624
38348,211,1795000,1,13,12,28,835,47548835
38349,844,1795000,1,13,12,29,679,47549679
38350,983,1795100,1,13,12,30,662,47550662
38351,499,1795000,1,13,12,31,161,47551161
38352,1172,1795100,1,13,12,32,333,47552333
38353,2064,1795000,2,13,12,34,397,47554397
38354,925,1795000,1,13,12,35,322,47555322
38355,820,1795100,1,13,12,36,142,47556142
38356,720,1795100,5,13,12,36,862,47556862
38357,277,1795000,1,13,12,37,139,47557139
38358,743,1795100,3,13,12,37,882,47557882
38359,309,1795100,1,13,12,38,191,47558191
38360,848,1795100,1,13,12,39,39,47559039
38361,1979,1795100,1,13,12,41,18,47561018
38362,37,1795100,1,13,12,41,55,47561055
38363,59,1795100,2,13,12,41,114,47561114
38364,38,1795200,1,13,12,41,152,47561152
38365,351,1795100,1,13,12,41,503,47561503
38366,7,1795100,1,13,12,41,510,47561510
38367,1251,1795100,1,13,12,42,761,47562761
38368,531,1795100,1,13,12,43,292,47563292
38369,1082,1795100,7,13,12,44,374,47564374
38370,1,1794900,2,13,12,44,375,47564375
38371,442,1794900,1,13,12,44,817,47564817
38372,456,1794900,1,13,12,45,273,47565273
38373,3042,1794900,1,13,12,48,315,47568315
38375,410,1794900,1,13,12,48,725,47568725
38376,244,1794900,1,13,12,48,969,47568969
38378,101,1795000,1,13,12,49,70,47569070
38379,2815,1795100,1,13,12,51,885,47571885
38380,464,1794900,1,13,12,52,349,47572349
38381,872,1794800,1,13,12,53,221,47573221
38382,1,1794800,7,13,12,53,222,47573222
38383,485,1794900,5,13,12,53,707,47573707
38384,168,1794900,1,13,12,53,875,47573875
38385,802,1795000,9,13,12,54,677,47574677
38386,1,1795000,11,13,12,54,678,47574678
38387,2869,1794800,1,13,12,57,547,47577547
38388,4180,1794900,1,13,13,1,727,47581727
38389,407,1794800,1,13,13,2,134,47582134
38390,43,1794900,1,13,13,2,177,47582177
38391,1145,1794900,5,13,13,3,322,47583322
38392,1,1794900,1,13,13,3,323,47583323
38393,11,1795000,2,13,13,3,334,47583334
38394,2,1795000,1,13,13,3,336,47583336
38395,1650,1795000,1,13,13,4,986,47584986
38396,823,1794900,1,13,13,5,809,47585809
38397,4611,1794900,1,13,13,10,420,47590420
38398,2409,1794900,1,13,13,12,829,47592829
38399,524,1795000,6,13,13,13,353,47593353
38400,1,1795000,1,13,13,13,354,47593354
38401,751,1795000,1,13,13,14,105,47594105
38402,243,1795100,3,13,13,14,348,47594348
38403,518,1795100,1,13,13,14,866,47594866
38404,3014,1795000,1,13,13,17,880,47597880
38405,262,1795100,1,13,13,18,142,47598142
38406,1262,1795000,1,13,13,19,404,47599404
38407,1,1795000,1,13,13,19,405,47599405
38408,2218,1795000,1,13,13,21,623,47601623
38409,3283,1795000,2,13,13,24,906,47604906
38410,70,1795000,1,13,13,24,976,47604976
38411,1,1795000,5,13,13,24,977,47604977
38412,3257,1794900,1,13,13,28,234,47608234
38413,1482,1794800,1,13,13,29,716,47609716
38414,507,1794800,1,13,13,30,223,47610223
38415,1,1794800,1,13,13,30,224,47610224
38416,1,1794800,2,13,13,30,225,47610225
38417,0,1794800,1,13,13,30,225,47610225
38418,0,1794800,1,13,13,30,225,47610225
38419,316,1794700,1,13,13,30,541,47610541
38420,661,1794900,1,13,13,31,202,47611202
38421,136,1794900,1,13,13,31,338,47611338
38422,2065,1794900,1,13,13,33,403,47613403
38423,1641,1794700,1,13,13,35,44,47615044
38424,1330,1794800,2,13,13,36,374,47616374
38425,1448,1794900,1,13,13,37,822,47617822
38426,2230,1794900,1,13,13,40,52,47620052
38427,1381,1795000,1,13,13,41,433,47621433
38428,1048,1794900,1,13,13,42,481,47622481
38429,1436,1794900,2,13,13,43,917,47623917
38430,3202,1794900,4,13,13,47,119,47627119
38431,821,1794900,1,13,13,47,940,47627940
38432,2567,1794900,1,13,13,50,507,47630507
38433,5210,1794900,1,13,13,55,717,47635717
38434,204,1794900,1,13,13,55,921,47635921
38436,5309,1794900,2,13,14,1,230,47641230
38437,0,1794900,1,13,14,1,230,47641230
38438,1,1794800,1,13,14,1,231,47641231
38439,319,1794900,3,13,14,1,550,47641550
38440,1710,1794900,1,13,14,3,260,47643260
38441,746,1794800,2,13,14,4,6,47644006
38442,960,1794800,1,13,14,4,966,47644966
38443,2447,1794900,1,13,14,7,413,47647413
38444,67,1794900,2,13,14,7,480,47647480
38445,3656,1794800,1,13,14,11,136,47651136
38446,311,1794900,1,13,14,11,447,47651447
38447,2070,1794800,3,13,14,13,517,47653517
38448,0,1794800,1,13,14,13,517,47653517
38449,2290,1794800,3,13,14,15,807,47655807
38450,175,1794800,4,13,14,15,982,47655982
38451,1147,1794800,5,13,14,17,129,47657129
38452,1018,1794900,1,13,14,18,147,47658147
38453,197,1794800,2,13,14,18,344,47658344
38454,0,1794800,1,13,14,18,344,47658344
38455,2030,1794800,1,13,14,20,374,47660374
38456,418,1794900,1,13,14,20,792,47660792
38457,938,1794900,1,13,14,21,730,47661730
38458,234,1794700,1,13,14,21,964,47661964
38459,196,1794700,1,13,14,22,160,47662160
38460,173,1794700,1,13,14,22,333,47662333
38461,178,1794700,1,13,14,22,511,47662511
38462,152,1794700,1,13,14,22,663,47662663
38463,27,1794700,4,13,14,22,690,47662690
38464,91,1794700,1,13,14,22,781,47662781
38465,171,1794700,1,13,14,22,952,47662952
38466,146,1794700,1,13,14,23,98,47663098
38467,145,1794700,1,13,14,23,243,47663243
38468,147,1794700,1,13,14,23,390,47663390
38469,143,1794700,1,13,14,23,533,47663533
38470,177,1794700,1,13,14,23,710,47663710
38471,1,1794700,1,13,14,23,711,47663711
38472,0,1794700,1,13,14,23,711,47663711
38473,0,1794700,3,13,14,23,711,47663711
38474,0,1794700,2,13,14,23,711,47663711
38475,0,1794700,2,13,14,23,711,47663711
38476,1,1794700,1,13,14,23,712,47663712
38477,0,1794700,3,13,14,23,712,47663712
38478,1,1794700,1,13,14,23,713,47663713
38479,1543,1794700,1,13,14,25,256,47665256
38480,569,1794600,1,13,14,25,825,47665825
38481,0,1794600,1,13,14,25,825,47665825
38482,0,1794600,8,13,14,25,825,47665825
38483,0,1794600,1,13,14,25,825,47665825
38484,0,1794600,12,13,14,25,825,47665825
38485,0,1794600,1,13,14,25,825,47665825
38486,706,1794600,2,13,14,26,531,47666531
38487,467,1794500,1,13,14,26,998,47666998
38488,76,1794500,1,13,14,27,74,47667074
38489,142,1794600,1,13,14,27,216,47667216
38490,69,1794500,1,13,14,27,285,47667285
38491,50,1794500,1,13,14,27,335,47667335
38492,404,1794600,1,13,14,27,739,47667739
38493,534,1794600,1,13,14,28,273,47668273
38494,657,1794500,4,13,14,28,930,47668930
38495,49,1794500,1,13,14,28,979,47668979
38496,19,1794600,1,13,14,28,998,47668998
38497,628,1794500,1,13,14,29,626,47669626
38498,27,1794600,1,13,14,29,653,47669653
38499,318,1794500,1,13,14,29,971,47669971
38500,661,1794500,1,13,14,30,632,47670632
38501,100,1794600,1,13,14,30,732,47670732
38502,51,1794500,1,13,14,30,783,47670783
38503,43,1794500,1,13,14,30,826,47670826
38504,106,1794500,1,13,14,30,932,47670932
38505,175,1794500,1,13,14,31,107,47671107
38506,77,1794500,2,13,14,31,184,47671184
38507,124,1794500,1,13,14,31,308,47671308
38508,56,1794500,1,13,14,31,364,47671364
38509,94,1794500,1,13,14,31,458,47671458
38510,175,1794400,1,13,14,31,633,47671633
38511,2,1794400,5,13,14,31,635,47671635
38512,114,1794400,1,13,14,31,749,47671749
38513,197,1794300,1,13,14,31,946,47671946
38514,1996,1794400,3,13,14,33,942,47673942
38515,16,1794300,1,13,14,33,958,47673958
38516,201,1794400,3,13,14,34,159,47674159
38517,88,1794400,1,13,14,34,247,47674247
38518,400,1794300,1,13,14,34,647,47674647
38519,1049,1794300,1,13,14,35,696,47675696
38520,104,1794300,1,13,14,35,800,47675800
38521,519,1794300,5,13,14,36,319,47676319
38522,336,1794300,1,13,14,36,655,47676655
38523,1823,1794300,1,13,14,38,478,47678478
38524,286,1794400,3,13,14,38,764,47678764
38525,460,1794300,1,13,14,39,224,47679224
38526,95,1794400,1,13,14,39,319,47679319
38527,62,1794300,1,13,14,39,381,47679381
38528,216,1794400,1,13,14,39,597,47679597
38529,1754,1794400,1,13,14,41,351,47681351
38530,109,1794400,1,13,14,41,460,47681460
38531,142,1794300,1,13,14,41,602,47681602
38532,900,1794400,1,13,14,42,502,47682502
38533,685,1794300,1,13,14,43,187,47683187
38534,111,1794400,1,13,14,43,298,47683298
38535,17,1794300,1,13,14,43,315,47683315
38536,115,1794400,1,13,14,43,430,47683430
38537,1810,1794300,1,13,14,45,240,47685240
38538,1646,1794300,5,13,14,46,886,47686886
38539,1513,1794400,9,13,14,48,399,47688399
38540,217,1794500,2,13,14,48,616,47688616
38541,8,1794400,3,13,14,48,624,47688624
38542,51,1794400,1,13,14,48,675,47688675
38543,0,1794400,1,13,14,48,675,47688675
38544,27,1794400,1,13,14,48,702,47688702
38545,46,1794400,1,13,14,48,748,47688748
38546,531,1794300,1,13,14,49,279,47689279
38547,66,1794500,2,13,14,49,345,47689345
38548,312,1794400,1,13,14,49,657,47689657
38549,524,1794400,1,13,14,50,181,47690181
38550,913,1794400,1,13,14,51,94,47691094
38551,303,1794300,1,13,14,51,397,47691397
38552,574,1794300,1,13,14,51,971,47691971
38553,99,1794300,1,13,14,52,70,47692070
38554,1207,1794400,1,13,14,53,277,47693277
38555,1846,1794300,1,13,14,55,123,47695123
38556,7,1794300,1,13,14,55,130,47695130
38557,229,1794400,2,13,14,55,359,47695359
38558,23,1794200,1,13,14,55,382,47695382
38559,324,1794200,1,13,14,55,706,47695706
38560,111,1794200,1,13,14,55,817,47695817
38561,35,1794200,1,13,14,55,852,47695852
38562,21,1794200,1,13,14,55,873,47695873
38563,20,1794200,1,13,14,55,893,47695893
38564,1,1794200,1,13,14,55,894,47695894
38565,218,1794200,1,13,14,56,112,47696112
38566,460,1794300,2,13,14,56,572,47696572
38567,226,1794200,7,13,14,56,798,47696798
38568,1,1794200,1,13,14,56,799,47696799
38569,900,1794100,4,13,14,57,699,47697699
38570,51,1794100,1,13,14,57,750,47697750
38571,2,1794000,1,13,14,57,752,47697752
38572,20,1794000,1,13,14,57,772,47697772
38573,4,1794000,1,13,14,57,776,47697776
38574,101,1794000,4,13,14,57,877,47697877
38575,59,1794000,4,13,14,57,936,47697936
38576,105,1794000,1,13,14,58,41,47698041
38577,102,1794000,8,13,14,58,143,47698143
38578,16,1794000,4,13,14,58,159,47698159
38579,0,1794000,6,13,14,58,159,47698159
38580,1,1794000,1,13,14,58,160,47698160
38581,0,1794000,1,13,14,58,160,47698160
38582,30,1793900,1,13,14,58,190,47698190
38583,20,1794000,1,13,14,58,210,47698210
38584,11,1793900,1,13,14,58,221,47698221
38585,6,1793900,1,13,14,58,227,47698227
38586,1,1793900,1,13,14,58,228,47698228
38587,4,1793800,1,13,14,58,232,47698232
38588,60,1793800,1,13,14,58,292,47698292
38589,178,1793800,3,13,14,58,470,47698470
38590,215,1793800,1,13,14,58,685,47698685
38591,70,1793900,1,13,14,58,755,47698755
38592,58,1793800,2,13,14,58,813,47698813
38593,365,1793900,1,13,14,59,178,47699178
38594,110,1793900,1,13,14,59,288,47699288
38595,126,1793900,1,13,14,59,414,47699414
38596,15,1793900,1,13,14,59,429,47699429
38597,33,1793900,2,13,14,59,462,47699462
38598,757,1794000,1,13,15,0,219,47700219
38599,11,1793900,2,13,15,0,230,47700230
38600,0,1793900,1,13,15,0,230,47700230
38601,0,1793900,1,13,15,0,230,47700230
38602,1,1793900,1,13,15,0,231,47700231
38603,0,1793900,1,13,15,0,231,47700231
38604,0,1793900,1,13,15,0,231,47700231
38605,0,1793900,1,13,15,0,231,47700231
38606,3,1794100,1,13,15,0,234,47700234
38607,0,1794100,2,13,15,0,234,47700234
38608,0,1794100,1,13,15,0,234,47700234
38609,1,1794100,1,13,15,0,235,47700235
38610,1,1794100,1,13,15,0,236,47700236
38611,1,1794100,1,13,15,0,237,47700237
38612,46,1794100,1,13,15,0,283,47700283
38613,73,1794000,4,13,15,0,356,47700356
38614,0,1794000,4,13,15,0,356,47700356
38615,0,1794000,4,13,15,0,356,47700356
38617,7,1793800,2,13,15,0,363,47700363
38618,33,1793800,1,13,15,0,396,47700396
38619,0,1793800,1,13,15,0,396,47700396
38620,31,1793900,1,13,15,0,427,47700427
38621,22,1793800,1,13,15,0,449,47700449
38622,24,1793800,1,13,15,0,473,47700473
38623,29,1793800,2,13,15,0,502,47700502
38624,5,1793900,5,13,15,0,507,47700507
38625,7,1793800,2,13,15,0,514,47700514
38626,10,1793800,1,13,15,0,524,47700524
38627,15,1793800,2,13,15,0,539,47700539
38628,15,1793800,3,13,15,0,554,47700554
38629,19,1793700,2,13,15,0,573,47700573
38630,14,1793700,1,13,15,0,587,47700587
38631,7,1793800,3,13,15,0,594,47700594
38632,15,1793800,1,13,15,0,609,47700609
38633,119,1793700,2,13,15,0,728,47700728
38634,56,1793700,4,13,15,0,784,47700784
38635,10,1793900,1,13,15,0,794,47700794
38636,16,1793900,1,13,15,0,810,47700810
38637,43,1793700,1,13,15,0,853,47700853
38638,66,1793800,1,13,15,0,919,47700919
38639,0,1793700,4,13,15,0,919,47700919
38640,62,1793700,1,13,15,0,981,47700981
38641,63,1793700,2,13,15,1,44,47701044
38642,115,1793900,3,13,15,1,159,47701159
38644,11,1793800,1,13,15,1,170,47701170
38645,31,1793800,1,13,15,1,201,47701201
38646,9,1793800,1,13,15,1,210,47701210
38647,15,1793800,1,13,15,1,225,47701225
38648,20,1793800,4,13,15,1,245,47701245
38649,0,1793700,1,13,15,1,245,47701245
38650,43,1793700,1,13,15,1,288,47701288
38651,13,1793700,2,13,15,1,301,47701301
38652,28,1793700,1,13,15,1,329,47701329
38653,6,1793700,1,13,15,1,335,47701335
38654,4,1793700,4,13,15,1,339,47701339
38655,1,1793800,2,13,15,1,340,47701340
38656,56,1793700,1,13,15,1,396,47701396
38657,8,1793700,1,13,15,1,404,47701404
38658,14,1793800,1,13,15,1,418,47701418
38659,2,1793800,1,13,15,1,420,47701420
38660,104,1793700,1,13,15,1,524,47701524
38661,24,1793800,1,13,15,1,548,47701548
38662,123,1793800,1,13,15,1,671,47701671
38663,81,1793800,1,13,15,1,752,47701752
38664,31,1793900,1,13,15,1,783,47701783
38665,84,1793800,1,13,15,1,867,47701867
38666,130,1793800,1,13,15,1,997,47701997
38667,3,1793700,1,13,15,2,0,47702000
38668,136,1793700,2,13,15,2,136,47702136
38669,40,1793700,1,13,15,2,176,47702176
38670,170,1793900,1,13,15,2,346,47702346
38671,235,1794000,4,13,15,2,581,47702581
38672,4,1794000,1,13,15,2,585,47702585
38673,119,1794100,2,13,15,2,704,47702704
38674,55,1794100,2,13,15,2,759,47702759
38675,168,1793800,2,13,15,2,927,47702927
38676,78,1793800,1,13,15,3,5,47703005
38677,12,1793800,1,13,15,3,17,47703017
38678,28,1793800,1,13,15,3,45,47703045
38679,63,1793800,1,13,15,3,108,47703108
38680,24,1793800,1,13,15,3,132,47703132
38681,274,1793900,1,13,15,3,406,47703406
38683,97,1793800,2,13,15,3,503,47703503
38684,139,1793800,1,13,15,3,642,47703642
38685,70,1793800,1,13,15,3,712,47703712
38686,73,1793900,1,13,15,3,785,47703785
38687,128,1793800,1,13,15,3,913,47703913
38688,9,1793900,1,13,15,3,922,47703922
38689,41,1793800,1,13,15,3,963,47703963
38690,56,1793800,1,13,15,4,19,47704019
38691,21,1793800,1,13,15,4,40,47704040
38692,1,1793800,3,13,15,4,41,47704041
38693,385,1793800,1,13,15,4,426,47704426
38694,690,1793700,1,13,15,5,116,47705116
38695,155,1793800,1,13,15,5,271,47705271
38696,322,1793900,1,13,15,5,593,47705593
38697,767,1793900,1,13,15,6,360,47706360
38698,816,1793800,1,13,15,7,176,47707176
38699,540,1793800,3,13,15,7,716,47707716
38700,493,1793800,1,13,15,8,209,47708209
38701,317,1793800,4,13,15,8,526,47708526
38702,194,1793800,1,13,15,8,720,47708720
38703,773,1793700,1,13,15,9,493,47709493
38704,323,1793700,4,13,15,9,816,47709816
38705,496,1793600,1,13,15,10,312,47710312
38706,132,1793700,1,13,15,10,444,47710444
38707,2,1793700,1,13,15,10,446,47710446
38709,82,1793600,1,13,15,10,528,47710528
38710,4,1793600,8,13,15,10,532,47710532
38711,42,1793600,1,13,15,10,574,47710574
38712,5,1793600,1,13,15,10,579,47710579
38713,102,1793700,1,13,15,10,681,47710681
38714,31,1793800,1,13,15,10,712,47710712
38715,1,1793800,3,13,15,10,713,47710713
38716,39,1793800,1,13,15,10,752,47710752
38717,23,1793800,2,13,15,10,775,47710775
38719,97,1793800,1,13,15,10,872,47710872
38720,109,1793900,2,13,15,10,981,47710981
38721,39,1793900,2,13,15,11,20,47711020
38723,1,1794000,2,13,15,11,21,47711021
38724,404,1793900,1,13,15,11,425,47711425
38725,4,1793900,1,13,15,11,429,47711429
38726,15,1793900,1,13,15,11,444,47711444
38727,116,1793900,1,13,15,11,560,47711560
38728,304,1794000,1,13,15,11,864,47711864
38729,204,1794000,1,13,15,12,68,47712068
38730,5,1794000,1,13,15,12,73,47712073
38731,120,1794100,1,13,15,12,193,47712193
38732,0,1794100,7,13,15,12,193,47712193
38733,87,1794200,1,13,15,12,280,47712280
38734,195,1794300,1,13,15,12,475,47712475
38735,158,1794400,2,13,15,12,633,47712633
38736,11,1794200,1,13,15,12,644,47712644
38737,209,1794200,1,13,15,12,853,47712853
38738,118,1794300,1,13,15,12,971,47712971
38739,286,1794200,4,13,15,13,257,47713257
38740,69,1794200,1,13,15,13,326,47713326
38741,648,1794200,1,13,15,13,974,47713974
38742,2042,1794200,1,13,15,16,16,47716016
38743,212,1794100,1,13,15,16,228,47716228
38744,77,1794100,1,13,15,16,305,47716305
38745,1,1794100,2,13,15,16,306,47716306
38746,335,1794000,1,13,15,16,641,47716641
38747,646,1793900,1,13,15,17,287,47717287
38748,326,1793900,1,13,15,17,613,47717613
38749,0,1793900,1,13,15,17,613,47717613
38750,0,1793900,1,13,15,17,613,47717613
38751,1703,1794000,1,13,15,19,316,47719316
38752,2261,1794000,1,13,15,21,577,47721577
38753,326,1794200,2,13,15,21,903,47721903
38754,119,1794200,2,13,15,22,22,47722022
38755,201,1794100,2,13,15,22,223,47722223
38756,1306,1794200,1,13,15,23,529,47723529
38757,160,1794300,1,13,15,23,689,47723689
38758,275,1794300,1,13,15,23,964,47723964
38759,87,1794300,1,13,15,24,51,47724051
38760,139,1794300,1,13,15,24,190,47724190
38761,11,1794300,1,13,15,24,201,47724201
38762,1712,1794300,9,13,15,25,913,47725913
38763,1,1794300,1,13,15,25,914,47725914
38764,0,1794300,3,13,15,25,914,47725914
38765,298,1794300,1,13,15,26,212,47726212
38766,526,1794300,1,13,15,26,738,47726738
38767,140,1794300,1,13,15,26,878,47726878
38768,326,1794200,1,13,15,27,204,47727204
38769,798,1794300,1,13,15,28,2,47728002
38770,150,1794200,1,13,15,28,152,47728152
38771,0,1794200,1,13,15,28,152,47728152
38772,0,1794200,1,13,15,28,152,47728152
38773,579,1794100,2,13,15,28,731,47728731
38774,60,1794000,1,13,15,28,791,47728791
38775,30,1794100,1,13,15,28,821,47728821
38776,38,1794000,1,13,15,28,859,47728859
38777,149,1794100,1,13,15,29,8,47729008
38778,180,1794000,1,13,15,29,188,47729188
38779,426,1793900,1,13,15,29,614,47729614
38780,0,1793900,1,13,15,29,614,47729614
38781,0,1793900,3,13,15,29,614,47729614
38782,0,1793900,1,13,15,29,614,47729614
38783,0,1793900,1,13,15,29,614,47729614
38784,1,1793900,1,13,15,29,615,47729615
38785,485,1793900,1,13,15,30,100,47730100
38786,565,1793800,4,13,15,30,665,47730665
38787,66,1794000,2,13,15,30,731,47730731
38788,541,1793800,1,13,15,31,272,47731272
38789,7,1793900,4,13,15,31,279,47731279
38790,41,1793800,1,13,15,31,320,47731320
38791,32,1793800,1,13,15,31,352,47731352
38792,15,1793800,1,13,15,31,367,47731367
38793,20,1793800,1,13,15,31,387,47731387
38794,276,1793900,1,13,15,31,663,47731663
38795,40,1793900,1,13,15,31,703,47731703
38796,809,1793900,2,13,15,32,512,47732512
38797,1183,1793900,1,13,15,33,695,47733695
38798,877,1793900,1,13,15,34,572,47734572
38799,368,1793900,1,13,15,34,940,47734940
38800,634,1794000,1,13,15,35,574,47735574
38801,1327,1794100,3,13,15,36,901,47736901
38802,136,1794200,2,13,15,37,37,47737037
38803,1684,1794300,1,13,15,38,721,47738721
38804,109,1794200,1,13,15,38,830,47738830
38805,220,1794300,1,13,15,39,50,47739050
38806,245,1794300,1,13,15,39,295,47739295
38807,172,1794200,4,13,15,39,467,47739467
38808,0,1794200,4,13,15,39,467,47739467
38809,0,1794200,4,13,15,39,467,47739467
38810,0,1794200,4,13,15,39,467,47739467
38812,503,1793900,1,13,15,39,970,47739970
38813,29,1794000,1,13,15,39,999,47739999
38814,43,1794000,2,13,15,40,42,47740042
38815,330,1794100,1,13,15,40,372,47740372
38816,7,1793900,2,13,15,40,379,47740379
38817,1018,1794000,1,13,15,41,397,47741397
38818,1090,1794000,1,13,15,42,487,47742487
38819,331,1794000,1,13,15,42,818,47742818
38820,1662,1793900,1,13,15,44,480,47744480
38821,267,1794000,6,13,15,44,747,47744747
38822,42,1793900,1,13,15,44,789,47744789
38823,2858,1794000,1,13,15,47,647,47747647
38824,721,1794000,1,13,15,48,368,47748368
38825,1975,1794100,1,13,15,50,343,47750343
38826,26,1794100,1,13,15,50,369,47750369
38827,1246,1794000,1,13,15,51,615,47751615
38828,844,1794100,9,13,15,52,459,47752459
38829,726,1794100,1,13,15,53,185,47753185
38830,892,1794200,1,13,15,54,77,47754077
38831,2156,1794100,2,13,15,56,233,47756233
38833,78,1794100,1,13,15,56,311,47756311
38835,471,1794100,1,13,15,56,782,47756782
38836,975,1794200,1,13,15,57,757,47757757
38837,301,1794100,1,13,15,58,58,47758058
38838,1455,1794100,1,13,15,59,513,47759513
38839,104,1794100,1,13,15,59,617,47759617
38840,465,1794100,1,13,16,0,82,47760082
38841,148,1794100,1,13,16,0,230,47760230
38842,864,1794100,1,13,16,1,94,47761094
38843,407,1794100,2,13,16,1,501,47761501
38844,1018,1794000,1,13,16,2,519,47762519
38845,144,1794100,1,13,16,2,663,47762663
38846,160,1794200,1,13,16,2,823,47762823
38847,873,1794200,1,13,16,3,696,47763696
38848,0,1794200,7,13,16,3,696,47763696
38849,1,1794200,11,13,16,3,697,47763697
38850,549,1794300,6,13,16,4,246,47764246
38851,517,1794400,1,13,16,4,763,47764763
38852,58,1794400,1,13,16,4,821,47764821
38853,770,1794300,1,13,16,5,591,47765591
38854,510,1794400,1,13,16,6,101,47766101
38855,1168,1794300,2,13,16,7,269,47767269
38856,333,1794200,1,13,16,7,602,47767602
38857,61,1794400,1,13,16,7,663,47767663
38858,1360,1794400,1,13,16,9,23,47769023
38859,0,1794400,1,13,16,9,23,47769023
38860,869,1794400,1,13,16,9,892,47769892
38861,1009,1794500,5,13,16,10,901,47770901
38862,155,1794300,1,13,16,11,56,47771056
38863,2083,1794400,5,13,16,13,139,47773139
38864,363,1794400,1,13,16,13,502,47773502
38865,580,1794400,1,13,16,14,82,47774082
38866,350,1794400,1,13,16,14,432,47774432
38867,141,1794400,1,13,16,14,573,47774573
38868,653,1794400,2,13,16,15,226,47775226
38869,230,1794400,2,13,16,15,456,47775456
38870,555,1794300,1,13,16,16,11,47776011
38871,0,1794300,1,13,16,16,11,47776011
38872,2083,1794200,1,13,16,18,94,47778094
38873,686,1794400,2,13,16,18,780,47778780
38874,389,1794400,1,13,16,19,169,47779169
38875,654,1794400,1,13,16,19,823,47779823
38876,530,1794400,2,13,16,20,353,47780353
38877,1128,1794400,5,13,16,21,481,47781481
38878,1892,1794400,1,13,16,23,373,47783373
38879,1679,1794400,1,13,16,25,52,47785052
38880,2731,1794400,5,13,16,27,783,47787783
38882,65,1794500,3,13,16,27,848,47787848
38883,64,1794400,1,13,16,27,912,47787912
38884,37,1794400,1,13,16,27,949,47787949
38885,1533,1794400,1,13,16,29,482,47789482
38886,49,1794300,1,13,16,29,531,47789531
38887,72,1794400,5,13,16,29,603,47789603
38888,113,1794400,2,13,16,29,716,47789716
38890,1144,1794300,3,13,16,30,860,47790860
38891,1458,1794400,1,13,16,32,318,47792318
38892,0,1794400,2,13,16,32,318,47792318
38893,76,1794500,3,13,16,32,394,47792394
38894,46,1794400,1,13,16,32,440,47792440
38895,372,1794400,1,13,16,32,812,47792812
38896,149,1794300,2,13,16,32,961,47792961
38897,904,1794400,1,13,16,33,865,47793865
38898,1707,1794300,2,13,16,35,572,47795572
38899,724,1794300,2,13,16,36,296,47796296
38901,822,1794200,1,13,16,37,118,47797118
38902,1405,1794400,1,13,16,38,523,47798523
38903,768,1794500,3,13,16,39,291,47799291
38904,283,1794300,1,13,16,39,574,47799574
38905,4535,1794300,1,13,16,44,109,47804109
38906,1487,1794400,1,13,16,45,596,47805596
38907,1762,1794400,1,13,16,47,358,47807358
38908,245,1794400,3,13,16,47,603,47807603
38910,81,1794500,4,13,16,47,684,47807684
38911,205,1794400,1,13,16,47,889,47807889
38912,2781,1794500,3,13,16,50,670,47810670
38913,3096,1794500,1,13,16,53,766,47813766
38914,2279,1794500,1,13,16,56,45,47816045
38915,1965,1794600,1,13,16,58,10,47818010
38916,1119,1794500,1,13,16,59,129,47819129
38917,313,1794500,2,13,16,59,442,47819442
38918,6,1794500,1,13,16,59,448,47819448
38919,1,1794500,1,13,16,59,449,47819449
38920,691,1794400,2,13,17,0,140,47820140
38921,2571,1794500,2,13,17,2,711,47822711
38922,334,1794500,1,13,17,3,45,47823045
38923,114,1794600,1,13,17,3,159,47823159
38924,489,1794500,2,13,17,3,648,47823648
38925,190,1794500,1,13,17,3,838,47823838
38926,646,1794500,1,13,17,4,484,47824484
38927,1583,1794500,1,13,17,6,67,47826067
38928,1667,1794500,1,13,17,7,734,47827734
38929,900,1794400,1,13,17,8,634,47828634
38930,2405,1794300,7,13,17,11,39,47831039
38931,0,1794300,1,13,17,11,39,47831039
38932,1029,1794200,1,13,17,12,68,47832068
38933,793,1794300,1,13,17,12,861,47832861
38934,6465,1794400,2,13,17,19,326,47839326
38935,1267,1794400,1,13,17,20,593,47840593
38936,1767,1794300,1,13,17,22,360,47842360
38937,7,1794500,2,13,17,22,367,47842367
38938,162,1794500,1,13,17,22,529,47842529
38939,696,1794500,1,13,17,23,225,47843225
38940,154,1794500,2,13,17,23,379,47843379
38941,683,1794500,1,13,17,24,62,47844062
38942,375,1794400,2,13,17,24,437,47844437
38943,1,1794400,1,13,17,24,438,47844438
38944,1329,1794500,1,13,17,25,767,47845767
38945,0,1794500,1,13,17,25,767,47845767
38946,266,1794600,5,13,17,26,33,47846033
38947,2013,1794600,4,13,17,28,46,47848046
38948,255,1794500,1,13,17,28,301,47848301
38949,879,1794500,1,13,17,29,180,47849180
38950,706,1794500,1,13,17,29,886,47849886
38951,215,1794500,1,13,17,30,101,47850101
38952,321,1794600,1,13,17,30,422,47850422
38953,48,1794600,1,13,17,30,470,47850470
38954,1429,1794500,2,13,17,31,899,47851899
38956,438,1794600,2,13,17,32,337,47852337
38957,797,1794400,4,13,17,33,134,47853134
38959,1126,1794500,1,13,17,34,260,47854260
38960,93,1794500,1,13,17,34,353,47854353
38961,401,1794600,2,13,17,34,754,47854754
38962,1328,1794500,1,13,17,36,82,47856082
38964,1929,1794500,1,13,17,38,11,47858011
38965,6265,1794400,2,13,17,44,276,47864276
38966,0,1794400,1,13,17,44,276,47864276
38967,840,1794400,1,13,17,45,116,47865116
38968,1715,1794400,1,13,17,46,831,47866831
38969,717,1794400,1,13,17,47,548,47867548
38970,2188,1794400,1,13,17,49,736,47869736
38971,569,1794400,1,13,17,50,305,47870305
38972,1440,1794500,1,13,17,51,745,47871745
38973,1650,1794400,1,13,17,53,395,47873395
38974,1876,1794400,1,13,17,55,271,47875271
38975,541,1794400,2,13,17,55,812,47875812
38976,19,1794400,1,13,17,55,831,47875831
38977,2665,1794400,1,13,17,58,496,47878496
38978,620,1794400,1,13,17,59,116,47879116
38979,78,1794500,1,13,17,59,194,47879194
38980,2531,1794500,1,13,18,1,725,47881725
38981,411,1794500,1,13,18,2,136,47882136
38982,156,1794500,1,13,18,2,292,47882292
38983,3359,1794500,1,13,18,5,651,47885651
38984,1084,1794500,3,13,18,6,735,47886735
38985,1478,1794400,1,13,18,8,213,47888213
38986,342,1794500,1,13,18,8,555,47888555
38987,951,1794500,1,13,18,9,506,47889506
38988,43,1794500,1,13,18,9,549,47889549
38989,2499,1794500,1,13,18,12,48,47892048
38990,922,1794500,1,13,18,12,970,47892970
38991,5311,1794400,2,13,18,18,281,47898281
38992,1,1794400,4,13,18,18,282,47898282
38993,0,1794400,3,13,18,18,282,47898282
38994,0,1794400,1,13,18,18,282,47898282
38995,0,1794400,1,13,18,18,282,47898282
38996,427,1794400,1,13,18,18,709,47898709
38997,525,1794300,1,13,18,19,234,47899234
38998,0,1794300,1,13,18,19,234,47899234
38999,0,1794300,4,13,18,19,234,47899234
39000,2458,1794200,1,13,18,21,692,47901692
39001,0,1794200,5,13,18,21,692,47901692
39002,0,1794200,4,13,18,21,692,47901692
39003,708,1794200,1,13,18,22,400,47902400
39004,137,1794200,1,13,18,22,537,47902537
39005,1413,1794200,1,13,18,23,950,47903950
39006,2173,1794100,4,13,18,26,123,47906123
39007,1,1794100,1,13,18,26,124,47906124
39008,0,1794100,2,13,18,26,124,47906124
39009,0,1794100,1,13,18,26,124,47906124
39010,0,1794100,2,13,18,26,124,47906124
39011,178,1794000,10,13,18,26,302,47906302
39012,220,1794000,1,13,18,26,522,47906522
39013,1662,1794000,5,13,18,28,184,47908184
39014,45,1793900,1,13,18,28,229,47908229
39015,478,1793900,1,13,18,28,707,47908707
39016,120,1794000,1,13,18,28,827,47908827
39017,87,1794000,3,13,18,28,914,47908914
39018,54,1794000,1,13,18,28,968,47908968
39019,128,1793900,2,13,18,29,96,47909096
39020,52,1793900,2,13,18,29,148,47909148
39021,353,1793900,2,13,18,29,501,47909501
39022,729,1793900,1,13,18,30,230,47910230
39023,120,1793900,1,13,18,30,350,47910350
39024,877,1794000,1,13,18,31,227,47911227
39026,11,1793900,1,13,18,31,238,47911238
39027,1661,1794100,1,13,18,32,899,47912899
39028,690,1794000,1,13,18,33,589,47913589
39029,980,1794100,1,13,18,34,569,47914569
39030,125,1794100,1,13,18,34,694,47914694
39031,391,1794200,1,13,18,35,85,47915085
39032,568,1794200,1,13,18,35,653,47915653
39033,4,1794300,2,13,18,35,657,47915657
39034,346,1794400,1,13,18,36,3,47916003
39035,93,1794300,1,13,18,36,96,47916096
39036,459,1794200,1,13,18,36,555,47916555
39038,1910,1794200,2,13,18,38,465,47918465
39039,2221,1794100,2,13,18,40,686,47920686
39040,1852,1794200,1,13,18,42,538,47922538
39041,26,1794200,1,13,18,42,564,47922564
39042,975,1794100,1,13,18,43,539,47923539
39043,45,1794000,2,13,18,43,584,47923584
39044,820,1794200,1,13,18,44,404,47924404
39045,1688,1794100,2,13,18,46,92,47926092
39046,177,1794200,1,13,18,46,269,47926269
39047,3896,1794100,3,13,18,50,165,47930165
39048,70,1794100,1,13,18,50,235,47930235
39049,41,1794100,1,13,18,50,276,47930276
39050,181,1794100,3,13,18,50,457,47930457
39051,920,1794000,5,13,18,51,377,47931377
39052,0,1794000,2,13,18,51,377,47931377
39053,72,1794000,1,13,18,51,449,47931449
39054,1786,1794000,1,13,18,53,235,47933235
39055,346,1793900,5,13,18,53,581,47933581
39056,0,1793900,1,13,18,53,581,47933581
39057,0,1793900,1,13,18,53,581,47933581
39058,1,1793900,4,13,18,53,582,47933582
39059,1448,1794000,1,13,18,55,30,47935030
39060,199,1793800,2,13,18,55,229,47935229
39061,255,1793800,1,13,18,55,484,47935484
39062,435,1793900,1,13,18,55,919,47935919
39063,430,1793800,4,13,18,56,349,47936349
39064,553,1793800,1,13,18,56,902,47936902
39065,999,1793800,5,13,18,57,901,47937901
39066,1100,1793900,1,13,18,59,1,47939001
39067,105,1793900,1,13,18,59,106,47939106
39068,1187,1793900,1,13,19,0,293,47940293
39069,131,1793800,10,13,19,0,424,47940424
39071,405,1793900,1,13,19,0,829,47940829
39072,227,1793700,1,13,19,1,56,47941056
39073,272,1793800,1,13,19,1,328,47941328
39074,719,1793600,2,13,19,2,47,47942047
39075,236,1793700,2,13,19,2,283,47942283
39076,31,1793600,1,13,19,2,314,47942314
39077,1245,1793700,1,13,19,3,559,47943559
39078,417,1793700,1,13,19,3,976,47943976
39079,19,1793700,1,13,19,3,995,47943995
39080,45,1793700,1,13,19,4,40,47944040
39081,92,1793700,2,13,19,4,132,47944132
39082,962,1793600,1,13,19,5,94,47945094
39083,38,1793600,1,13,19,5,132,47945132
39084,166,1793800,1,13,19,5,298,47945298
39085,2806,1793800,1,13,19,8,104,47948104
39086,231,1793700,1,13,19,8,335,47948335
39087,635,1793700,1,13,19,8,970,47948970
39088,1542,1793600,5,13,19,10,512,47950512
39089,16,1793700,1,13,19,10,528,47950528
39090,78,1793600,1,13,19,10,606,47950606
39091,55,1793700,1,13,19,10,661,47950661
39092,379,1793700,1,13,19,11,40,47951040
39093,1541,1793700,1,13,19,12,581,47952581
39094,113,1793700,4,13,19,12,694,47952694
39095,1,1793700,1,13,19,12,695,47952695
39096,1090,1793600,2,13,19,13,785,47953785
39097,92,1793600,3,13,19,13,877,47953877
39098,0,1793600,1,13,19,13,877,47953877
39099,1,1793600,1,13,19,13,878,47953878
39100,872,1793500,1,13,19,14,750,47954750
39101,62,1793500,1,13,19,14,812,47954812
39102,53,1793500,3,13,19,14,865,47954865
39103,8,1793500,15,13,19,14,873,47954873
39104,1,1793500,2,13,19,14,874,47954874
39105,63,1793500,1,13,19,14,937,47954937
39106,11,1793500,1,13,19,14,948,47954948
39107,29,1793500,1,13,19,14,977,47954977
39108,17,1793400,1,13,19,14,994,47954994
39109,106,1793400,2,13,19,15,100,47955100
39110,0,1793400,3,13,19,15,100,47955100
39111,4,1793500,1,13,19,15,104,47955104
39112,26,1793600,3,13,19,15,130,47955130
39113,100,1793400,1,13,19,15,230,47955230
39114,46,1793400,1,13,19,15,276,47955276
39115,118,1793400,1,13,19,15,394,47955394
39116,51,1793300,2,13,19,15,445,47955445
39117,11,1793300,1,13,19,15,456,47955456
39118,2,1793300,1,13,19,15,458,47955458
39119,187,1793300,1,13,19,15,645,47955645
39120,11,1793300,1,13,19,15,656,47955656
39121,27,1793400,1,13,19,15,683,47955683
39122,1,1793400,2,13,19,15,684,47955684
39123,17,1793500,2,13,19,15,701,47955701
39124,76,1793500,1,13,19,15,777,47955777
39125,59,1793400,1,13,19,15,836,47955836
39126,59,1793400,1,13,19,15,895,47955895
39127,24,1793400,1,13,19,15,919,47955919
39128,27,1793400,1,13,19,15,946,47955946
39129,85,1793400,1,13,19,16,31,47956031
39130,288,1793400,1,13,19,16,319,47956319
39131,122,1793400,1,13,19,16,441,47956441
39133,7,1793500,1,13,19,16,448,47956448
39134,18,1793400,1,13,19,16,466,47956466
39135,46,1793500,2,13,19,16,512,47956512
39136,552,1793400,2,13,19,17,64,47957064
39137,224,1793400,2,13,19,17,288,47957288
39138,61,1793400,2,13,19,17,349,47957349
39139,444,1793300,3,13,19,17,793,47957793
39140,564,1793400,2,13,19,18,357,47958357
39141,211,1793400,1,13,19,18,568,47958568
39142,74,1793300,2,13,19,18,642,47958642
39143,25,1793300,3,13,19,18,667,47958667
39144,1,1793300,1,13,19,18,668,47958668
39145,0,1793300,1,13,19,18,668,47958668
39146,14,1793300,1,13,19,18,682,47958682
39147,598,1793300,1,13,19,19,280,47959280
39148,11,1793300,3,13,19,19,291,47959291
39149,226,1793200,14,13,19,19,517,47959517
39151,73,1793200,1,13,19,19,590,47959590
39152,9,1793100,8,13,19,19,599,47959599
39153,0,1793100,9,13,19,19,599,47959599
39155,6,1793000,2,13,19,19,605,47959605
39156,0,1793000,2,13,19,19,605,47959605
39157,26,1793000,1,13,19,19,631,47959631
39158,26,1793100,1,13,19,19,657,47959657
39159,16,1793000,2,13,19,19,673,47959673
39160,3,1793000,1,13,19,19,676,47959676
39161,3,1793100,1,13,19,19,679,47959679
39162,73,1793000,1,13,19,19,752,47959752
39163,30,1793000,1,13,19,19,782,47959782
39164,4,1793100,1,13,19,19,786,47959786
39165,5,1793000,1,13,19,19,791,47959791
39166,46,1793000,1,13,19,19,837,47959837
39167,57,1793000,1,13,19,19,894,47959894
39168,56,1793100,1,13,19,19,950,47959950
39169,1,1793000,1,13,19,19,951,47959951
39170,1,1793000,1,13,19,19,952,47959952
39171,100,1793000,1,13,19,20,52,47960052
39172,46,1792900,1,13,19,20,98,47960098
39173,174,1793000,1,13,19,20,272,47960272
39174,91,1792900,3,13,19,20,363,47960363
39175,164,1792900,1,13,19,20,527,47960527
39176,189,1792800,1,13,19,20,716,47960716
39177,1,1792800,19,13,19,20,717,47960717
39178,180,1792700,1,13,19,20,897,47960897
39179,12,1792700,1,13,19,20,909,47960909
39180,17,1792700,1,13,19,20,926,47960926
39182,53,1792600,2,13,19,20,979,47960979
39183,33,1792800,3,13,19,21,12,47961012
39185,4,1792700,1,13,19,21,16,47961016
39186,16,1792700,2,13,19,21,32,47961032
39187,11,1792700,1,13,19,21,43,47961043
39188,28,1792600,16,13,19,21,71,47961071
39189,40,1792700,1,13,19,21,111,47961111
39190,206,1792600,1,13,19,21,317,47961317
39191,34,1792800,6,13,19,21,351,47961351
39192,1,1792800,2,13,19,21,352,47961352
39193,5,1792700,1,13,19,21,357,47961357
39194,1,1792700,1,13,19,21,358,47961358
39195,116,1792700,1,13,19,21,474,47961474
39196,11,1792600,4,13,19,21,485,47961485
39197,22,1792600,1,13,19,21,507,47961507
39198,13,1792600,1,13,19,21,520,47961520
39199,3,1792600,1,13,19,21,523,47961523
39200,29,1792600,1,13,19,21,552,47961552
39201,1,1792600,1,13,19,21,553,47961553
39202,54,1792600,1,13,19,21,607,47961607
39203,105,1792600,4,13,19,21,712,47961712
39205,114,1792500,1,13,19,21,826,47961826
39206,57,1792600,1,13,19,21,883,47961883
39207,1,1792500,1,13,19,21,884,47961884
39208,66,1792700,5,13,19,21,950,47961950
39209,202,1792600,1,13,19,22,152,47962152
39210,7,1792600,1,13,19,22,159,47962159
39211,7,1792600,1,13,19,22,166,47962166
39212,32,1792500,1,13,19,22,198,47962198
39213,109,1792500,6,13,19,22,307,47962307
39215,46,1792400,1,13,19,22,353,47962353
39216,152,1792500,1,13,19,22,505,47962505
39217,31,1792500,2,13,19,22,536,47962536
39218,94,1792400,4,13,19,22,630,47962630
39219,7,1792400,4,13,19,22,637,47962637
39220,35,1792400,1,13,19,22,672,47962672
39221,37,1792400,1,13,19,22,709,47962709
39222,1,1792400,1,13,19,22,710,47962710
39223,4,1792400,1,13,19,22,714,47962714
39224,58,1792500,1,13,19,22,772,47962772
39225,62,1792400,1,13,19,22,834,47962834
39227,84,1792300,2,13,19,22,918,47962918
39228,2,1792300,4,13,19,22,920,47962920
39229,2,1792300,4,13,19,22,922,47962922
39230,24,1792300,4,13,19,22,946,47962946
39231,3,1792300,1,13,19,22,949,47962949
39232,10,1792300,4,13,19,22,959,47962959
39233,249,1792400,8,13,19,23,208,47963208
39235,68,1792400,1,13,19,23,276,47963276
39237,52,1792500,2,13,19,23,328,47963328
39238,1,1792400,1,13,19,23,329,47963329
39239,61,1792500,1,13,19,23,390,47963390
39240,94,1792300,1,13,19,23,484,47963484
39241,27,1792300,1,13,19,23,511,47963511
39242,25,1792500,2,13,19,23,536,47963536
39243,14,1792300,2,13,19,23,550,47963550
39244,57,1792300,1,13,19,23,607,47963607
39245,0,1792500,1,13,19,23,607,47963607
39246,128,1792300,2,13,19,23,735,47963735
39247,371,1792300,1,13,19,24,106,47964106
39248,255,1792300,1,13,19,24,361,47964361
39249,68,1792200,1,13,19,24,429,47964429
39250,59,1792200,1,13,19,24,488,47964488
39251,47,1792400,1,13,19,24,535,47964535
39252,2,1792200,1,13,19,24,537,47964537
39253,69,1792200,7,13,19,24,606,47964606
39254,32,1792200,3,13,19,24,638,47964638
39255,0,1792200,2,13,19,24,638,47964638
39256,22,1792200,5,13,19,24,660,47964660
39258,27,1792100,1,13,19,24,687,47964687
39259,15,1792100,1,13,19,24,702,47964702
39260,138,1792000,1,13,19,24,840,47964840
39261,13,1792000,1,13,19,24,853,47964853
39262,38,1792000,2,13,19,24,891,47964891
39263,11,1792000,1,13,19,24,902,47964902
39264,19,1792200,1,13,19,24,921,47964921
39265,14,1792000,2,13,19,24,935,47964935
39266,79,1792100,1,13,19,25,14,47965014
39267,24,1792200,1,13,19,25,38,47965038
39268,7,1792000,9,13,19,25,45,47965045
39270,54,1792000,1,13,19,25,99,47965099
39271,9,1791900,1,13,19,25,108,47965108
39272,126,1791800,1,13,19,25,234,47965234
39273,50,1791800,2,13,19,25,284,47965284
39274,22,1791900,1,13,19,25,306,47965306
39275,4,1791900,1,13,19,25,310,47965310
39276,1,1791800,1,13,19,25,311,47965311
39277,9,1791800,2,13,19,25,320,47965320
39278,6,1791800,1,13,19,25,326,47965326
39280,7,1791700,1,13,19,25,333,47965333
39281,12,1791700,2,13,19,25,345,47965345
39282,13,1791700,2,13,19,25,358,47965358
39283,10,1791700,2,13,19,25,368,47965368
39284,1,1791700,1,13,19,25,369,47965369
39285,5,1791600,2,13,19,25,374,47965374
39286,0,1791600,1,13,19,25,374,47965374
39287,1,1791600,1,13,19,25,375,47965375
39288,0,1791600,1,13,19,25,375,47965375
39289,0,1791600,1,13,19,25,375,47965375
39290,1,1791600,1,13,19,25,376,47965376
39291,0,1791600,1,13,19,25,376,47965376
39292,0,1791500,2,13,19,25,376,47965376
39293,1,1791500,1,13,19,25,377,47965377
39294,0,1791500,1,13,19,25,377,47965377
39295,0,1791500,2,13,19,25,377,47965377
39296,0,1791500,1,13,19,25,377,47965377
39297,0,1791500,1,13,19,25,377,47965377
39298,1,1791500,1,13,19,25,378,47965378
39299,0,1791500,1,13,19,25,378,47965378
39300,0,1791500,8,13,19,25,378,47965378
39301,0,1791500,1,13,19,25,378,47965378
39302,0,1791500,1,13,19,25,378,47965378
39303,0,1791500,1,13,19,25,378,47965378
39304,0,1791500,1,13,19,25,378,47965378
39305,0,1791500,1,13,19,25,378,47965378
39306,0,1791500,3,13,19,25,378,47965378
39307,1,1791400,1,13,19,25,379,47965379
39308,2,1791400,2,13,19,25,381,47965381
39309,0,1791300,1,13,19,25,381,47965381
39310,13,1791300,4,13,19,25,394,47965394
39311,0,1791300,3,13,19,25,394,47965394
39312,1,1791300,1,13,19,25,395,47965395
39313,1,1791400,1,13,19,25,396,47965396
39314,22,1791300,1,13,19,25,418,47965418
39315,8,1791300,1,13,19,25,426,47965426
39316,5,1791300,1,13,19,25,431,47965431
39317,2,1791300,1,13,19,25,433,47965433
39318,3,1791500,3,13,19,25,436,47965436
39319,0,1791500,2,13,19,25,436,47965436
39320,0,1791600,1,13,19,25,436,47965436
39321,7,1791500,2,13,19,25,443,47965443
39322,8,1791500,1,13,19,25,451,47965451
39323,18,1791500,1,13,19,25,469,47965469
39324,7,1791500,2,13,19,25,476,47965476
39325,0,1791700,2,13,19,25,476,47965476
39326,2,1791600,1,13,19,25,478,47965478
39327,2,1791600,1,13,19,25,480,47965480
39328,34,1791800,1,13,19,25,514,47965514
39329,13,1791600,1,13,19,25,527,47965527
39330,8,1791600,1,13,19,25,535,47965535
39331,24,1791600,1,13,19,25,559,47965559
39332,3,1791600,1,13,19,25,562,47965562
39333,5,1791600,2,13,19,25,567,47965567
39334,0,1791800,1,13,19,25,567,47965567
39335,1,1791600,1,13,19,25,568,47965568
39336,8,1791800,3,13,19,25,576,47965576
39337,0,1791800,3,13,19,25,576,47965576
39339,32,1791700,1,13,19,25,608,47965608
39340,2,1791700,1,13,19,25,610,47965610
39341,0,1791700,1,13,19,25,610,47965610
39342,10,1791800,1,13,19,25,620,47965620
39343,17,1791700,1,13,19,25,637,47965637
39344,15,1791900,1,13,19,25,652,47965652
39345,30,1791800,1,13,19,25,682,47965682
39346,38,1791900,1,13,19,25,720,47965720
39347,43,1791900,1,13,19,25,763,47965763
39348,4,1792000,1,13,19,25,767,47965767
39349,5,1792000,1,13,19,25,772,47965772
39350,29,1791900,1,13,19,25,801,47965801
39351,4,1791900,1,13,19,25,805,47965805
39352,9,1791900,1,13,19,25,814,47965814
39353,9,1791900,1,13,19,25,823,47965823
39354,53,1792000,1,13,19,25,876,47965876
39355,35,1792000,1,13,19,25,911,47965911
39356,104,1792100,1,13,19,26,15,47966015
39357,29,1792000,2,13,19,26,44,47966044
39358,11,1792000,2,13,19,26,55,47966055
39359,11,1792200,1,13,19,26,66,47966066
39360,57,1792000,1,13,19,26,123,47966123
39361,58,1792200,5,13,19,26,181,47966181
39362,12,1792100,1,13,19,26,193,47966193
39363,9,1792200,1,13,19,26,202,47966202
39364,102,1792000,1,13,19,26,304,47966304
39365,77,1792000,1,13,19,26,381,47966381
39366,18,1792000,1,13,19,26,399,47966399
39367,136,1792200,1,13,19,26,535,47966535
39368,155,1792200,1,13,19,26,690,47966690
39369,34,1792100,1,13,19,26,724,47966724
39370,62,1792100,1,13,19,26,786,47966786
39371,31,1792300,1,13,19,26,817,47966817
39372,26,1792100,1,13,19,26,843,47966843
39373,60,1792100,1,13,19,26,903,47966903
39374,18,1792300,2,13,19,26,921,47966921
39375,2,1792100,1,13,19,26,923,47966923
39376,82,1792200,1,13,19,27,5,47967005
39377,61,1792200,2,13,19,27,66,47967066
39378,64,1792300,1,13,19,27,130,47967130
39379,193,1792100,1,13,19,27,323,47967323
39380,345,1792100,1,13,19,27,668,47967668
39381,47,1792300,1,13,19,27,715,47967715
39382,0,1792300,1,13,19,27,715,47967715
39383,0,1792400,7,13,19,27,715,47967715
39384,2,1792500,2,13,19,27,717,47967717
39385,0,1792400,2,13,19,27,717,47967717
39386,8,1792600,3,13,19,27,725,47967725
39387,42,1792700,11,13,19,27,767,47967767
39388,30,1792700,1,13,19,27,797,47967797
39389,39,1792700,1,13,19,27,836,47967836
39390,60,1792700,1,13,19,27,896,47967896
39391,17,1792800,3,13,19,27,913,47967913
39392,77,1792800,2,13,19,27,990,47967990
39393,10,1792700,1,13,19,28,0,47968000
39394,1,1792700,2,13,19,28,1,47968001
39395,0,1792700,1,13,19,28,1,47968001
39396,0,1792700,1,13,19,28,1,47968001
39397,0,1792700,1,13,19,28,1,47968001
39398,222,1792700,1,13,19,28,223,47968223
39399,2,1792700,1,13,19,28,225,47968225
39400,141,1792700,1,13,19,28,366,47968366
39401,227,1792700,1,13,19,28,593,47968593
39402,146,1792800,5,13,19,28,739,47968739
39403,14,1792700,1,13,19,28,753,47968753
39404,1,1792700,1,13,19,28,754,47968754
39405,0,1792700,1,13,19,28,754,47968754
39406,34,1792700,1,13,19,28,788,47968788
39407,262,1792800,1,13,19,29,50,47969050
39408,2,1792800,1,13,19,29,52,47969052
39409,155,1792700,1,13,19,29,207,47969207
39410,1,1792700,1,13,19,29,208,47969208
39411,154,1792900,1,13,19,29,362,47969362
39412,270,1793000,1,13,19,29,632,47969632
39413,46,1792800,3,13,19,29,678,47969678
39414,37,1792800,1,13,19,29,715,47969715
39415,347,1793000,1,13,19,30,62,47970062
39416,52,1793000,1,13,19,30,114,47970114
39417,119,1793000,1,13,19,30,233,47970233
39418,181,1793000,2,13,19,30,414,47970414
39419,201,1792900,1,13,19,30,615,47970615
39420,0,1792900,1,13,19,30,615,47970615
39421,1,1792900,1,13,19,30,616,47970616
39422,22,1793000,1,13,19,30,638,47970638
39423,83,1793000,1,13,19,30,721,47970721
39424,459,1793100,2,13,19,31,180,47971180
39425,86,1793100,2,13,19,31,266,47971266
39426,196,1793300,2,13,19,31,462,47971462
39427,45,1793200,2,13,19,31,507,47971507
39428,278,1793200,1,13,19,31,785,47971785
39429,64,1793100,1,13,19,31,849,47971849
39430,83,1793200,1,13,19,31,932,47971932
39431,433,1793400,2,13,19,32,365,47972365
39432,78,1793300,3,13,19,32,443,47972443
39433,64,1793400,3,13,19,32,507,47972507
39434,356,1793400,3,13,19,32,863,47972863
39435,273,1793500,3,13,19,33,136,47973136
39436,443,1793500,1,13,19,33,579,47973579
39437,51,1793500,1,13,19,33,630,47973630
39438,164,1793400,1,13,19,33,794,47973794
39439,502,1793400,1,13,19,34,296,47974296
39440,902,1793400,1,13,19,35,198,47975198
39441,1,1793400,1,13,19,35,199,47975199
39442,0,1793400,1,13,19,35,199,47975199
39443,94,1793400,1,13,19,35,293,47975293
39444,494,1793300,1,13,19,35,787,47975787
39445,271,1793200,1,13,19,36,58,47976058
39446,50,1793300,1,13,19,36,108,47976108
39447,173,1793300,1,13,19,36,281,47976281
39448,58,1793200,1,13,19,36,339,47976339
39449,17,1793200,1,13,19,36,356,47976356
39450,18,1793300,1,13,19,36,374,47976374
39451,157,1793200,1,13,19,36,531,47976531
39452,124,1793300,2,13,19,36,655,47976655
39453,426,1793200,1,13,19,37,81,47977081
39454,439,1793100,3,13,19,37,520,47977520
39456,391,1793100,1,13,19,37,911,47977911
39457,329,1793200,1,13,19,38,240,47978240
39458,742,1793000,1,13,19,38,982,47978982
39459,0,1793000,1,13,19,38,982,47978982
39460,1,1793000,1,13,19,38,983,47978983
39461,0,1793000,1,13,19,38,983,47978983
39462,0,1793000,1,13,19,38,983,47978983
39463,462,1792900,1,13,19,39,445,47979445
39464,1,1792900,1,13,19,39,446,47979446
39465,360,1793000,4,13,19,39,806,47979806
39466,547,1792900,1,13,19,40,353,47980353
39467,1100,1792900,1,13,19,41,453,47981453
39468,1141,1792900,1,13,19,42,594,47982594
39469,249,1792900,4,13,19,42,843,47982843
39470,963,1792800,1,13,19,43,806,47983806
39471,33,1792900,1,13,19,43,839,47983839
39472,609,1792900,2,13,19,44,448,47984448
39473,95,1792900,2,13,19,44,543,47984543
39475,1124,1792900,1,13,19,45,667,47985667
39476,802,1792900,1,13,19,46,469,47986469
39477,179,1792900,1,13,19,46,648,47986648
39478,42,1792900,3,13,19,46,690,47986690
39479,566,1792900,3,13,19,47,256,47987256
39480,1394,1792900,2,13,19,48,650,47988650
39481,0,1792900,1,13,19,48,650,47988650
39482,458,1792900,1,13,19,49,108,47989108
39483,489,1793000,1,13,19,49,597,47989597
39484,51,1793000,6,13,19,49,648,47989648
39485,201,1793100,1,13,19,49,849,47989849
39486,171,1793100,5,13,19,50,20,47990020
39487,433,1792900,1,13,19,50,453,47990453
39488,548,1792900,1,13,19,51,1,47991001
39489,906,1793000,1,13,19,51,907,47991907
39490,218,1793000,2,13,19,52,125,47992125
39491,110,1792900,6,13,19,52,235,47992235
39492,0,1792900,6,13,19,52,235,47992235
39494,3,1792800,1,13,19,52,238,47992238
39495,60,1792900,1,13,19,52,298,47992298
39496,210,1792900,1,13,19,52,508,47992508
39497,2029,1792900,1,13,19,54,537,47994537
39498,156,1792800,1,13,19,54,693,47994693
39499,140,1792700,1,13,19,54,833,47994833
39500,1083,1792800,1,13,19,55,916,47995916
39501,300,1792900,1,13,19,56,216,47996216
39502,318,1792700,1,13,19,56,534,47996534
39503,159,1792900,1,13,19,56,693,47996693
39504,503,1792700,3,13,19,57,196,47997196
39505,132,1792700,3,13,19,57,328,47997328
39506,0,1792700,1,13,19,57,328,47997328
39507,2069,1792700,1,13,19,59,397,47999397
39508,236,1792600,9,13,19,59,633,47999633
39509,68,1792700,3,13,19,59,701,47999701
39510,29,1792700,2,13,19,59,730,47999730
39511,515,1792700,2,13,20,0,245,48000245
39512,54,1792500,5,13,20,0,299,48000299
39513,6,1792500,5,13,20,0,305,48000305
39514,7,1792600,1,13,20,0,312,48000312
39515,40,1792500,2,13,20,0,352,48000352
39517,0,1792400,2,13,20,0,352,48000352
39518,0,1792400,2,13,20,0,352,48000352
39519,0,1792400,1,13,20,0,352,48000352
39520,1,1792300,3,13,20,0,353,48000353
39521,1,1792400,2,13,20,0,354,48000354
39522,0,1792400,1,13,20,0,354,48000354
39523,0,1792400,1,13,20,0,354,48000354
39524,18,1792600,1,13,20,0,372,48000372
39525,130,1792400,1,13,20,0,502,48000502
39526,15,1792600,5,13,20,0,517,48000517
39527,5,1792400,1,13,20,0,522,48000522
39528,25,1792400,1,13,20,0,547,48000547
39529,13,1792400,1,13,20,0,560,48000560
39530,7,1792400,1,13,20,0,567,48000567
39531,5,1792400,1,13,20,0,572,48000572
39532,0,1792400,1,13,20,0,572,48000572
39533,35,1792300,1,13,20,0,607,48000607
39534,6,1792300,1,13,20,0,613,48000613
39535,83,1792500,1,13,20,0,696,48000696
39536,93,1792300,2,13,20,0,789,48000789
39537,0,1792300,2,13,20,0,789,48000789
39538,0,1792300,1,13,20,0,789,48000789
39540,167,1792400,1,13,20,0,956,48000956
39541,178,1792300,1,13,20,1,134,48001134
39542,23,1792400,1,13,20,1,157,48001157
39543,69,1792200,1,13,20,1,226,48001226
39544,0,1792200,1,13,20,1,226,48001226
39545,0,1792200,1,13,20,1,226,48001226
39546,1,1792200,1,13,20,1,227,48001227
39547,253,1792300,1,13,20,1,480,48001480
39548,60,1792400,1,13,20,1,540,48001540
39550,121,1792500,1,13,20,1,661,48001661
39551,73,1792400,1,13,20,1,734,48001734
39552,347,1792400,1,13,20,2,81,48002081
39553,119,1792500,3,13,20,2,200,48002200
39554,298,1792600,2,13,20,2,498,48002498
39555,533,1792700,1,13,20,3,31,48003031
39556,1,1792700,2,13,20,3,32,48003032
39557,70,1792700,2,13,20,3,102,48003102
39558,747,1792700,5,13,20,3,849,48003849
39559,215,1792700,2,13,20,4,64,48004064
39560,48,1792800,1,13,20,4,112,48004112
39561,303,1792600,7,13,20,4,415,48004415
39562,223,1792700,1,13,20,4,638,48004638
39563,92,1792600,1,13,20,4,730,48004730
39564,159,1792700,1,13,20,4,889,48004889
39565,480,1792900,2,13,20,5,369,48005369
39566,259,1792900,4,13,20,5,628,48005628
39567,276,1792900,2,13,20,5,904,48005904
39568,50,1792800,1,13,20,5,954,48005954
39569,623,1792800,6,13,20,6,577,48006577
39570,0,1792800,6,13,20,6,577,48006577
39572,1,1792800,1,13,20,6,578,48006578
39573,1,1792800,1,13,20,6,579,48006579
39574,17,1792900,1,13,20,6,596,48006596
39575,175,1792700,1,13,20,6,771,48006771
39576,109,1792900,1,13,20,6,880,48006880
39577,167,1792800,4,13,20,7,47,48007047
39579,23,1792900,1,13,20,7,70,48007070
39580,30,1792700,1,13,20,7,100,48007100
39581,1,1792700,1,13,20,7,101,48007101
39582,0,1792700,1,13,20,7,101,48007101
39583,636,1792800,1,13,20,7,737,48007737
39584,852,1792700,1,13,20,8,589,48008589
39585,430,1792800,1,13,20,9,19,48009019
39586,73,1792800,1,13,20,9,92,48009092
39588,232,1792800,1,13,20,9,324,48009324
39589,1203,1792800,1,13,20,10,527,48010527
39590,94,1792800,1,13,20,10,621,48010621
39591,115,1792800,2,13,20,10,736,48010736
39592,36,1792800,1,13,20,10,772,48010772
39593,1341,1792800,1,13,20,12,113,48012113
39594,292,1792700,1,13,20,12,405,48012405
39595,547,1792800,2,13,20,12,952,48012952
39596,635,1792800,1,13,20,13,587,48013587
39597,28,1792900,1,13,20,13,615,48013615
39598,415,1792800,6,13,20,14,30,48014030
39599,436,1792700,1,13,20,14,466,48014466
39600,179,1792800,1,13,20,14,645,48014645
39601,346,1792700,2,13,20,14,991,48014991
39602,1,1792700,4,13,20,14,992,48014992
39603,0,1792700,1,13,20,14,992,48014992
39604,0,1792700,3,13,20,14,992,48014992
39605,0,1792700,5,13,20,14,992,48014992
39606,181,1792700,1,13,20,15,173,48015173
39607,418,1792600,2,13,20,15,591,48015591
39608,780,1792800,1,13,20,16,371,48016371
39609,205,1792700,1,13,20,16,576,48016576
39610,57,1792700,1,13,20,16,633,48016633
39611,33,1792700,1,13,20,16,666,48016666
39612,1962,1792800,1,13,20,18,628,48018628
39613,97,1792700,1,13,20,18,725,48018725
39614,1,1792700,1,13,20,18,726,48018726
39615,0,1792600,1,13,20,18,726,48018726
39616,518,1792600,1,13,20,19,244,48019244
39617,1125,1792800,1,13,20,20,369,48020369
39618,1,1792800,1,13,20,20,370,48020370
39619,1826,1792800,1,13,20,22,196,48022196
39620,1628,1792800,1,13,20,23,824,48023824
39621,0,1792800,1,13,20,23,824,48023824
39622,0,1792800,1,13,20,23,824,48023824
39623,1049,1792800,1,13,20,24,873,48024873
39624,375,1792800,5,13,20,25,248,48025248
39626,341,1792600,2,13,20,25,589,48025589
39627,160,1792600,1,13,20,25,749,48025749
39628,731,1792700,1,13,20,26,480,48026480
39629,1630,1792600,1,13,20,28,110,48028110
39630,115,1792600,1,13,20,28,225,48028225
39631,0,1792600,1,13,20,28,225,48028225
39632,1,1792600,1,13,20,28,226,48028226
39633,0,1792600,1,13,20,28,226,48028226
39634,0,1792600,1,13,20,28,226,48028226
39635,0,1792500,1,13,20,28,226,48028226
39636,1,1792500,1,13,20,28,227,48028227
39637,187,1792600,1,13,20,28,414,48028414
39638,557,1792500,1,13,20,28,971,48028971
39639,0,1792500,6,13,20,28,971,48028971
39640,124,1792500,1,13,20,29,95,48029095
39641,23,1792600,1,13,20,29,118,48029118
39642,618,1792400,1,13,20,29,736,48029736
39643,701,1792600,1,13,20,30,437,48030437
39644,465,1792400,1,13,20,30,902,48030902
39645,103,1792400,1,13,20,31,5,48031005
39646,557,1792600,1,13,20,31,562,48031562
39647,1836,1792500,1,13,20,33,398,48033398
39648,1024,1792500,1,13,20,34,422,48034422
39649,141,1792600,15,13,20,34,563,48034563
39650,180,1792600,1,13,20,34,743,48034743
39651,886,1792700,3,13,20,35,629,48035629
39652,233,1792700,1,13,20,35,862,48035862
39653,285,1792600,1,13,20,36,147,48036147
39654,898,1792700,1,13,20,37,45,48037045
39655,55,1792600,1,13,20,37,100,48037100
39656,203,1792700,2,13,20,37,303,48037303
39657,149,1792600,1,13,20,37,452,48037452
39658,589,1792600,1,13,20,38,41,48038041
39659,66,1792500,1,13,20,38,107,48038107
39660,173,1792600,3,13,20,38,280,48038280
39661,14,1792600,1,13,20,38,294,48038294
39662,49,1792400,1,13,20,38,343,48038343
39663,1343,1792500,1,13,20,39,686,48039686
39664,15,1792500,1,13,20,39,701,48039701
39665,2608,1792500,3,13,20,42,309,48042309
39666,888,1792500,1,13,20,43,197,48043197
39667,318,1792400,1,13,20,43,515,48043515
39668,165,1792600,1,13,20,43,680,48043680
39669,13,1792500,1,13,20,43,693,48043693
39670,26,1792400,1,13,20,43,719,48043719
39671,406,1792400,1,13,20,44,125,48044125
39672,92,1792500,1,13,20,44,217,48044217
39673,171,1792400,1,13,20,44,388,48044388
39674,241,1792500,1,13,20,44,629,48044629
39675,61,1792400,1,13,20,44,690,48044690
39676,1,1792400,1,13,20,44,691,48044691
39677,0,1792400,1,13,20,44,691,48044691
39678,1056,1792300,3,13,20,45,747,48045747
39679,0,1792300,1,13,20,45,747,48045747
39680,0,1792300,4,13,20,45,747,48045747
39681,1072,1792200,2,13,20,46,819,48046819
39682,528,1792200,2,13,20,47,347,48047347
39683,204,1792300,1,13,20,47,551,48047551
39684,19,1792200,1,13,20,47,570,48047570
39685,0,1792200,1,13,20,47,570,48047570
39686,0,1792200,12,13,20,47,570,48047570
39687,28,1792100,7,13,20,47,598,48047598
39688,261,1792200,1,13,20,47,859,48047859
39689,26,1792100,1,13,20,47,885,48047885
39690,213,1792100,1,13,20,48,98,48048098
39691,324,1792000,1,13,20,48,422,48048422
39692,94,1792100,1,13,20,48,516,48048516
39693,164,1792100,1,13,20,48,680,48048680
39694,154,1792100,1,13,20,48,834,48048834
39695,7,1792000,1,13,20,48,841,48048841
39696,71,1792200,5,13,20,48,912,48048912
39697,76,1792100,1,13,20,48,988,48048988
39698,234,1792100,1,13,20,49,222,48049222
39699,88,1792100,2,13,20,49,310,48049310
39700,43,1792100,1,13,20,49,353,48049353
39701,256,1792100,1,13,20,49,609,48049609
39702,44,1792300,3,13,20,49,653,48049653
39703,0,1792300,1,13,20,49,653,48049653
39704,0,1792300,2,13,20,49,653,48049653
39705,839,1792400,2,13,20,50,492,48050492
39706,0,1792400,1,13,20,50,492,48050492
39707,1,1792400,1,13,20,50,493,48050493
39708,133,1792500,1,13,20,50,626,48050626
39709,900,1792300,2,13,20,51,526,48051526
39710,1023,1792300,1,13,20,52,549,48052549
39711,408,1792300,1,13,20,52,957,48052957
39712,168,1792300,1,13,20,53,125,48053125
39713,579,1792300,1,13,20,53,704,48053704
39714,784,1792300,1,13,20,54,488,48054488
39715,1096,1792400,2,13,20,55,584,48055584
39716,454,1792200,1,13,20,56,38,48056038
39717,2126,1792200,1,13,20,58,164,48058164
39718,362,1792200,1,13,20,58,526,48058526
39719,68,1792300,1,13,20,58,594,48058594
39720,627,1792200,3,13,20,59,221,48059221
39721,611,1792300,1,13,20,59,832,48059832
39722,583,1792200,5,13,21,0,415,48060415
39723,62,1792100,1,13,21,0,477,48060477
39724,0,1792100,2,13,21,0,477,48060477
39725,0,1792100,3,13,21,0,477,48060477
39726,0,1792100,1,13,21,0,477,48060477
39727,1,1792100,2,13,21,0,478,48060478
39728,0,1792000,5,13,21,0,478,48060478
39729,0,1792000,2,13,21,0,478,48060478
39730,0,1792000,1,13,21,0,478,48060478
39731,1,1792000,1,13,21,0,479,48060479
39732,7,1792000,3,13,21,0,486,48060486
39733,1,1792000,6,13,21,0,487,48060487
39734,14,1792000,1,13,21,0,501,48060501
39735,352,1791900,2,13,21,0,853,48060853
39736,170,1792100,2,13,21,1,23,48061023
39737,77,1792100,1,13,21,1,100,48061100
39738,0,1792000,1,13,21,1,100,48061100
39739,0,1792000,1,13,21,1,100,48061100
39740,0,1792000,1,13,21,1,100,48061100
39741,0,1792000,1,13,21,1,100,48061100
39742,0,1792000,1,13,21,1,100,48061100
39743,2,1792000,1,13,21,1,102,48061102
39744,148,1792100,2,13,21,1,250,48061250
39745,254,1792000,1,13,21,1,504,48061504
39746,101,1792000,2,13,21,1,605,48061605
39747,9,1792000,1,13,21,1,614,48061614
39748,135,1792000,1,13,21,1,749,48061749
39749,69,1791900,3,13,21,1,818,48061818
39750,202,1792100,1,13,21,2,20,48062020
39751,250,1792100,1,13,21,2,270,48062270
39752,99,1792100,1,13,21,2,369,48062369
39753,62,1792000,1,13,21,2,431,48062431
39754,118,1792000,2,13,21,2,549,48062549
39755,261,1792100,3,13,21,2,810,48062810
39756,1,1792100,4,13,21,2,811,48062811
39757,0,1792100,1,13,21,2,811,48062811
39758,233,1792100,4,13,21,3,44,48063044
39759,1,1792100,1,13,21,3,45,48063045
39760,14,1792000,1,13,21,3,59,48063059
39761,43,1792000,1,13,21,3,102,48063102
39762,288,1792200,1,13,21,3,390,48063390
39763,257,1792200,3,13,21,3,647,48063647
39764,1,1792200,1,13,21,3,648,48063648
39765,0,1792200,1,13,21,3,648,48063648
39766,0,1792200,1,13,21,3,648,48063648
39767,0,1792200,1,13,21,3,648,48063648
39768,319,1792200,2,13,21,3,967,48063967
39769,665,1792300,3,13,21,4,632,48064632
39770,1128,1792200,1,13,21,5,760,48065760
39771,466,1792200,1,13,21,6,226,48066226
39772,699,1792300,1,13,21,6,925,48066925
39773,15,1792300,1,13,21,6,940,48066940
39774,0,1792300,4,13,21,6,940,48066940
39775,16,1792400,4,13,21,6,956,48066956
39776,176,1792500,1,13,21,7,132,48067132
39777,61,1792500,2,13,21,7,193,48067193
39778,32,1792400,1,13,21,7,225,48067225
39779,0,1792400,1,13,21,7,225,48067225
39780,1,1792400,1,13,21,7,226,48067226
39781,0,1792300,1,13,21,7,226,48067226
39782,1,1792300,1,13,21,7,227,48067227
39783,474,1792400,1,13,21,7,701,48067701
39784,791,1792400,1,13,21,8,492,48068492
39785,49,1792500,7,13,21,8,541,48068541
39786,92,1792600,1,13,21,8,633,48068633
39787,918,1792500,1,13,21,9,551,48069551
39788,242,1792600,4,13,21,9,793,48069793
39789,1347,1792600,1,13,21,11,140,48071140
39790,322,1792600,1,13,21,11,462,48071462
39791,172,1792500,1,13,21,11,634,48071634
39792,278,1792500,3,13,21,11,912,48071912
39794,3,1792500,1,13,21,11,915,48071915
39795,63,1792400,1,13,21,11,978,48071978
39796,313,1792400,2,13,21,12,291,48072291
39797,1128,1792500,1,13,21,13,419,48073419
39798,265,1792600,1,13,21,13,684,48073684
39799,36,1792500,1,13,21,13,720,48073720
39800,297,1792600,1,13,21,14,17,48074017
39801,402,1792500,1,13,21,14,419,48074419
39802,1264,1792500,1,13,21,15,683,48075683
39803,364,1792400,2,13,21,16,47,48076047
39804,1243,1792300,1,13,21,17,290,48077290
39805,60,1792200,1,13,21,17,350,48077350
39806,0,1792200,1,13,21,17,350,48077350
39807,0,1792200,1,13,21,17,350,48077350
39808,1,1792200,1,13,21,17,351,48077351
39809,0,1792100,1,13,21,17,351,48077351
39810,1,1792100,1,13,21,17,352,48077352
39811,81,1792300,1,13,21,17,433,48077433
39812,1141,1792200,1,13,21,18,574,48078574
39813,683,1792200,2,13,21,19,257,48079257
39814,1254,1792100,1,13,21,20,511,48080511
39815,1831,1792300,1,13,21,22,342,48082342
39816,578,1792300,1,13,21,22,920,48082920
39817,1067,1792200,3,13,21,23,987,48083987
39818,706,1792100,2,13,21,24,693,48084693
39819,24,1792200,1,13,21,24,717,48084717
39820,1,1792200,1,13,21,24,718,48084718
39821,234,1792200,1,13,21,24,952,48084952
39822,1080,1792200,1,13,21,26,32,48086032
39823,1986,1792100,3,13,21,28,18,48088018
39824,82,1792100,1,13,21,28,100,48088100
39825,0,1792100,1,13,21,28,100,48088100
39826,0,1792100,1,13,21,28,100,48088100
39827,1,1792000,1,13,21,28,101,48088101
39828,0,1792000,1,13,21,28,101,48088101
39829,422,1792200,1,13,21,28,523,48088523
39830,152,1792300,1,13,21,28,675,48088675
39831,0,1792200,1,13,21,28,675,48088675
39832,618,1792200,2,13,21,29,293,48089293
39833,1550,1792100,1,13,21,30,843,48090843
39834,242,1792100,2,13,21,31,85,48091085
39835,386,1792000,1,13,21,31,471,48091471
39836,1,1792000,1,13,21,31,472,48091472
39837,0,1792000,1,13,21,31,472,48091472
39838,0,1792000,9,13,21,31,472,48091472
39839,0,1792000,1,13,21,31,472,48091472
39840,0,1792000,1,13,21,31,472,48091472
39841,0,1792000,1,13,21,31,472,48091472
39842,13,1792000,1,13,21,31,485,48091485
39843,199,1792000,3,13,21,31,684,48091684
39844,0,1791900,3,13,21,31,684,48091684
39845,369,1792000,1,13,21,32,53,48092053
39846,93,1791900,1,13,21,32,146,48092146
39847,51,1791900,1,13,21,32,197,48092197
39849,155,1791900,2,13,21,32,352,48092352
39851,106,1792000,3,13,21,32,458,48092458
39853,92,1792100,9,13,21,32,550,48092550
39854,99,1792100,2,13,21,32,649,48092649
39855,318,1792200,2,13,21,32,967,48092967
39856,920,1792200,1,13,21,33,887,48093887
39857,14,1792100,1,13,21,33,901,48093901
39858,302,1792200,1,13,21,34,203,48094203
39859,931,1792100,3,13,21,35,134,48095134
39860,706,1792100,2,13,21,35,840,48095840
39861,239,1792100,1,13,21,36,79,48096079
39862,657,1792100,1,13,21,36,736,48096736
39863,169,1792200,1,13,21,36,905,48096905
39864,173,1792100,1,13,21,37,78,48097078
39865,0,1792100,1,13,21,37,78,48097078
39866,22,1792100,1,13,21,37,100,48097100
39867,0,1792000,1,13,21,37,100,48097100
39868,64,1792100,1,13,21,37,164,48097164
39869,147,1792100,3,13,21,37,311,48097311
39870,3244,1792200,3,13,21,40,555,48100555
39871,1,1792200,1,13,21,40,556,48100556
39872,0,1792200,1,13,21,40,556,48100556
39873,192,1792300,1,13,21,40,748,48100748
39874,13,1792300,2,13,21,40,761,48100761
39875,75,1792300,3,13,21,40,836,48100836
39876,434,1792200,1,13,21,41,270,48101270
39878,118,1792300,1,13,21,41,388,48101388
39879,15,1792300,1,13,21,41,403,48101403
39880,386,1792200,1,13,21,41,789,48101789
39881,195,1792100,2,13,21,41,984,48101984
39882,677,1792100,2,13,21,42,661,48102661
39883,1737,1792100,1,13,21,44,398,48104398
39884,1291,1792300,1,13,21,45,689,48105689
39885,42,1792200,1,13,21,45,731,48105731
39886,72,1792200,1,13,21,45,803,48105803
39887,746,1792100,2,13,21,46,549,48106549
39889,176,1792200,1,13,21,46,725,48106725
39890,831,1792100,2,13,21,47,556,48107556
39891,44,1792100,1,13,21,47,600,48107600
39892,1,1792100,1,13,21,47,601,48107601
39893,1365,1792200,1,13,21,48,966,48108966
39894,1,1792200,1,13,21,48,967,48108967
39895,519,1792200,2,13,21,49,486,48109486
39897,499,1792300,1,13,21,49,985,48109985
39898,1300,1792200,1,13,21,51,285,48111285
39899,162,1792200,1,13,21,51,447,48111447
39900,46,1792100,1,13,21,51,493,48111493
39901,1341,1792100,1,13,21,52,834,48112834
39902,77,1792200,1,13,21,52,911,48112911
39903,715,1792200,1,13,21,53,626,48113626
39904,577,1792200,1,13,21,54,203,48114203
39905,304,1792100,1,13,21,54,507,48114507
39906,487,1792100,1,13,21,54,994,48114994
39907,296,1792100,6,13,21,55,290,48115290
39908,1480,1792200,1,13,21,56,770,48116770
39909,747,1792200,1,13,21,57,517,48117517
39910,984,1792200,1,13,21,58,501,48118501
39911,2012,1792200,1,13,22,0,513,48120513
39912,87,1792100,1,13,22,0,600,48120600
39913,0,1792100,2,13,22,0,600,48120600
39914,1,1792100,1,13,22,0,601,48120601
39915,0,1792100,1,13,22,0,601,48120601
39916,0,1792100,3,13,22,0,601,48120601
39917,0,1792100,1,13,22,0,601,48120601
39918,0,1792100,1,13,22,0,601,48120601
39919,1,1792100,1,13,22,0,602,48120602
39920,0,1792100,1,13,22,0,602,48120602
39921,1,1792100,1,13,22,0,603,48120603
39922,0,1792100,1,13,22,0,603,48120603
39923,37,1792200,1,13,22,0,640,48120640
39924,309,1792100,1,13,22,0,949,48120949
39925,698,1792200,1,13,22,1,647,48121647
39926,899,1792200,1,13,22,2,546,48122546
39927,445,1792200,1,13,22,2,991,48122991
39928,1054,1792200,1,13,22,4,45,48124045
39929,89,1792300,1,13,22,4,134,48124134
39930,86,1792300,1,13,22,4,220,48124220
39931,31,1792300,2,13,22,4,251,48124251
39932,85,1792300,5,13,22,4,336,48124336
39933,372,1792300,1,13,22,4,708,48124708
39934,408,1792300,1,13,22,5,116,48125116
39935,128,1792400,3,13,22,5,244,48125244
39936,1,1792400,1,13,22,5,245,48125245
39937,0,1792400,1,13,22,5,245,48125245
39938,0,1792400,1,13,22,5,245,48125245
39939,0,1792400,1,13,22,5,245,48125245
39940,0,1792400,1,13,22,5,245,48125245
39941,0,1792400,1,13,22,5,245,48125245
39942,129,1792400,1,13,22,5,374,48125374
39943,472,1792400,1,13,22,5,846,48125846
39944,422,1792400,1,13,22,6,268,48126268
39945,310,1792400,1,13,22,6,578,48126578
39946,1492,1792400,1,13,22,8,70,48128070
39947,31,1792300,1,13,22,8,101,48128101
39948,0,1792300,1,13,22,8,101,48128101
39949,0,1792300,1,13,22,8,101,48128101
39950,669,1792400,1,13,22,8,770,48128770
39951,251,1792400,1,13,22,9,21,48129021
39952,1033,1792400,1,13,22,10,54,48130054
39953,138,1792300,1,13,22,10,192,48130192
39954,559,1792400,1,13,22,10,751,48130751
39955,912,1792400,1,13,22,11,663,48131663
39956,2,1792400,9,13,22,11,665,48131665
39957,115,1792500,3,13,22,11,780,48131780
39958,80,1792500,1,13,22,11,860,48131860
39959,72,1792500,3,13,22,11,932,48131932
39960,39,1792500,1,13,22,11,971,48131971
39961,29,1792500,1,13,22,12,0,48132000
39962,19,1792500,1,13,22,12,19,48132019
39963,149,1792500,2,13,22,12,168,48132168
39964,51,1792500,1,13,22,12,219,48132219
39965,469,1792500,1,13,22,12,688,48132688
39966,3,1792500,1,13,22,12,691,48132691
39967,0,1792500,1,13,22,12,691,48132691
39968,0,1792500,2,13,22,12,691,48132691
39969,0,1792500,1,13,22,12,691,48132691
39970,0,1792500,2,13,22,12,691,48132691
39971,385,1792600,2,13,22,13,76,48133076
39972,419,1792600,1,13,22,13,495,48133495
39973,12,1792600,1,13,22,13,507,48133507
39974,3,1792600,5,13,22,13,510,48133510
39975,0,1792600,10,13,22,13,510,48133510
39976,251,1792700,3,13,22,13,761,48133761
39977,206,1792700,1,13,22,13,967,48133967
39978,21,1792700,1,13,22,13,988,48133988
39979,24,1792700,2,13,22,14,12,48134012
39980,45,1792600,4,13,22,14,57,48134057
39981,1,1792600,1,13,22,14,58,48134058
39982,394,1792700,1,13,22,14,452,48134452
39983,345,1792700,1,13,22,14,797,48134797
39984,484,1792700,1,13,22,15,281,48135281
39985,152,1792700,5,13,22,15,433,48135433
39986,45,1792700,1,13,22,15,478,48135478
39987,24,1792700,1,13,22,15,502,48135502
39988,60,1792700,4,13,22,15,562,48135562
39989,69,1792700,1,13,22,15,631,48135631
39990,69,1792800,1,13,22,15,700,48135700
39991,282,1792700,2,13,22,15,982,48135982
39993,233,1792700,1,13,22,16,215,48136215
39994,1687,1792600,1,13,22,17,902,48137902
39995,1,1792600,1,13,22,17,903,48137903
39996,1,1792600,1,13,22,17,904,48137904
39997,8,1792700,3,13,22,17,912,48137912
39998,11,1792700,3,13,22,17,923,48137923
39999,33,1792700,1,13,22,17,956,48137956
40000,20,1792500,1,13,22,17,976,48137976
40001,0,1792500,1,13,22,17,976,48137976
40002,173,1792600,2,13,22,18,149,48138149
40003,269,1792500,3,13,22,18,418,48138418
40004,840,1792500,1,13,22,19,258,48139258
40005,929,1792400,1,13,22,20,187,48140187
40006,372,1792400,3,13,22,20,559,48140559
40007,0,1792400,1,13,22,20,559,48140559
40008,54,1792400,1,13,22,20,613,48140613
40009,687,1792400,1,13,22,21,300,48141300
40010,0,1792400,1,13,22,21,300,48141300
40011,316,1792500,1,13,22,21,616,48141616
40012,0,1792400,2,13,22,21,616,48141616
40013,1030,1792400,1,13,22,22,646,48142646
40014,440,1792400,2,13,22,23,86,48143086
40016,560,1792500,2,13,22,23,646,48143646
40017,638,1792400,3,13,22,24,284,48144284
40018,429,1792400,1,13,22,24,713,48144713
40019,51,1792400,1,13,22,24,764,48144764
40020,308,1792500,3,13,22,25,72,48145072
40021,98,1792500,2,13,22,25,170,48145170
40022,1237,1792500,1,13,22,26,407,48146407
40023,1,1792500,1,13,22,26,408,48146408
40024,188,1792500,1,13,22,26,596,48146596
40025,896,1792600,1,13,22,27,492,48147492
40026,108,1792400,1,13,22,27,600,48147600
40027,219,1792600,2,13,22,27,819,48147819
40028,1174,1792500,1,13,22,28,993,48148993
40029,430,1792400,1,13,22,29,423,48149423
40030,934,1792400,1,13,22,30,357,48150357
40031,698,1792500,1,13,22,31,55,48151055
40032,269,1792400,1,13,22,31,324,48151324
40033,12,1792500,1,13,22,31,336,48151336
40034,1636,1792400,1,13,22,32,972,48152972
40035,234,1792400,1,13,22,33,206,48153206
40036,1028,1792500,1,13,22,34,234,48154234
40037,466,1792600,1,13,22,34,700,48154700
40038,232,1792600,1,13,22,34,932,48154932
40039,33,1792600,2,13,22,34,965,48154965
40040,0,1792600,1,13,22,34,965,48154965
40041,59,1792600,1,13,22,35,24,48155024
40042,107,1792700,1,13,22,35,131,48155131
40043,60,1792700,1,13,22,35,191,48155191
40044,20,1792700,3,13,22,35,211,48155211
40045,65,1792700,1,13,22,35,276,48155276
40046,15,1792700,1,13,22,35,291,48155291
40047,722,1792600,1,13,22,36,13,48156013
40048,761,1792600,1,13,22,36,774,48156774
40049,66,1792500,1,13,22,36,840,48156840
40050,539,1792600,1,13,22,37,379,48157379
40051,96,1792600,1,13,22,37,475,48157475
40052,172,1792600,1,13,22,37,647,48157647
40053,16,1792600,1,13,22,37,663,48157663
40054,37,1792600,2,13,22,37,700,48157700
40055,0,1792600,3,13,22,37,700,48157700
40056,1776,1792600,1,13,22,39,476,48159476
40057,11,1792600,1,13,22,39,487,48159487
40058,643,1792400,2,13,22,40,130,48160130
40059,186,1792500,1,13,22,40,316,48160316
40060,765,1792500,1,13,22,41,81,48161081
40061,2032,1792500,1,13,22,43,113,48163113
40062,1580,1792500,1,13,22,44,693,48164693
40063,1164,1792600,1,13,22,45,857,48165857
40064,1783,1792600,1,13,22,47,640,48167640
40065,175,1792600,1,13,22,47,815,48167815
40066,902,1792600,1,13,22,48,717,48168717
40067,1,1792500,1,13,22,48,718,48168718
40068,626,1792600,1,13,22,49,344,48169344
40069,1391,1792600,1,13,22,50,735,48170735
40070,1377,1792500,2,13,22,52,112,48172112
40072,2274,1792600,1,13,22,54,386,48174386
40073,42,1792500,1,13,22,54,428,48174428
40074,0,1792500,1,13,22,54,428,48174428
40075,1,1792500,1,13,22,54,429,48174429
40076,89,1792500,1,13,22,54,518,48174518
40077,771,1792600,1,13,22,55,289,48175289
40078,1688,1792500,2,13,22,56,977,48176977
40079,118,1792500,1,13,22,57,95,48177095
40080,657,1792600,1,13,22,57,752,48177752
40081,268,1792600,1,13,22,58,20,48178020
40082,392,1792600,1,13,22,58,412,48178412
40083,252,1792600,2,13,22,58,664,48178664
40084,92,1792600,1,13,22,58,756,48178756
40085,42,1792700,1,13,22,58,798,48178798
40086,92,1792700,1,13,22,58,890,48178890
40087,69,1792700,3,13,22,58,959,48178959
40088,454,1792600,1,13,22,59,413,48179413
40089,157,1792700,3,13,22,59,570,48179570
40090,168,1792700,2,13,22,59,738,48179738
40091,333,1792600,1,13,23,0,71,48180071
40092,497,1792600,1,13,23,0,568,48180568
40093,1167,1792500,5,13,23,1,735,48181735
40094,1237,1792600,2,13,23,2,972,48182972
40095,850,1792600,1,13,23,3,822,48183822
40096,0,1792600,2,13,23,3,822,48183822
40097,170,1792700,1,13,23,3,992,48183992
40098,0,1792700,3,13,23,3,992,48183992
40099,0,1792700,1,13,23,3,992,48183992
40100,0,1792700,3,13,23,3,992,48183992
40101,1,1792700,4,13,23,3,993,48183993
40102,336,1792700,1,13,23,4,329,48184329
40103,11,1792700,1,13,23,4,340,48184340
40104,566,1792700,1,13,23,4,906,48184906
40105,150,1792800,1,13,23,5,56,48185056
40106,308,1792700,3,13,23,5,364,48185364
40107,58,1792800,3,13,23,5,422,48185422
40108,146,1792700,1,13,23,5,568,48185568
40109,334,1792600,1,13,23,5,902,48185902
40110,0,1792600,2,13,23,5,902,48185902
40111,130,1792700,1,13,23,6,32,48186032
40112,227,1792600,1,13,23,6,259,48186259
40113,793,1792700,1,13,23,7,52,48187052
40114,18,1792700,2,13,23,7,70,48187070
40115,547,1792700,5,13,23,7,617,48187617
40116,218,1792700,1,13,23,7,835,48187835
40117,1221,1792700,3,13,23,9,56,48189056
40118,0,1792700,2,13,23,9,56,48189056
40119,774,1792700,1,13,23,9,830,48189830
40120,39,1792700,1,13,23,9,869,48189869
40121,1786,1792700,1,13,23,11,655,48191655
40122,194,1792600,1,13,23,11,849,48191849
40123,741,1792700,2,13,23,12,590,48192590
40124,1381,1792800,1,13,23,13,971,48193971
40125,274,1792700,1,13,23,14,245,48194245
40126,1145,1792700,1,13,23,15,390,48195390
40127,37,1792600,1,13,23,15,427,48195427
40128,254,1792700,1,13,23,15,681,48195681
40129,968,1792700,1,13,23,16,649,48196649
40130,414,1792800,5,13,23,17,63,48197063
40131,2,1792800,2,13,23,17,65,48197065
40132,49,1792800,1,13,23,17,114,48197114
40133,26,1792800,1,13,23,17,140,48197140
40134,276,1792900,4,13,23,17,416,48197416
40135,19,1792900,1,13,23,17,435,48197435
40136,229,1792800,1,13,23,17,664,48197664
40137,129,1792700,3,13,23,17,793,48197793
40138,149,1792700,1,13,23,17,942,48197942
40139,383,1792900,1,13,23,18,325,48198325
40140,404,1792900,1,13,23,18,729,48198729
40141,615,1792800,1,13,23,19,344,48199344
40142,346,1792800,1,13,23,19,690,48199690
40143,233,1792800,3,13,23,19,923,48199923
40144,111,1792900,1,13,23,20,34,48200034
40145,87,1792900,5,13,23,20,121,48200121
40146,213,1792800,1,13,23,20,334,48200334
40147,117,1792900,1,13,23,20,451,48200451
40148,258,1792700,1,13,23,20,709,48200709
40149,82,1792800,1,13,23,20,791,48200791
40150,1265,1792900,4,13,23,22,56,48202056
40151,7,1792900,3,13,23,22,63,48202063
40152,1025,1793000,2,13,23,23,88,48203088
40153,581,1793000,19,13,23,23,669,48203669
40154,1,1793100,1,13,23,23,670,48203670
40155,59,1793100,4,13,23,23,729,48203729
40156,226,1793000,1,13,23,23,955,48203955
40157,135,1793100,4,13,23,24,90,48204090
40158,103,1793100,1,13,23,24,193,48204193
40159,79,1793100,1,13,23,24,272,48204272
40160,950,1793200,2,13,23,25,222,48205222
40161,1,1793200,1,13,23,25,223,48205223
40162,123,1793200,1,13,23,25,346,48205346
40163,73,1793200,1,13,23,25,419,48205419
40164,429,1793200,2,13,23,25,848,48205848
40165,78,1793200,11,13,23,25,926,48205926
40166,88,1793300,1,13,23,26,14,48206014
40167,83,1793300,1,13,23,26,97,48206097
40168,210,1793300,3,13,23,26,307,48206307
40169,109,1793400,1,13,23,26,416,48206416
40170,151,1793200,1,13,23,26,567,48206567
40171,57,1793200,2,13,23,26,624,48206624
40172,16,1793200,1,13,23,26,640,48206640
40173,197,1793200,1,13,23,26,837,48206837
40174,17,1793200,2,13,23,26,854,48206854
40175,8,1793200,1,13,23,26,862,48206862
40176,321,1793200,1,13,23,27,183,48207183
40177,222,1793100,1,13,23,27,405,48207405
40178,574,1793000,1,13,23,27,979,48207979
40179,9,1793100,4,13,23,27,988,48207988
40180,218,1793100,1,13,23,28,206,48208206
40181,34,1793200,2,13,23,28,240,48208240
40182,191,1793100,1,13,23,28,431,48208431
40183,362,1793100,1,13,23,28,793,48208793
40184,29,1793100,1,13,23,28,822,48208822
40185,275,1793100,1,13,23,29,97,48209097
40186,233,1793200,1,13,23,29,330,48209330
40187,93,1793100,1,13,23,29,423,48209423
40188,97,1793100,1,13,23,29,520,48209520
40189,139,1793100,3,13,23,29,659,48209659
40190,578,1793000,1,13,23,30,237,48210237
40191,73,1793100,1,13,23,30,310,48210310
40192,117,1793200,1,13,23,30,427,48210427
40193,35,1793000,1,13,23,30,462,48210462
40194,275,1793100,1,13,23,30,737,48210737
40195,283,1793100,2,13,23,31,20,48211020
40196,129,1793100,1,13,23,31,149,48211149
40197,46,1793100,1,13,23,31,195,48211195
40198,162,1793000,1,13,23,31,357,48211357
40199,188,1793200,4,13,23,31,545,48211545
40200,195,1793100,1,13,23,31,740,48211740
40201,163,1793100,1,13,23,31,903,48211903
40202,245,1793100,1,13,23,32,148,48212148
40203,168,1793200,1,13,23,32,316,48212316
40204,64,1793100,2,13,23,32,380,48212380
40205,96,1793100,1,13,23,32,476,48212476
40207,156,1793200,1,13,23,32,632,48212632
40208,60,1793000,1,13,23,32,692,48212692
40209,217,1793200,1,13,23,32,909,48212909
40210,95,1793200,7,13,23,33,4,48213004
40212,64,1793100,1,13,23,33,68,48213068
40213,132,1793200,1,13,23,33,200,48213200
40214,35,1793200,2,13,23,33,235,48213235
40215,257,1793100,1,13,23,33,492,48213492
40216,232,1793300,3,13,23,33,724,48213724
40217,498,1793100,1,13,23,34,222,48214222
40218,188,1793100,1,13,23,34,410,48214410
40219,30,1793100,1,13,23,34,440,48214440
40220,752,1793100,1,13,23,35,192,48215192
40221,317,1793100,1,13,23,35,509,48215509
40222,275,1793100,1,13,23,35,784,48215784
40223,291,1793200,1,13,23,36,75,48216075
40224,1094,1793300,1,13,23,37,169,48217169
40225,125,1793200,1,13,23,37,294,48217294
40226,34,1793200,1,13,23,37,328,48217328
40227,917,1793300,1,13,23,38,245,48218245
40228,720,1793300,1,13,23,38,965,48218965
40229,38,1793300,1,13,23,39,3,48219003
40230,0,1793300,1,13,23,39,3,48219003
40232,148,1793500,1,13,23,39,151,48219151
40233,134,1793500,1,13,23,39,285,48219285
40234,4,1793500,2,13,23,39,289,48219289
40235,4,1793500,5,13,23,39,293,48219293
40236,5,1793600,3,13,23,39,298,48219298
40237,549,1793400,1,13,23,39,847,48219847
40238,217,1793400,1,13,23,40,64,48220064
40239,204,1793400,1,13,23,40,268,48220268
40240,89,1793600,1,13,23,40,357,48220357
40241,300,1793600,2,13,23,40,657,48220657
40242,111,1793600,1,13,23,40,768,48220768
40243,114,1793600,2,13,23,40,882,48220882
40244,0,1793600,1,13,23,40,882,48220882
40245,0,1793600,7,13,23,40,882,48220882
40246,10,1793700,10,13,23,40,892,48220892
40247,1,1793700,11,13,23,40,893,48220893
40248,0,1793700,2,13,23,40,893,48220893
40249,99,1793700,2,13,23,40,992,48220992
40250,50,1793700,2,13,23,41,42,48221042
40251,27,1793800,7,13,23,41,69,48221069
40252,11,1793800,1,13,23,41,80,48221080
40253,69,1793800,1,13,23,41,149,48221149
40254,13,1793800,1,13,23,41,162,48221162
40255,235,1793600,1,13,23,41,397,48221397
40256,79,1793700,1,13,23,41,476,48221476
40257,44,1793400,1,13,23,41,520,48221520
40258,64,1793600,1,13,23,41,584,48221584
40259,391,1793700,3,13,23,41,975,48221975
40260,296,1793600,1,13,23,42,271,48222271
40261,293,1793700,1,13,23,42,564,48222564
40262,90,1793600,1,13,23,42,654,48222654
40263,145,1793600,1,13,23,42,799,48222799
40264,1408,1793700,1,13,23,44,207,48224207
40265,240,1793600,1,13,23,44,447,48224447
40266,0,1793600,1,13,23,44,447,48224447
40267,1,1793600,2,13,23,44,448,48224448
40268,644,1793600,1,13,23,45,92,48225092
40269,91,1793600,1,13,23,45,183,48225183
40270,500,1793500,1,13,23,45,683,48225683
40271,547,1793400,1,13,23,46,230,48226230
40272,407,1793400,1,13,23,46,637,48226637
40273,186,1793500,1,13,23,46,823,48226823
40274,96,1793500,1,13,23,46,919,48226919
40276,192,1793400,1,13,23,47,111,48227111
40277,592,1793500,1,13,23,47,703,48227703
40278,176,1793500,1,13,23,47,879,48227879
40279,569,1793500,4,13,23,48,448,48228448
40281,131,1793500,1,13,23,48,579,48228579
40282,324,1793500,1,13,23,48,903,48228903
40283,88,1793600,2,13,23,48,991,48228991
40284,52,1793600,2,13,23,49,43,48229043
40285,171,1793600,2,13,23,49,214,48229214
40286,205,1793500,1,13,23,49,419,48229419
40287,229,1793700,1,13,23,49,648,48229648
40288,1513,1793600,1,13,23,51,161,48231161
40289,650,1793600,1,13,23,51,811,48231811
40290,1,1793600,2,13,23,51,812,48231812
40291,558,1793700,1,13,23,52,370,48232370
40292,0,1793700,3,13,23,52,370,48232370
40293,1,1793700,1,13,23,52,371,48232371
40294,0,1793700,2,13,23,52,371,48232371
40295,44,1793800,1,13,23,52,415,48232415
40296,155,1793800,2,13,23,52,570,48232570
40297,0,1793800,4,13,23,52,570,48232570
40298,0,1793800,4,13,23,52,570,48232570
40299,212,1793900,5,13,23,52,782,48232782
40300,0,1793900,1,13,23,52,782,48232782
40301,0,1793900,7,13,23,52,782,48232782
40302,101,1794000,1,13,23,52,883,48232883
40303,1,1794000,6,13,23,52,884,48232884
40304,90,1794100,6,13,23,52,974,48232974
40306,1,1794100,1,13,23,52,975,48232975
40307,38,1794200,1,13,23,53,13,48233013
40308,132,1794200,1,13,23,53,145,48233145
40309,7,1794200,2,13,23,53,152,48233152
40310,100,1794200,2,13,23,53,252,48233252
40311,1,1794200,7,13,23,53,253,48233253
40312,49,1794100,1,13,23,53,302,48233302
40313,37,1794300,1,13,23,53,339,48233339
40314,91,1794200,4,13,23,53,430,48233430
40315,0,1794200,4,13,23,53,430,48233430
40316,0,1794200,4,13,23,53,430,48233430
40318,164,1794100,2,13,23,53,594,48233594
40319,18,1794000,1,13,23,53,612,48233612
40321,147,1794000,1,13,23,53,759,48233759
40322,133,1794000,1,13,23,53,892,48233892
40323,20,1794100,2,13,23,53,912,48233912
40324,592,1794000,3,13,23,54,504,48234504
40325,376,1793800,2,13,23,54,880,48234880
40326,17,1793900,1,13,23,54,897,48234897
40327,321,1793900,1,13,23,55,218,48235218
40328,309,1793900,1,13,23,55,527,48235527
40329,380,1793900,1,13,23,55,907,48235907
40330,42,1794000,1,13,23,55,949,48235949
40331,434,1793900,1,13,23,56,383,48236383
40332,95,1794000,1,13,23,56,478,48236478
40333,1,1794000,7,13,23,56,479,48236479
40334,177,1794100,2,13,23,56,656,48236656
40335,5,1794200,1,13,23,56,661,48236661
40337,901,1794100,1,13,23,57,562,48237562
40338,110,1794200,2,13,23,57,672,48237672
40339,419,1794200,1,13,23,58,91,48238091
40340,136,1794200,1,13,23,58,227,48238227
40341,11,1794100,1,13,23,58,238,48238238
40342,432,1794100,1,13,23,58,670,48238670
40343,18,1794200,1,13,23,58,688,48238688
40344,69,1794200,2,13,23,58,757,48238757
40345,1307,1794300,7,13,24,0,64,48240064
40346,0,1794300,1,13,24,0,64,48240064
40347,1,1794300,5,13,24,0,65,48240065
40348,487,1794400,1,13,24,0,552,48240552
40349,82,1794400,1,13,24,0,634,48240634
40350,235,1794400,1,13,24,0,869,48240869
40351,255,1794300,1,13,24,1,124,48241124
40352,139,1794300,1,13,24,1,263,48241263
40353,365,1794100,1,13,24,1,628,48241628
40354,0,1794200,1,13,24,1,628,48241628
40355,289,1794100,4,13,24,1,917,48241917
40356,1,1794100,4,13,24,1,918,48241918
40357,0,1794100,4,13,24,1,918,48241918
40358,106,1794100,1,13,24,2,24,48242024
40359,143,1794100,1,13,24,2,167,48242167
40360,7,1794200,1,13,24,2,174,48242174
40361,31,1794200,2,13,24,2,205,48242205
40362,248,1794200,1,13,24,2,453,48242453
40363,0,1794200,1,13,24,2,453,48242453
40364,160,1794300,1,13,24,2,613,48242613
40365,169,1794300,3,13,24,2,782,48242782
40366,0,1794300,2,13,24,2,782,48242782
40367,579,1794300,3,13,24,3,361,48243361
40369,50,1794400,1,13,24,3,411,48243411
40370,656,1794400,2,13,24,4,67,48244067
40371,80,1794400,3,13,24,4,147,48244147
40372,283,1794400,3,13,24,4,430,48244430
40373,227,1794400,1,13,24,4,657,48244657
40374,114,1794400,1,13,24,4,771,48244771
40375,378,1794400,1,13,24,5,149,48245149
40376,35,1794300,5,13,24,5,184,48245184
40377,98,1794300,3,13,24,5,282,48245282
40378,329,1794400,1,13,24,5,611,48245611
40379,656,1794400,1,13,24,6,267,48246267
40380,20,1794400,1,13,24,6,287,48246287
40381,88,1794400,1,13,24,6,375,48246375
40382,133,1794300,1,13,24,6,508,48246508
40383,205,1794400,1,13,24,6,713,48246713
40384,260,1794400,1,13,24,6,973,48246973
40385,149,1794300,5,13,24,7,122,48247122
40386,350,1794300,2,13,24,7,472,48247472
40387,188,1794300,2,13,24,7,660,48247660
40389,53,1794400,1,13,24,7,713,48247713
40390,10,1794300,1,13,24,7,723,48247723
40391,97,1794400,4,13,24,7,820,48247820
40393,68,1794400,1,13,24,7,888,48247888
40394,16,1794300,1,13,24,7,904,48247904
40395,18,1794400,1,13,24,7,922,48247922
40396,44,1794300,1,13,24,7,966,48247966
40397,3,1794200,1,13,24,7,969,48247969
40398,1218,1794400,3,13,24,9,187,48249187
40400,507,1794400,1,13,24,9,694,48249694
40401,402,1794400,1,13,24,10,96,48250096
40402,76,1794400,1,13,24,10,172,48250172
40403,691,1794300,1,13,24,10,863,48250863
40404,176,1794300,2,13,24,11,39,48251039
40405,711,1794400,1,13,24,11,750,48251750
40406,352,1794400,1,13,24,12,102,48252102
40407,1025,1794400,1,13,24,13,127,48253127
40408,469,1794400,1,13,24,13,596,48253596
40409,322,1794500,2,13,24,13,918,48253918
40410,983,1794500,1,13,24,14,901,48254901
40411,315,1794500,5,13,24,15,216,48255216
40412,334,1794600,11,13,24,15,550,48255550
40413,403,1794600,1,13,24,15,953,48255953
40414,134,1794600,1,13,24,16,87,48256087
40415,84,1794600,1,13,24,16,171,48256171
40416,277,1794700,1,13,24,16,448,48256448
40417,3,1794600,2,13,24,16,451,48256451
40418,54,1794700,1,13,24,16,505,48256505
40419,20,1794700,1,13,24,16,525,48256525
40420,14,1794700,1,13,24,16,539,48256539
40421,115,1794700,1,13,24,16,654,48256654
40422,418,1794700,1,13,24,17,72,48257072
40423,78,1794700,2,13,24,17,150,48257150
40424,314,1794700,1,13,24,17,464,48257464
40425,1,1794700,1,13,24,17,465,48257465
40426,762,1794700,1,13,24,18,227,48258227
40427,0,1794600,2,13,24,18,227,48258227
40428,94,1794700,6,13,24,18,321,48258321
40430,188,1794800,1,13,24,18,509,48258509
40431,219,1794600,1,13,24,18,728,48258728
40432,71,1794800,1,13,24,18,799,48258799
40433,55,1794700,1,13,24,18,854,48258854
40434,354,1794800,1,13,24,19,208,48259208
40435,133,1794700,1,13,24,19,341,48259341
40436,2,1794800,1,13,24,19,343,48259343
40437,290,1794700,1,13,24,19,633,48259633
40438,82,1794800,1,13,24,19,715,48259715
40439,155,1794800,1,13,24,19,870,48259870
40440,523,1794700,4,13,24,20,393,48260393
40441,67,1794700,1,13,24,20,460,48260460
40442,321,1794700,2,13,24,20,781,48260781
40443,382,1794600,4,13,24,21,163,48261163
40444,0,1794600,2,13,24,21,163,48261163
40445,129,1794600,1,13,24,21,292,48261292
40446,119,1794600,1,13,24,21,411,48261411
40447,766,1794600,1,13,24,22,177,48262177
40448,31,1794700,1,13,24,22,208,48262208
40449,106,1794700,1,13,24,22,314,48262314
40450,1529,1794600,3,13,24,23,843,48263843
40451,4,1794500,2,13,24,23,847,48263847
40452,330,1794500,3,13,24,24,177,48264177
40453,39,1794500,2,13,24,24,216,48264216
40454,67,1794400,2,13,24,24,283,48264283
40455,1,1794400,1,13,24,24,284,48264284
40456,441,1794500,1,13,24,24,725,48264725
40457,331,1794400,1,13,24,25,56,48265056
40458,233,1794300,2,13,24,25,289,48265289
40460,903,1794400,1,13,24,26,192,48266192
40461,198,1794300,3,13,24,26,390,48266390
40462,409,1794400,1,13,24,26,799,48266799
40463,2618,1794300,3,13,24,29,417,48269417
40464,0,1794300,2,13,24,29,417,48269417
40465,1,1794400,1,13,24,29,418,48269418
40466,132,1794400,3,13,24,29,550,48269550
40467,289,1794300,1,13,24,29,839,48269839
40468,699,1794300,1,13,24,30,538,48270538
40469,655,1794400,2,13,24,31,193,48271193
40470,91,1794400,2,13,24,31,284,48271284
40471,25,1794500,3,13,24,31,309,48271309
40472,156,1794400,1,13,24,31,465,48271465
40473,35,1794400,1,13,24,31,500,48271500
40474,3,1794400,1,13,24,31,503,48271503
40475,281,1794500,1,13,24,31,784,48271784
40476,57,1794500,2,13,24,31,841,48271841
40477,64,1794500,1,13,24,31,905,48271905
40478,55,1794500,1,13,24,31,960,48271960
40479,20,1794500,1,13,24,31,980,48271980
40480,383,1794400,1,13,24,32,363,48272363
40481,281,1794500,2,13,24,32,644,48272644
40482,273,1794300,1,13,24,32,917,48272917
40483,107,1794500,1,13,24,33,24,48273024
40484,1059,1794500,1,13,24,34,83,48274083
40485,101,1794500,2,13,24,34,184,48274184
40486,77,1794600,1,13,24,34,261,48274261
40487,1103,1794500,1,13,24,35,364,48275364
40488,33,1794500,1,13,24,35,397,48275397
40489,194,1794500,1,13,24,35,591,48275591
40490,155,1794500,1,13,24,35,746,48275746
40491,195,1794500,1,13,24,35,941,48275941
40492,374,1794500,1,13,24,36,315,48276315
40493,1275,1794500,1,13,24,37,590,48277590
40494,129,1794500,1,13,24,37,719,48277719
40495,293,1794500,1,13,24,38,12,48278012
40497,76,1794400,2,13,24,38,88,48278088
40498,1,1794400,2,13,24,38,89,48278089
40499,0,1794300,2,13,24,38,89,48278089
40500,1,1794300,1,13,24,38,90,48278090
40501,93,1794500,1,13,24,38,183,48278183
40502,999,1794300,1,13,24,39,182,48279182
40503,0,1794300,4,13,24,39,182,48279182
40504,1,1794300,1,13,24,39,183,48279183
40505,71,1794300,1,13,24,39,254,48279254
40506,489,1794400,1,13,24,39,743,48279743
40507,1360,1794300,1,13,24,41,103,48281103
40508,605,1794300,1,13,24,41,708,48281708
40509,25,1794300,2,13,24,41,733,48281733
40510,2,1794300,4,13,24,41,735,48281735
40511,67,1794300,1,13,24,41,802,48281802
40512,563,1794200,2,13,24,42,365,48282365
40513,0,1794200,4,13,24,42,365,48282365
40514,41,1794200,1,13,24,42,406,48282406
40515,554,1794200,1,13,24,42,960,48282960
40516,554,1794100,4,13,24,43,514,48283514
40517,1,1794100,1,13,24,43,515,48283515
40518,0,1794100,1,13,24,43,515,48283515
40519,165,1794000,4,13,24,43,680,48283680
40520,1,1794100,3,13,24,43,681,48283681
40521,3,1794000,4,13,24,43,684,48283684
40522,178,1793900,1,13,24,43,862,48283862
40523,15,1793900,1,13,24,43,877,48283877
40524,3,1794100,1,13,24,43,880,48283880
40525,954,1793900,2,13,24,44,834,48284834
40526,163,1793900,1,13,24,44,997,48284997
40527,792,1793900,1,13,24,45,789,48285789
40528,597,1793800,1,13,24,46,386,48286386
40529,64,1794000,1,13,24,46,450,48286450
40530,167,1793900,1,13,24,46,617,48286617
40531,810,1793900,1,13,24,47,427,48287427
40532,860,1793900,3,13,24,48,287,48288287
40533,443,1793900,3,13,24,48,730,48288730
40534,97,1793800,1,13,24,48,827,48288827
40535,864,1793800,1,13,24,49,691,48289691
40536,146,1793900,1,13,24,49,837,48289837
40537,394,1793800,1,13,24,50,231,48290231
40538,391,1793800,1,13,24,50,622,48290622
40539,197,1793800,9,13,24,50,819,48290819
40540,223,1793700,8,13,24,51,42,48291042
40541,1,1793700,1,13,24,51,43,48291043
40542,676,1793700,1,13,24,51,719,48291719
40543,223,1793800,1,13,24,51,942,48291942
40544,30,1793800,1,13,24,51,972,48291972
40545,163,1793700,1,13,24,52,135,48292135
40546,284,1793800,1,13,24,52,419,48292419
40547,0,1793800,1,13,24,52,419,48292419
40548,0,1793800,1,13,24,52,419,48292419
40549,0,1793800,12,13,24,52,419,48292419
40550,0,1793800,1,13,24,52,419,48292419
40551,0,1793800,1,13,24,52,419,48292419
40552,191,1793900,1,13,24,52,610,48292610
40553,2421,1793900,11,13,24,55,31,48295031
40554,0,1793900,1,13,24,55,31,48295031
40555,0,1793900,1,13,24,55,31,48295031
40556,867,1793900,1,13,24,55,898,48295898
40558,294,1794000,1,13,24,56,192,48296192
40559,0,1794000,1,13,24,56,192,48296192
40560,0,1794000,2,13,24,56,192,48296192
40561,0,1794000,8,13,24,56,192,48296192
40562,1763,1794000,1,13,24,57,955,48297955
40563,1434,1793800,3,13,24,59,389,48299389
40564,0,1793800,1,13,24,59,389,48299389
40565,0,1793800,1,13,24,59,389,48299389
40566,176,1793800,1,13,24,59,565,48299565
40567,476,1793700,1,13,25,0,41,48300041
40568,273,1793800,1,13,25,0,314,48300314
40569,155,1793900,1,13,25,0,469,48300469
40571,1,1793800,1,13,25,0,470,48300470
40572,71,1794000,1,13,25,0,541,48300541
40573,80,1793800,1,13,25,0,621,48300621
40574,52,1793900,1,13,25,0,673,48300673
40575,165,1794000,2,13,25,0,838,48300838
40576,552,1794000,1,13,25,1,390,48301390
40577,331,1793900,1,13,25,1,721,48301721
40578,162,1793800,1,13,25,1,883,48301883
40579,274,1793800,1,13,25,2,157,48302157
40580,14,1793800,1,13,25,2,171,48302171
40581,11,1793800,3,13,25,2,182,48302182
40583,33,1793800,1,13,25,2,215,48302215
40584,39,1793900,1,13,25,2,254,48302254
40585,318,1793700,1,13,25,2,572,48302572
40586,255,1793800,1,13,25,2,827,48302827
40587,874,1793900,1,13,25,3,701,48303701
40588,202,1793800,1,13,25,3,903,48303903
40589,1301,1793900,2,13,25,5,204,48305204
40590,544,1793800,1,13,25,5,748,48305748
40591,101,1793900,2,13,25,5,849,48305849
40592,470,1793900,1,13,25,6,319,48306319
40593,1329,1794000,1,13,25,7,648,48307648
40594,0,1794000,13,13,25,7,648,48307648
40595,171,1794000,1,13,25,7,819,48307819
40596,1097,1794200,2,13,25,8,916,48308916
40597,189,1794200,2,13,25,9,105,48309105
40598,29,1794200,1,13,25,9,134,48309134
40599,6,1794300,1,13,25,9,140,48309140
40600,0,1794300,1,13,25,9,140,48309140
40601,367,1794200,1,13,25,9,507,48309507
40602,182,1794200,1,13,25,9,689,48309689
40603,503,1794100,1,13,25,10,192,48310192
40604,11,1794100,1,13,25,10,203,48310203
40605,1,1794100,3,13,25,10,204,48310204
40606,74,1794200,2,13,25,10,278,48310278
40607,306,1794000,2,13,25,10,584,48310584
40608,69,1794000,1,13,25,10,653,48310653
40609,355,1794000,2,13,25,11,8,48311008
40610,120,1793900,1,13,25,11,128,48311128
40611,2,1793900,1,13,25,11,130,48311130
40612,16,1793900,1,13,25,11,146,48311146
40613,0,1793900,2,13,25,11,146,48311146
40614,0,1793900,1,13,25,11,146,48311146
40615,137,1793900,1,13,25,11,283,48311283
40616,504,1793800,2,13,25,11,787,48311787
40617,168,1793900,3,13,25,11,955,48311955
40618,68,1793900,1,13,25,12,23,48312023
40619,66,1793800,1,13,25,12,89,48312089
40620,93,1793800,1,13,25,12,182,48312182
40621,10,1794000,9,13,25,12,192,48312192
40623,11,1793900,1,13,25,12,203,48312203
40624,55,1793800,3,13,25,12,258,48312258
40625,18,1794000,1,13,25,12,276,48312276
40626,670,1793900,1,13,25,12,946,48312946
40627,906,1794000,1,13,25,13,852,48313852
40628,75,1794000,2,13,25,13,927,48313927
40629,378,1794000,1,13,25,14,305,48314305
40630,311,1794000,1,13,25,14,616,48314616
40631,312,1794000,1,13,25,14,928,48314928
40632,105,1794000,3,13,25,15,33,48315033
40633,0,1794000,2,13,25,15,33,48315033
40634,75,1794000,2,13,25,15,108,48315108
40636,1048,1793900,1,13,25,16,156,48316156
40637,545,1793900,1,13,25,16,701,48316701
40638,288,1793900,1,13,25,16,989,48316989
40639,164,1793800,1,13,25,17,153,48317153
40640,441,1793900,3,13,25,17,594,48317594
40641,1017,1793900,1,13,25,18,611,48318611
40642,169,1794000,1,13,25,18,780,48318780
40643,358,1793900,1,13,25,19,138,48319138
40644,68,1794000,2,13,25,19,206,48319206
40645,1048,1793800,1,13,25,20,254,48320254
40646,283,1794000,1,13,25,20,537,48320537
40647,505,1794000,4,13,25,21,42,48321042
40648,546,1794100,1,13,25,21,588,48321588
40649,170,1794000,1,13,25,21,758,48321758
40650,251,1794100,1,13,25,22,9,48322009
40651,830,1794000,3,13,25,22,839,48322839
40652,1138,1794100,1,13,25,23,977,48323977
40653,972,1794100,2,13,25,24,949,48324949
40654,578,1794100,1,13,25,25,527,48325527
40655,76,1794200,2,13,25,25,603,48325603
40656,633,1794100,1,13,25,26,236,48326236
40657,60,1794200,1,13,25,26,296,48326296
40658,244,1794300,1,13,25,26,540,48326540
40659,408,1794300,3,13,25,26,948,48326948
40660,12,1794300,1,13,25,26,960,48326960
40661,46,1794300,1,13,25,27,6,48327006
40662,1062,1794200,1,13,25,28,68,48328068
40663,1050,1794200,1,13,25,29,118,48329118
40664,48,1794200,1,13,25,29,166,48329166
40665,2467,1794200,1,13,25,31,633,48331633
40666,357,1794200,1,13,25,31,990,48331990
40667,1050,1794200,1,13,25,33,40,48333040
40668,0,1794200,5,13,25,33,40,48333040
40669,513,1794300,1,13,25,33,553,48333553
40670,19,1794300,1,13,25,33,572,48333572
40671,73,1794300,1,13,25,33,645,48333645
40672,48,1794300,2,13,25,33,693,48333693
40673,746,1794300,1,13,25,34,439,48334439
40674,29,1794300,1,13,25,34,468,48334468
40675,36,1794300,1,13,25,34,504,48334504
40676,76,1794300,1,13,25,34,580,48334580
40677,0,1794300,2,13,25,34,580,48334580
40678,0,1794300,8,13,25,34,580,48334580
40679,614,1794300,1,13,25,35,194,48335194
40680,346,1794200,1,13,25,35,540,48335540
40681,92,1794400,1,13,25,35,632,48335632
40682,2026,1794400,10,13,25,37,658,48337658
40683,600,1794400,1,13,25,38,258,48338258
40684,26,1794300,1,13,25,38,284,48338284
40685,598,1794500,2,13,25,38,882,48338882
40686,360,1794300,1,13,25,39,242,48339242
40687,393,1794400,1,13,25,39,635,48339635
40688,249,1794400,1,13,25,39,884,48339884
40689,453,1794400,1,13,25,40,337,48340337
40690,306,1794400,1,13,25,40,643,48340643
40691,763,1794400,1,13,25,41,406,48341406
40692,2290,1794200,2,13,25,43,696,48343696
40693,1,1794200,1,13,25,43,697,48343697
40694,0,1794200,5,13,25,43,697,48343697
40695,43,1794300,1,13,25,43,740,48343740
40696,16,1794300,3,13,25,43,756,48343756
40697,20,1794300,5,13,25,43,776,48343776
40698,13,1794300,1,13,25,43,789,48343789
40699,1244,1794400,1,13,25,45,33,48345033
40700,107,1794300,1,13,25,45,140,48345140
40701,84,1794400,1,13,25,45,224,48345224
40702,155,1794400,1,13,25,45,379,48345379
40703,493,1794400,2,13,25,45,872,48345872
40704,108,1794300,2,13,25,45,980,48345980
40705,1179,1794400,1,13,25,47,159,48347159
40706,1002,1794300,4,13,25,48,161,48348161
40707,981,1794400,1,13,25,49,142,48349142
40708,408,1794300,1,13,25,49,550,48349550
40709,734,1794300,1,13,25,50,284,48350284
40710,1028,1794300,1,13,25,51,312,48351312
40711,260,1794100,1,13,25,51,572,48351572
40712,62,1794200,1,13,25,51,634,48351634
40713,129,1794200,1,13,25,51,763,48351763
40714,53,1794200,1,13,25,51,816,48351816
40715,108,1794200,5,13,25,51,924,48351924
40716,780,1794200,2,13,25,52,704,48352704
40717,870,1794200,2,13,25,53,574,48353574
40718,1911,1794200,1,13,25,55,485,48355485
40719,435,1794100,1,13,25,55,920,48355920
40720,251,1794100,2,13,25,56,171,48356171
40721,155,1794200,1,13,25,56,326,48356326
40722,376,1794200,1,13,25,56,702,48356702
40723,133,1794200,1,13,25,56,835,48356835
40724,1502,1794100,10,13,25,58,337,48358337
40725,994,1794000,3,13,25,59,331,48359331
40726,151,1794000,1,13,25,59,482,48359482
40727,256,1794000,1,13,25,59,738,48359738
40728,640,1793900,2,13,26,0,378,48360378
40729,1653,1794000,4,13,26,2,31,48362031
40731,956,1793900,5,13,26,2,987,48362987
40732,0,1793900,1,13,26,2,987,48362987
40733,65,1793800,5,13,26,3,52,48363052
40734,0,1793800,1,13,26,3,52,48363052
40735,189,1793900,1,13,26,3,241,48363241
40736,1071,1793700,1,13,26,4,312,48364312
40737,668,1793700,1,13,26,4,980,48364980
40738,27,1793700,1,13,26,5,7,48365007
40739,0,1793700,2,13,26,5,7,48365007
40740,305,1793700,1,13,26,5,312,48365312
40741,56,1793700,1,13,26,5,368,48365368
40742,72,1793800,1,13,26,5,440,48365440
40743,51,1793800,1,13,26,5,491,48365491
40744,29,1793800,1,13,26,5,520,48365520
40745,20,1793800,1,13,26,5,540,48365540
40746,112,1793800,1,13,26,5,652,48365652
40747,39,1793800,1,13,26,5,691,48365691
40748,41,1793800,1,13,26,5,732,48365732
40749,34,1793900,1,13,26,5,766,48365766
40750,17,1793800,2,13,26,5,783,48365783
40751,874,1793900,1,13,26,6,657,48366657
40752,221,1793700,3,13,26,6,878,48366878
40753,445,1793600,1,13,26,7,323,48367323
40754,339,1793600,1,13,26,7,662,48367662
40755,0,1793600,1,13,26,7,662,48367662
40756,0,1793600,7,13,26,7,662,48367662
40757,1,1793600,2,13,26,7,663,48367663
40758,75,1793500,1,13,26,7,738,48367738
40759,62,1793500,1,13,26,7,800,48367800
40760,0,1793500,3,13,26,7,800,48367800
40761,1,1793500,3,13,26,7,801,48367801
40762,0,1793500,1,13,26,7,801,48367801
40763,0,1793500,1,13,26,7,801,48367801
40764,0,1793500,4,13,26,7,801,48367801
40765,0,1793500,4,13,26,7,801,48367801
40766,459,1793500,1,13,26,8,260,48368260
40767,21,1793500,1,13,26,8,281,48368281
40768,58,1793500,1,13,26,8,339,48368339
40769,133,1793400,1,13,26,8,472,48368472
40770,327,1793400,3,13,26,8,799,48368799
40771,17,1793500,1,13,26,8,816,48368816
40772,36,1793400,1,13,26,8,852,48368852
40773,59,1793500,1,13,26,8,911,48368911
40774,41,1793600,1,13,26,8,952,48368952
40775,106,1793300,1,13,26,9,58,48369058
40776,46,1793500,1,13,26,9,104,48369104
40778,396,1793500,1,13,26,9,500,48369500
40779,658,1793500,1,13,26,10,158,48370158
40780,518,1793500,5,13,26,10,676,48370676
40781,420,1793500,1,13,26,11,96,48371096
40782,79,1793300,2,13,26,11,175,48371175
40783,287,1793500,1,13,26,11,462,48371462
40784,486,1793500,1,13,26,11,948,48371948
40785,1909,1793500,1,13,26,13,857,48373857
40786,287,1793500,1,13,26,14,144,48374144
40787,647,1793600,1,13,26,14,791,48374791
40788,51,1793600,1,13,26,14,842,48374842
40789,84,1793600,1,13,26,14,926,48374926
40790,654,1793600,1,13,26,15,580,48375580
40791,1187,1793500,3,13,26,16,767,48376767
40792,2211,1793600,1,13,26,18,978,48378978
40793,933,1793500,2,13,26,19,911,48379911
40794,442,1793500,2,13,26,20,353,48380353
40795,3,1793500,2,13,26,20,356,48380356
40796,700,1793500,2,13,26,21,56,48381056
40797,1432,1793500,1,13,26,22,488,48382488
40798,910,1793600,1,13,26,23,398,48383398
40799,4,1793600,1,13,26,23,402,48383402
40800,326,1793500,1,13,26,23,728,48383728
40801,434,1793500,1,13,26,24,162,48384162
40802,211,1793500,1,13,26,24,373,48384373
40803,389,1793600,1,13,26,24,762,48384762
40804,121,1793600,4,13,26,24,883,48384883
40805,649,1793600,1,13,26,25,532,48385532
40806,46,1793500,4,13,26,25,578,48385578
40807,130,1793600,1,13,26,25,708,48385708
40808,233,1793500,1,13,26,25,941,48385941
40809,1,1793500,1,13,26,25,942,48385942
40810,394,1793600,1,13,26,26,336,48386336
40811,241,1793500,3,13,26,26,577,48386577
40812,37,1793600,3,13,26,26,614,48386614
40813,0,1793600,1,13,26,26,614,48386614
40814,0,1793600,1,13,26,26,614,48386614
40815,1,1793600,1,13,26,26,615,48386615
40816,0,1793600,1,13,26,26,615,48386615
40817,0,1793600,1,13,26,26,615,48386615
40818,57,1793600,1,13,26,26,672,48386672
40819,151,1793600,2,13,26,26,823,48386823
40820,15,1793700,1,13,26,26,838,48386838
40821,138,1793700,3,13,26,26,976,48386976
40822,125,1793600,1,13,26,27,101,48387101
40823,476,1793700,8,13,26,27,577,48387577
40825,938,1793600,1,13,26,28,515,48388515
40826,254,1793500,1,13,26,28,769,48388769
40827,64,1793500,13,13,26,28,833,48388833
40828,1,1793400,1,13,26,28,834,48388834
40829,0,1793400,2,13,26,28,834,48388834
40830,9,1793300,4,13,26,28,843,48388843
40831,20,1793200,4,13,26,28,863,48388863
40832,119,1793300,3,13,26,28,982,48388982
40833,217,1793200,1,13,26,29,199,48389199
40834,22,1793200,1,13,26,29,221,48389221
40835,299,1793100,2,13,26,29,520,48389520
40836,60,1793100,1,13,26,29,580,48389580
40838,148,1793000,1,13,26,29,728,48389728
40839,131,1793000,2,13,26,29,859,48389859
40840,437,1793000,1,13,26,30,296,48390296
40841,700,1793100,1,13,26,30,996,48390996
40842,60,1793200,1,13,26,31,56,48391056
40843,520,1793200,1,13,26,31,576,48391576
40844,40,1793200,1,13,26,31,616,48391616
40845,36,1793200,1,13,26,31,652,48391652
40846,35,1793200,1,13,26,31,687,48391687
40847,235,1793200,6,13,26,31,922,48391922
40848,107,1793200,2,13,26,32,29,48392029
40849,94,1793300,1,13,26,32,123,48392123
40850,484,1793200,1,13,26,32,607,48392607
40851,69,1793200,1,13,26,32,676,48392676
40852,2239,1793200,1,13,26,34,915,48394915
40853,196,1793200,4,13,26,35,111,48395111
40854,2,1793300,10,13,26,35,113,48395113
40855,0,1793400,1,13,26,35,113,48395113
40856,0,1793400,1,13,26,35,113,48395113
40857,0,1793400,2,13,26,35,113,48395113
40858,0,1793400,6,13,26,35,113,48395113
40859,139,1793500,3,13,26,35,252,48395252
40860,46,1793500,1,13,26,35,298,48395298
40861,186,1793400,1,13,26,35,484,48395484
40862,18,1793600,3,13,26,35,502,48395502
40863,478,1793400,1,13,26,35,980,48395980
40864,136,1793400,1,13,26,36,116,48396116
40865,356,1793400,1,13,26,36,472,48396472
40866,13,1793500,1,13,26,36,485,48396485
40867,162,1793600,1,13,26,36,647,48396647
40868,40,1793600,1,13,26,36,687,48396687
40869,1375,1793500,1,13,26,38,62,48398062
40870,183,1793500,3,13,26,38,245,48398245
40871,10,1793500,1,13,26,38,255,48398255
40872,191,1793500,2,13,26,38,446,48398446
40873,21,1793600,1,13,26,38,467,48398467
40874,0,1793600,6,13,26,38,467,48398467
40875,21,1793700,1,13,26,38,488,48398488
40876,0,1793700,1,13,26,38,488,48398488
40877,0,1793700,1,13,26,38,488,48398488
40878,1,1793700,1,13,26,38,489,48398489
40879,137,1793700,1,13,26,38,626,48398626
40880,126,1793800,5,13,26,38,752,48398752
40881,0,1793800,1,13,26,38,752,48398752
40882,32,1793900,2,13,26,38,784,48398784
40883,84,1793800,1,13,26,38,868,48398868
40884,35,1793800,1,13,26,38,903,48398903
40885,37,1793800,1,13,26,38,940,48398940
40886,48,1793800,1,13,26,38,988,48398988
40887,109,1793800,1,13,26,39,97,48399097
40888,94,1793800,1,13,26,39,191,48399191
40889,397,1793700,1,13,26,39,588,48399588
40890,1,1793700,1,13,26,39,589,48399589
40891,0,1793700,1,13,26,39,589,48399589
40892,0,1793700,1,13,26,39,589,48399589
40893,135,1793800,2,13,26,39,724,48399724
40894,1104,1793700,1,13,26,40,828,48400828
40895,385,1793700,2,13,26,41,213,48401213
40896,1,1793700,1,13,26,41,214,48401214
40897,355,1793800,2,13,26,41,569,48401569
40898,82,1793800,1,13,26,41,651,48401651
40899,45,1793700,3,13,26,41,696,48401696
40900,238,1793800,1,13,26,41,934,48401934
40901,229,1793800,1,13,26,42,163,48402163
40902,846,1793700,1,13,26,43,9,48403009
40903,1,1793700,1,13,26,43,10,48403010
40904,0,1793700,1,13,26,43,10,48403010
40905,43,1793700,1,13,26,43,53,48403053
40906,236,1793700,1,13,26,43,289,48403289
40907,96,1793700,1,13,26,43,385,48403385
40908,291,1793600,3,13,26,43,676,48403676
40909,391,1793600,1,13,26,44,67,48404067
40910,111,1793600,1,13,26,44,178,48404178
40911,1264,1793800,1,13,26,45,442,48405442
40912,20,1793800,3,13,26,45,462,48405462
40913,0,1793800,1,13,26,45,462,48405462
40914,921,1793700,1,13,26,46,383,48406383
40915,495,1793700,4,13,26,46,878,48406878
40917,1045,1793600,2,13,26,47,923,48407923
40919,668,1793600,1,13,26,48,591,48408591
40920,1782,1793600,5,13,26,50,373,48410373
40921,2347,1793700,10,13,26,52,720,48412720
40922,1,1793700,1,13,26,52,721,48412721
40923,101,1793700,1,13,26,52,822,48412822
40924,66,1793600,1,13,26,52,888,48412888
40925,719,1793800,2,13,26,53,607,48413607
40926,19,1793800,2,13,26,53,626,48413626
40927,103,1793800,1,13,26,53,729,48413729
40928,116,1793800,2,13,26,53,845,48413845
40929,83,1793800,1,13,26,53,928,48413928
40930,4,1793800,4,13,26,53,932,48413932
40931,66,1793900,7,13,26,53,998,48413998
40932,133,1794000,1,13,26,54,131,48414131
40933,2464,1794000,1,13,26,56,595,48416595
40934,454,1793900,1,13,26,57,49,48417049
40935,920,1794000,1,13,26,57,969,48417969
40936,179,1794000,1,13,26,58,148,48418148
40937,123,1794000,1,13,26,58,271,48418271
40938,702,1794000,23,13,26,58,973,48418973
40939,1,1794000,1,13,26,58,974,48418974
40940,0,1794000,1,13,26,58,974,48418974
40941,0,1794000,3,13,26,58,974,48418974
40942,0,1794000,1,13,26,58,974,48418974
40943,1,1794100,1,13,26,58,975,48418975
40944,22,1794100,1,13,26,58,997,48418997
40945,14,1794100,10,13,26,59,11,48419011
40946,67,1794200,2,13,26,59,78,48419078
40947,7,1794100,2,13,26,59,85,48419085
40948,50,1794100,1,13,26,59,135,48419135
40949,0,1794100,2,13,26,59,135,48419135
40950,12,1794000,1,13,26,59,147,48419147
40951,151,1794000,1,13,26,59,298,48419298
40952,94,1794100,1,13,26,59,392,48419392
40953,393,1794100,1,13,26,59,785,48419785
40954,0,1794100,1,13,26,59,785,48419785
40955,196,1794100,2,13,26,59,981,48419981
40956,95,1794100,1,13,27,0,76,48420076
40957,231,1794100,1,13,27,0,307,48420307
40958,748,1794200,2,13,27,1,55,48421055
40959,1,1794200,9,13,27,1,56,48421056
40960,0,1794200,3,13,27,1,56,48421056
40961,218,1794300,8,13,27,1,274,48421274
40962,131,1794400,1,13,27,1,405,48421405
40963,24,1794200,1,13,27,1,429,48421429
40964,94,1794200,1,13,27,1,523,48421523
40965,86,1794200,1,13,27,1,609,48421609
40966,73,1794300,1,13,27,1,682,48421682
40967,71,1794300,1,13,27,1,753,48421753
40968,57,1794200,1,13,27,1,810,48421810
40969,1930,1794300,1,13,27,3,740,48423740
40970,194,1794300,1,13,27,3,934,48423934
40971,720,1794400,13,13,27,4,654,48424654
40972,43,1794300,1,13,27,4,697,48424697
40973,26,1794500,5,13,27,4,723,48424723
40974,17,1794300,2,13,27,4,740,48424740
40975,183,1794300,1,13,27,4,923,48424923
40976,41,1794400,1,13,27,4,964,48424964
40977,611,1794300,3,13,27,5,575,48425575
40979,127,1794400,1,13,27,5,702,48425702
40980,123,1794300,2,13,27,5,825,48425825
40981,135,1794400,1,13,27,5,960,48425960
40982,1,1794400,1,13,27,5,961,48425961
40983,677,1794500,1,13,27,6,638,48426638
40984,211,1794500,1,13,27,6,849,48426849
40985,712,1794500,2,13,27,7,561,48427561
40986,281,1794400,3,13,27,7,842,48427842
40987,1,1794400,3,13,27,7,843,48427843
40988,69,1794400,1,13,27,7,912,48427912
40989,259,1794400,2,13,27,8,171,48428171
40990,8,1794400,1,13,27,8,179,48428179
40991,0,1794400,1,13,27,8,179,48428179
40992,2,1794400,1,13,27,8,181,48428181
40993,567,1794400,2,13,27,8,748,48428748
40994,182,1794400,2,13,27,8,930,48428930
40995,62,1794400,1,13,27,8,992,48428992
40996,59,1794400,2,13,27,9,51,48429051
40997,0,1794400,1,13,27,9,51,48429051
40998,349,1794300,1,13,27,9,400,48429400
40999,312,1794300,1,13,27,9,712,48429712
41000,40,1794300,2,13,27,9,752,48429752
41001,132,1794200,1,13,27,9,884,48429884
41002,1823,1794200,1,13,27,11,707,48431707
41003,0,1794200,1,13,27,11,707,48431707
41004,569,1794200,1,13,27,12,276,48432276
41005,377,1794100,1,13,27,12,653,48432653
41006,400,1794100,1,13,27,13,53,48433053
41007,664,1794100,1,13,27,13,717,48433717
41008,109,1794100,1,13,27,13,826,48433826
41009,0,1794100,1,13,27,13,826,48433826
41010,1,1794100,1,13,27,13,827,48433827
41011,2,1794000,1,13,27,13,829,48433829
41012,277,1793900,1,13,27,14,106,48434106
41013,649,1794000,1,13,27,14,755,48434755
41014,14,1794100,1,13,27,14,769,48434769
41015,1321,1794000,1,13,27,16,90,48436090
41016,1540,1794100,1,13,27,17,630,48437630
41017,1248,1794100,1,13,27,18,878,48438878
41018,203,1793900,4,13,27,19,81,48439081
41019,251,1794000,1,13,27,19,332,48439332
41020,44,1794000,1,13,27,19,376,48439376
41021,24,1794000,2,13,27,19,400,48439400
41022,441,1793800,1,13,27,19,841,48439841
41023,378,1793900,1,13,27,20,219,48440219
41024,13,1794000,2,13,27,20,232,48440232
41025,20,1794000,1,13,27,20,252,48440252
41026,72,1794000,1,13,27,20,324,48440324
41027,63,1794000,1,13,27,20,387,48440387
41028,81,1794000,1,13,27,20,468,48440468
41029,24,1794000,1,13,27,20,492,48440492
41030,219,1793900,1,13,27,20,711,48440711
41031,2257,1794000,5,13,27,22,968,48442968
41032,1,1794000,6,13,27,22,969,48442969
41033,0,1794000,1,13,27,22,969,48442969
41034,0,1794000,1,13,27,22,969,48442969
41035,0,1794000,3,13,27,22,969,48442969
41036,177,1794100,2,13,27,23,146,48443146
41037,1472,1794200,1,13,27,24,618,48444618
41038,255,1794100,1,13,27,24,873,48444873
41039,362,1794000,1,13,27,25,235,48445235
41040,313,1794000,1,13,27,25,548,48445548
41041,876,1794000,1,13,27,26,424,48446424
41042,1247,1794000,2,13,27,27,671,48447671
41044,1,1793900,1,13,27,27,672,48447672
41045,1302,1794000,1,13,27,28,974,48448974
41046,421,1794000,1,13,27,29,395,48449395
41047,9,1794100,1,13,27,29,404,48449404
41048,54,1794000,1,13,27,29,458,48449458
41049,92,1794200,1,13,27,29,550,48449550
41050,15,1794200,1,13,27,29,565,48449565
41051,29,1794200,1,13,27,29,594,48449594
41052,10,1794000,1,13,27,29,604,48449604
41053,10,1794200,1,13,27,29,614,48449614
41054,196,1794200,2,13,27,29,810,48449810
41055,20,1794200,1,13,27,29,830,48449830
41056,593,1794200,1,13,27,30,423,48450423
41057,206,1794200,1,13,27,30,629,48450629
41058,228,1794000,3,13,27,30,857,48450857
41059,1336,1794000,1,13,27,32,193,48452193
41060,2736,1794100,1,13,27,34,929,48454929
41061,37,1794200,2,13,27,34,966,48454966
41062,120,1794000,1,13,27,35,86,48455086
41063,307,1794200,1,13,27,35,393,48455393
41064,143,1794200,1,13,27,35,536,48455536
41065,253,1794200,1,13,27,35,789,48455789
41066,228,1794200,1,13,27,36,17,48456017
41067,254,1794200,1,13,27,36,271,48456271
41068,0,1794200,2,13,27,36,271,48456271
41069,5,1794100,2,13,27,36,276,48456276
41070,99,1794200,1,13,27,36,375,48456375
41071,46,1794200,1,13,27,36,421,48456421
41073,275,1794200,1,13,27,36,696,48456696
41074,121,1794200,1,13,27,36,817,48456817
41075,547,1794300,1,13,27,37,364,48457364
41076,179,1794300,1,13,27,37,543,48457543
41077,151,1794300,1,13,27,37,694,48457694
41078,453,1794300,4,13,27,38,147,48458147
41079,212,1794300,1,13,27,38,359,48458359
41080,284,1794400,2,13,27,38,643,48458643
41081,2,1794300,1,13,27,38,645,48458645
41082,545,1794400,1,13,27,39,190,48459190
41083,869,1794400,1,13,27,40,59,48460059
41084,33,1794300,1,13,27,40,92,48460092
41085,139,1794400,1,13,27,40,231,48460231
41086,160,1794400,1,13,27,40,391,48460391
41087,120,1794400,3,13,27,40,511,48460511
41088,2,1794400,5,13,27,40,513,48460513
41089,63,1794500,2,13,27,40,576,48460576
41090,169,1794500,5,13,27,40,745,48460745
41091,47,1794400,1,13,27,40,792,48460792
41092,220,1794500,1,13,27,41,12,48461012
41093,39,1794500,1,13,27,41,51,48461051
41094,37,1794500,1,13,27,41,88,48461088
41095,239,1794500,1,13,27,41,327,48461327
41096,0,1794500,26,13,27,41,327,48461327
41097,2,1794600,1,13,27,41,329,48461329
41098,0,1794600,1,13,27,41,329,48461329
41099,1,1794600,1,13,27,41,330,48461330
41100,0,1794600,1,13,27,41,330,48461330
41101,1,1794600,11,13,27,41,331,48461331
41102,16,1794600,1,13,27,41,347,48461347
41103,48,1794500,1,13,27,41,395,48461395
41104,110,1794600,1,13,27,41,505,48461505
41105,0,1794600,2,13,27,41,505,48461505
41106,62,1794700,3,13,27,41,567,48461567
41107,40,1794600,1,13,27,41,607,48461607
41108,32,1794700,1,13,27,41,639,48461639
41109,4,1794700,1,13,27,41,643,48461643
41110,17,1794700,2,13,27,41,660,48461660
41111,43,1794700,1,13,27,41,703,48461703
41112,37,1794700,1,13,27,41,740,48461740
41113,46,1794600,1,13,27,41,786,48461786
41114,3,1794700,1,13,27,41,789,48461789
41115,15,1794700,1,13,27,41,804,48461804
41116,59,1794700,1,13,27,41,863,48461863
41117,42,1794700,1,13,27,41,905,48461905
41118,107,1794700,3,13,27,42,12,48462012
41119,86,1794700,1,13,27,42,98,48462098
41120,8,1794700,1,13,27,42,106,48462106
41121,116,1794800,20,13,27,42,222,48462222
41122,199,1794700,1,13,27,42,421,48462421
41123,320,1794800,1,13,27,42,741,48462741
41124,9,1794700,2,13,27,42,750,48462750
41125,15,1794800,1,13,27,42,765,48462765
41126,119,1794800,1,13,27,42,884,48462884
41127,47,1794800,1,13,27,42,931,48462931
41128,131,1794800,1,13,27,43,62,48463062
41129,116,1794800,1,13,27,43,178,48463178
41130,107,1794900,1,13,27,43,285,48463285
41131,135,1794900,1,13,27,43,420,48463420
41132,58,1794900,18,13,27,43,478,48463478
41133,1,1795000,1,13,27,43,479,48463479
41134,7,1794900,1,13,27,43,486,48463486
41135,1,1795000,11,13,27,43,487,48463487
41136,0,1795000,1,13,27,43,487,48463487
41137,1,1795000,9,13,27,43,488,48463488
41138,0,1795000,1,13,27,43,488,48463488
41139,0,1795000,6,13,27,43,488,48463488
41140,0,1795000,1,13,27,43,488,48463488
41141,0,1795000,1,13,27,43,488,48463488
41142,0,1795000,1,13,27,43,488,48463488
41143,30,1795000,3,13,27,43,518,48463518
41144,94,1794900,1,13,27,43,612,48463612
41145,0,1794900,2,13,27,43,612,48463612
41146,1,1794800,2,13,27,43,613,48463613
41147,98,1794900,1,13,27,43,711,48463711
41148,6,1794800,2,13,27,43,717,48463717
41149,28,1794900,1,13,27,43,745,48463745
41150,36,1794900,1,13,27,43,781,48463781
41151,66,1794800,2,13,27,43,847,48463847
41152,64,1794900,3,13,27,43,911,48463911
41153,77,1794900,1,13,27,43,988,48463988
41154,21,1794900,1,13,27,44,9,48464009
41155,144,1794900,1,13,27,44,153,48464153
41156,94,1795000,1,13,27,44,247,48464247
41157,250,1795000,1,13,27,44,497,48464497
41158,9,1794800,1,13,27,44,506,48464506
41159,685,1794900,1,13,27,45,191,48465191
41160,1,1794900,1,13,27,45,192,48465192
41161,7,1794900,1,13,27,45,199,48465199
41162,149,1795000,1,13,27,45,348,48465348
41163,113,1795000,1,13,27,45,461,48465461
41164,87,1794900,1,13,27,45,548,48465548
41165,107,1794800,1,13,27,45,655,48465655
41166,152,1794800,5,13,27,45,807,48465807
41167,0,1794800,5,13,27,45,807,48465807
41169,3,1794500,9,13,27,45,810,48465810
41170,0,1794600,47,13,27,45,810,48465810
41171,1,1794500,1,13,27,45,811,48465811
41172,0,1794500,1,13,27,45,811,48465811
41173,2,1794600,4,13,27,45,813,48465813
41174,0,1794600,1,13,27,45,813,48465813
41175,2,1794500,3,13,27,45,815,48465815
41176,2,1794700,1,13,27,45,817,48465817
41177,3,1794500,2,13,27,45,820,48465820
41178,0,1794500,2,13,27,45,820,48465820
41179,47,1794500,2,13,27,45,867,48465867
41180,40,1794400,3,13,27,45,907,48465907
41181,41,1794600,3,13,27,45,948,48465948
41182,391,1794600,5,13,27,46,339,48466339
41183,54,1794600,1,13,27,46,393,48466393
41184,51,1794600,2,13,27,46,444,48466444
41185,49,1794600,2,13,27,46,493,48466493
41186,87,1794600,1,13,27,46,580,48466580
41187,595,1794700,1,13,27,47,175,48467175
41188,157,1794700,1,13,27,47,332,48467332
41189,256,1794700,1,13,27,47,588,48467588
41190,417,1794900,1,13,27,48,5,48468005
41191,178,1794700,4,13,27,48,183,48468183
41193,2,1794600,79,13,27,48,185,48468185
41194,0,1794500,2,13,27,48,185,48468185
41195,1,1794700,1,13,27,48,186,48468186
41196,0,1794700,1,13,27,48,186,48468186
41197,1,1794600,1,13,27,48,187,48468187
41198,0,1794600,1,13,27,48,187,48468187
41199,40,1794500,1,13,27,48,227,48468227
41200,76,1794700,2,13,27,48,303,48468303
41201,39,1794700,1,13,27,48,342,48468342
41202,471,1794700,1,13,27,48,813,48468813
41203,207,1794600,1,13,27,49,20,48469020
41204,163,1794700,1,13,27,49,183,48469183
41205,1367,1794700,5,13,27,50,550,48470550
41207,359,1794800,2,13,27,50,909,48470909
41208,147,1794800,1,13,27,51,56,48471056
41209,146,1794800,1,13,27,51,202,48471202
41210,555,1794800,2,13,27,51,757,48471757
41211,51,1794600,4,13,27,51,808,48471808
41212,0,1794600,4,13,27,51,808,48471808
41214,3,1794300,1,13,27,51,811,48471811
41215,1,1794300,1,13,27,51,812,48471812
41216,0,1794300,1,13,27,51,812,48471812
41217,2,1794300,1,13,27,51,814,48471814
41219,1,1794400,1,13,27,51,815,48471815
41220,83,1794400,1,13,27,51,898,48471898
41221,13,1794400,1,13,27,51,911,48471911
41222,263,1794500,1,13,27,52,174,48472174
41223,561,1794400,2,13,27,52,735,48472735
41224,454,1794400,1,13,27,53,189,48473189
41225,170,1794400,2,13,27,53,359,48473359
41226,234,1794300,2,13,27,53,593,48473593
41227,147,1794300,2,13,27,53,740,48473740
41228,311,1794200,1,13,27,54,51,48474051
41229,130,1794300,1,13,27,54,181,48474181
41230,126,1794100,1,13,27,54,307,48474307
41231,186,1794200,1,13,27,54,493,48474493
41232,364,1794300,5,13,27,54,857,48474857
41233,1,1794300,1,13,27,54,858,48474858
41234,511,1794400,1,13,27,55,369,48475369
41235,115,1794500,1,13,27,55,484,48475484
41236,260,1794500,1,13,27,55,744,48475744
41237,17,1794500,2,13,27,55,761,48475761
41238,211,1794400,1,13,27,55,972,48475972
41239,524,1794500,1,13,27,56,496,48476496
41241,116,1794500,2,13,27,56,612,48476612
41242,15,1794600,1,13,27,56,627,48476627
41243,446,1794600,2,13,27,57,73,48477073
41244,241,1794500,1,13,27,57,314,48477314
41245,446,1794600,1,13,27,57,760,48477760
41246,48,1794700,1,13,27,57,808,48477808
41247,281,1794600,5,13,27,58,89,48478089
41248,0,1794600,5,13,27,58,89,48478089
41250,3,1794400,51,13,27,58,92,48478092
41251,129,1794500,5,13,27,58,221,48478221
41252,29,1794500,5,13,27,58,250,48478250
41253,144,1794500,1,13,27,58,394,48478394
41254,238,1794500,1,13,27,58,632,48478632
41255,90,1794500,2,13,27,58,722,48478722
41256,34,1794500,1,13,27,58,756,48478756
41257,1088,1794400,1,13,27,59,844,48479844
41258,1,1794400,2,13,27,59,845,48479845
41259,127,1794600,1,13,27,59,972,48479972
41260,39,1794600,2,13,28,0,11,48480011
41261,148,1794400,1,13,28,0,159,48480159
41262,317,1794500,1,13,28,0,476,48480476
41263,44,1794500,2,13,28,0,520,48480520
41264,418,1794500,1,13,28,0,938,48480938
41265,134,1794600,1,13,28,1,72,48481072
41266,36,1794600,1,13,28,1,108,48481108
41267,39,1794600,1,13,28,1,147,48481147
41268,73,1794600,1,13,28,1,220,48481220
41269,11,1794600,1,13,28,1,231,48481231
41270,9,1794600,2,13,28,1,240,48481240
41271,361,1794700,5,13,28,1,601,48481601
41272,368,1794700,1,13,28,1,969,48481969
41273,24,1794600,2,13,28,1,993,48481993
41275,415,1794500,1,13,28,2,408,48482408
41276,214,1794700,2,13,28,2,622,48482622
41277,389,1794500,1,13,28,3,11,48483011
41279,3,1794300,1,13,28,3,14,48483014
41280,0,1794300,1,13,28,3,14,48483014
41281,0,1794300,1,13,28,3,14,48483014
41282,0,1794300,4,13,28,3,14,48483014
41283,612,1794300,2,13,28,3,626,48483626
41284,6,1794300,1,13,28,3,632,48483632
41285,13,1794400,3,13,28,3,645,48483645
41286,258,1794300,1,13,28,3,903,48483903
41287,0,1794300,1,13,28,3,903,48483903
41289,366,1794300,1,13,28,4,269,48484269
41290,117,1794200,2,13,28,4,386,48484386
41292,50,1794200,2,13,28,4,436,48484436
41293,35,1794200,2,13,28,4,471,48484471
41295,28,1794300,4,13,28,4,499,48484499
41296,89,1794200,1,13,28,4,588,48484588
41297,67,1794300,1,13,28,4,655,48484655
41298,106,1794200,1,13,28,4,761,48484761
41300,351,1794100,3,13,28,5,112,48485112
41302,429,1794000,8,13,28,5,541,48485541
41303,543,1794200,1,13,28,6,84,48486084
41304,254,1794000,1,13,28,6,338,48486338
41305,69,1794200,1,13,28,6,407,48486407
41306,20,1794200,1,13,28,6,427,48486427
41307,24,1794200,2,13,28,6,451,48486451
41308,24,1794200,1,13,28,6,475,48486475
41309,365,1794300,1,13,28,6,840,48486840
41310,32,1794300,1,13,28,6,872,48486872
41311,44,1794200,1,13,28,6,916,48486916
41313,19,1794300,1,13,28,6,935,48486935
41314,1497,1794300,1,13,28,8,432,48488432
41315,178,1794300,2,13,28,8,610,48488610
41316,1453,1794200,1,13,28,10,63,48490063
41317,285,1794200,1,13,28,10,348,48490348
41318,164,1794100,1,13,28,10,512,48490512
41319,423,1794100,1,13,28,10,935,48490935
41320,42,1794100,1,13,28,10,977,48490977
41321,993,1794000,1,13,28,11,970,48491970
41322,365,1794000,1,13,28,12,335,48492335
41323,924,1794000,1,13,28,13,259,48493259
41324,1261,1794100,1,13,28,14,520,48494520
41325,1,1794100,1,13,28,14,521,48494521
41326,0,1794100,1,13,28,14,521,48494521
41327,0,1794100,1,13,28,14,521,48494521
41328,1,1794100,1,13,28,14,522,48494522
41329,420,1794200,2,13,28,14,942,48494942
41331,211,1794200,1,13,28,15,153,48495153
41332,174,1794300,1,13,28,15,327,48495327
41333,440,1794300,3,13,28,15,767,48495767
41334,183,1794200,2,13,28,15,950,48495950
41335,984,1794100,2,13,28,16,934,48496934
41336,136,1794100,1,13,28,17,70,48497070
41337,101,1794100,2,13,28,17,171,48497171
41338,1,1794100,2,13,28,17,172,48497172
41339,611,1794000,1,13,28,17,783,48497783
41340,42,1794000,2,13,28,17,825,48497825
41341,2,1794000,2,13,28,17,827,48497827
41342,0,1794000,4,13,28,17,827,48497827
41343,204,1793900,2,13,28,18,31,48498031
41344,364,1793800,1,13,28,18,395,48498395
41345,65,1793900,1,13,28,18,460,48498460
41346,41,1793900,1,13,28,18,501,48498501
41347,10,1793900,3,13,28,18,511,48498511
41348,79,1793800,1,13,28,18,590,48498590
41349,196,1793800,1,13,28,18,786,48498786
41350,214,1793800,3,13,28,19,0,48499000
41351,0,1793800,1,13,28,19,0,48499000
41352,37,1793700,1,13,28,19,37,48499037
41353,187,1793700,1,13,28,19,224,48499224
41354,241,1793900,1,13,28,19,465,48499465
41355,186,1793700,9,13,28,19,651,48499651
41356,171,1793700,1,13,28,19,822,48499822
41357,208,1793700,1,13,28,20,30,48500030
41358,448,1793600,1,13,28,20,478,48500478
41359,6,1793700,1,13,28,20,484,48500484
41360,148,1793600,5,13,28,20,632,48500632
41361,167,1793700,1,13,28,20,799,48500799
41362,41,1793600,1,13,28,20,840,48500840
41364,37,1793500,5,13,28,20,877,48500877
41365,265,1793500,2,13,28,21,142,48501142
41366,318,1793500,1,13,28,21,460,48501460
41367,151,1793500,1,13,28,21,611,48501611
41368,255,1793600,1,13,28,21,866,48501866
41369,174,1793600,1,13,28,22,40,48502040
41370,129,1793700,1,13,28,22,169,48502169
41371,78,1793600,1,13,28,22,247,48502247
41372,18,1793700,1,13,28,22,265,48502265
41373,19,1793700,1,13,28,22,284,48502284
41374,23,1793700,2,13,28,22,307,48502307
41375,1,1793700,3,13,28,22,308,48502308
41376,168,1793900,1,13,28,22,476,48502476
41377,20,1793900,1,13,28,22,496,48502496
41378,44,1793900,1,13,28,22,540,48502540
41379,40,1793900,1,13,28,22,580,48502580
41380,32,1793900,1,13,28,22,612,48502612
41381,28,1793900,1,13,28,22,640,48502640
41382,1079,1793900,9,13,28,23,719,48503719
41383,30,1793900,2,13,28,23,749,48503749
41384,242,1793900,1,13,28,23,991,48503991
41385,621,1793900,1,13,28,24,612,48504612
41386,567,1793900,1,13,28,25,179,48505179
41387,994,1793800,1,13,28,26,173,48506173
41388,0,1793800,1,13,28,26,173,48506173
41389,73,1793700,1,13,28,26,246,48506246
41390,578,1793700,1,13,28,26,824,48506824
41391,0,1793700,4,13,28,26,824,48506824
41392,785,1793700,2,13,28,27,609,48507609
41393,1,1793700,1,13,28,27,610,48507610
41394,262,1793600,1,13,28,27,872,48507872
41395,53,1793600,1,13,28,27,925,48507925
41396,409,1793700,1,13,28,28,334,48508334
41397,44,1793700,4,13,28,28,378,48508378
41399,222,1793800,1,13,28,28,600,48508600
41400,155,1793700,4,13,28,28,755,48508755
41401,1113,1793600,1,13,28,29,868,48509868
41402,173,1793800,1,13,28,30,41,48510041
41403,37,1793800,1,13,28,30,78,48510078
41404,570,1793700,5,13,28,30,648,48510648
41406,428,1793600,1,13,28,31,76,48511076
41407,531,1793600,3,13,28,31,607,48511607
41408,596,1793600,1,13,28,32,203,48512203
41409,1061,1793500,1,13,28,33,264,48513264
41410,388,1793500,2,13,28,33,652,48513652
41411,259,1793500,1,13,28,33,911,48513911
41412,349,1793500,2,13,28,34,260,48514260
41413,45,1793500,12,13,28,34,305,48514305
41414,50,1793400,4,13,28,34,355,48514355
41415,281,1793400,1,13,28,34,636,48514636
41416,272,1793400,2,13,28,34,908,48514908
41417,16,1793400,1,13,28,34,924,48514924
41418,578,1793400,2,13,28,35,502,48515502
41419,126,1793300,1,13,28,35,628,48515628
41420,123,1793400,1,13,28,35,751,48515751
41421,23,1793400,1,13,28,35,774,48515774
41422,75,1793300,1,13,28,35,849,48515849
41423,64,1793300,1,13,28,35,913,48515913
41424,139,1793300,1,13,28,36,52,48516052
41425,65,1793300,1,13,28,36,117,48516117
41426,7,1793200,3,13,28,36,124,48516124
41427,30,1793400,3,13,28,36,154,48516154
41428,301,1793200,2,13,28,36,455,48516455
41429,104,1793200,1,13,28,36,559,48516559
41430,518,1793200,4,13,28,37,77,48517077
41431,19,1793300,10,13,28,37,96,48517096
41432,21,1793400,1,13,28,37,117,48517117
41433,86,1793300,1,13,28,37,203,48517203
41434,0,1793300,1,13,28,37,203,48517203
41435,38,1793400,1,13,28,37,241,48517241
41436,46,1793300,1,13,28,37,287,48517287
41437,22,1793300,1,13,28,37,309,48517309
41438,511,1793400,1,13,28,37,820,48517820
41439,886,1793400,24,13,28,38,706,48518706
41440,0,1793400,24,13,28,38,706,48518706
41441,0,1793400,24,13,28,38,706,48518706
41443,12,1793500,1,13,28,38,718,48518718
41444,0,1793700,3,13,28,38,718,48518718
41445,310,1793700,1,13,28,39,28,48519028
41446,265,1793600,1,13,28,39,293,48519293
41447,317,1793700,1,13,28,39,610,48519610
41448,2038,1793600,4,13,28,41,648,48521648
41450,114,1793700,3,13,28,41,762,48521762
41451,1,1793700,57,13,28,41,763,48521763
41452,143,1793800,1,13,28,41,906,48521906
41453,5,1793800,1,13,28,41,911,48521911
41454,10,1793700,1,13,28,41,921,48521921
41455,24,1793800,1,13,28,41,945,48521945
41456,132,1793800,1,13,28,42,77,48522077
41457,124,1793700,1,13,28,42,201,48522201
41458,256,1793600,2,13,28,42,457,48522457
41459,806,1793700,2,13,28,43,263,48523263
41460,127,1793700,1,13,28,43,390,48523390
41461,215,1793700,1,13,28,43,605,48523605
41462,77,1793600,2,13,28,43,682,48523682
41463,1539,1793700,1,13,28,45,221,48525221
41464,2459,1793700,1,13,28,47,680,48527680
41465,497,1793700,1,13,28,48,177,48528177
41466,65,1793700,1,13,28,48,242,48528242
41467,44,1793700,1,13,28,48,286,48528286
41468,35,1793600,1,13,28,48,321,48528321
41469,23,1793600,2,13,28,48,344,48528344
41470,101,1793700,1,13,28,48,445,48528445
41471,83,1793700,1,13,28,48,528,48528528
41472,92,1793700,1,13,28,48,620,48528620
41473,609,1793700,1,13,28,49,229,48529229
41474,1823,1793600,1,13,28,51,52,48531052
41475,90,1793600,1,13,28,51,142,48531142
41476,965,1793600,1,13,28,52,107,48532107
41478,75,1793700,1,13,28,52,182,48532182
41479,106,1793800,2,13,28,52,288,48532288
41480,587,1793700,1,13,28,52,875,48532875
41481,682,1793700,1,13,28,53,557,48533557
41482,72,1793700,1,13,28,53,629,48533629
41483,3,1793700,1,13,28,53,632,48533632
41484,669,1793800,3,13,28,54,301,48534301
41486,43,1793700,1,13,28,54,344,48534344
41487,1257,1793900,1,13,28,55,601,48535601
41488,192,1793800,1,13,28,55,793,48535793
41489,771,1793800,4,13,28,56,564,48536564
41490,105,1793800,1,13,28,56,669,48536669
41491,361,1793900,1,13,28,57,30,48537030
41492,208,1793800,1,13,28,57,238,48537238
41493,439,1793900,1,13,28,57,677,48537677
41494,20,1793900,1,13,28,57,697,48537697
41495,46,1793900,2,13,28,57,743,48537743
41496,17,1793900,1,13,28,57,760,48537760
41497,812,1793900,1,13,28,58,572,48538572
41498,296,1793800,1,13,28,58,868,48538868
41499,507,1793800,1,13,28,59,375,48539375
41500,1112,1793800,2,13,29,0,487,48540487
41502,41,1793700,1,13,29,0,528,48540528
41503,467,1793900,1,13,29,0,995,48540995
41504,179,1793900,1,13,29,1,174,48541174
41505,53,1793700,1,13,29,1,227,48541227
41506,49,1793700,1,13,29,1,276,48541276
41507,95,1793900,1,13,29,1,371,48541371
41508,605,1793800,2,13,29,1,976,48541976
41509,440,1793700,1,13,29,2,416,48542416
41510,1,1793700,18,13,29,2,417,48542417
41511,0,1793700,1,13,29,2,417,48542417
41512,0,1793700,1,13,29,2,417,48542417
41513,0,1793700,6,13,29,2,417,48542417
41514,1,1793700,1,13,29,2,418,48542418
41515,0,1793700,2,13,29,2,418,48542418
41516,0,1793700,1,13,29,2,418,48542418
41517,0,1793700,2,13,29,2,418,48542418
41518,0,1793700,1,13,29,2,418,48542418
41519,0,1793700,2,13,29,2,418,48542418
41520,0,1793700,1,13,29,2,418,48542418
41521,223,1793600,2,13,29,2,641,48542641
41522,129,1793500,1,13,29,2,770,48542770
41523,297,1793500,3,13,29,3,67,48543067
41524,637,1793700,1,13,29,3,704,48543704
41525,14,1793700,4,13,29,3,718,48543718
41527,327,1793600,1,13,29,4,45,48544045
41528,1,1793600,1,13,29,4,46,48544046
41529,514,1793700,1,13,29,4,560,48544560
41530,100,1793700,1,13,29,4,660,48544660
41531,561,1793700,4,13,29,5,221,48545221
41533,522,1793600,2,13,29,5,743,48545743
41534,0,1793600,2,13,29,5,743,48545743
41535,0,1793600,2,13,29,5,743,48545743
41536,0,1793600,2,13,29,5,743,48545743
41538,51,1793800,3,13,29,5,794,48545794
41539,50,1793900,10,13,29,5,844,48545844
41540,237,1793900,1,13,29,6,81,48546081
41541,0,1793900,3,13,29,6,81,48546081
41542,0,1793900,1,13,29,6,81,48546081
41543,41,1793900,2,13,29,6,122,48546122
41544,0,1793900,1,13,29,6,122,48546122
41545,40,1793900,2,13,29,6,162,48546162
41546,38,1793900,1,13,29,6,200,48546200
41548,61,1793800,6,13,29,6,261,48546261
41550,539,1793800,1,13,29,6,800,48546800
41551,229,1793900,1,13,29,7,29,48547029
41552,1149,1793900,1,13,29,8,178,48548178
41553,108,1793900,1,13,29,8,286,48548286
41554,162,1793800,1,13,29,8,448,48548448
41555,536,1793900,1,13,29,8,984,48548984
41556,103,1793900,2,13,29,9,87,48549087
41557,587,1793800,1,13,29,9,674,48549674
41558,238,1793800,1,13,29,9,912,48549912
41560,17,1793900,2,13,29,9,929,48549929
41562,2,1794000,9,13,29,9,931,48549931
41563,155,1794100,1,13,29,10,86,48550086
41564,18,1794100,1,13,29,10,104,48550104
41565,26,1794100,5,13,29,10,130,48550130
41566,17,1794100,1,13,29,10,147,48550147
41567,5,1794000,1,13,29,10,152,48550152
41568,2,1794100,5,13,29,10,154,48550154
41569,1,1794100,1,13,29,10,155,48550155
41570,62,1794100,1,13,29,10,217,48550217
41572,35,1794100,3,13,29,10,252,48550252
41573,27,1794100,1,13,29,10,279,48550279
41574,45,1794100,1,13,29,10,324,48550324
41575,34,1794000,1,13,29,10,358,48550358
41576,177,1794200,1,13,29,10,535,48550535
41577,101,1794200,1,13,29,10,636,48550636
41578,146,1794000,1,13,29,10,782,48550782
41579,8,1794200,1,13,29,10,790,48550790
41580,151,1794200,3,13,29,10,941,48550941
41581,130,1794100,1,13,29,11,71,48551071
41582,602,1794200,1,13,29,11,673,48551673
41583,0,1794200,8,13,29,11,673,48551673
41584,1,1794200,1,13,29,11,674,48551674
41585,0,1794200,2,13,29,11,674,48551674
41586,345,1794100,1,13,29,12,19,48552019
41587,381,1794200,1,13,29,12,400,48552400
41588,683,1794200,1,13,29,13,83,48553083
41589,417,1794300,2,13,29,13,500,48553500
41590,366,1794300,5,13,29,13,866,48553866
41591,62,1794300,1,13,29,13,928,48553928
41592,150,1794300,1,13,29,14,78,48554078
41593,233,1794200,2,13,29,14,311,48554311
41594,9,1794200,1,13,29,14,320,48554320
41595,21,1794300,1,13,29,14,341,48554341
41596,865,1794300,2,13,29,15,206,48555206
41597,18,1794300,1,13,29,15,224,48555224
41598,152,1794300,1,13,29,15,376,48555376
41599,134,1794200,1,13,29,15,510,48555510
41600,232,1794200,1,13,29,15,742,48555742
41601,288,1794200,3,13,29,16,30,48556030
41602,653,1794100,5,13,29,16,683,48556683
41603,397,1794100,1,13,29,17,80,48557080
41604,528,1794000,5,13,29,17,608,48557608
41605,963,1794000,1,13,29,18,571,48558571
41606,466,1794000,1,13,29,19,37,48559037
41607,2062,1794000,2,13,29,21,99,48561099
41608,1302,1794000,4,13,29,22,401,48562401
41609,1223,1794100,1,13,29,23,624,48563624
41610,646,1794000,2,13,29,24,270,48564270
41611,20,1794000,2,13,29,24,290,48564290
41612,1190,1794100,1,13,29,25,480,48565480
41613,621,1794100,16,13,29,26,101,48566101
41615,2,1794200,2,13,29,26,103,48566103
41616,511,1794300,3,13,29,26,614,48566614
41617,117,1794200,5,13,29,26,731,48566731
41618,289,1794200,1,13,29,27,20,48567020
41619,166,1794300,3,13,29,27,186,48567186
41620,816,1794200,1,13,29,28,2,48568002
41621,1029,1794300,1,13,29,29,31,48569031
41622,360,1794200,2,13,29,29,391,48569391
41623,0,1794300,1,13,29,29,391,48569391
41624,631,1794300,1,13,29,30,22,48570022
41625,1,1794300,4,13,29,30,23,48570023
41626,528,1794300,3,13,29,30,551,48570551
41627,420,1794300,2,13,29,30,971,48570971
41628,606,1794300,2,13,29,31,577,48571577
41629,1058,1794300,1,13,29,32,635,48572635
41630,681,1794300,8,13,29,33,316,48573316
41631,2466,1794300,1,13,29,35,782,48575782
41632,1102,1794300,1,13,29,36,884,48576884
41633,1140,1794400,2,13,29,38,24,48578024
41634,59,1794400,1,13,29,38,83,48578083
41635,0,1794400,1,13,29,38,83,48578083
41636,1,1794300,4,13,29,38,84,48578084
41637,19,1794400,1,13,29,38,103,48578103
41638,401,1794300,3,13,29,38,504,48578504
41640,907,1794400,23,13,29,39,411,48579411
41642,2,1794500,1,13,29,39,413,48579413
41643,132,1794500,1,13,29,39,545,48579545
41644,2,1794500,1,13,29,39,547,48579547
41645,82,1794400,1,13,29,39,629,48579629
41646,443,1794500,2,13,29,40,72,48580072
41647,221,1794500,1,13,29,40,293,48580293
41648,125,1794500,2,13,29,40,418,48580418
41649,125,1794300,1,13,29,40,543,48580543
41650,3529,1794400,2,13,29,44,72,48584072
41651,50,1794400,1,13,29,44,122,48584122
41652,1098,1794500,1,13,29,45,220,48585220
41653,161,1794500,2,13,29,45,381,48585381
41654,166,1794500,1,13,29,45,547,48585547
41655,378,1794500,4,13,29,45,925,48585925
41656,78,1794600,1,13,29,46,3,48586003
41657,1,1794600,1,13,29,46,4,48586004
41658,0,1794600,1,13,29,46,4,48586004
41659,0,1794600,1,13,29,46,4,48586004
41660,0,1794600,6,13,29,46,4,48586004
41661,0,1794600,1,13,29,46,4,48586004
41662,0,1794600,9,13,29,46,4,48586004
41663,1,1794600,1,13,29,46,5,48586005
41664,0,1794600,1,13,29,46,5,48586005
41665,0,1794600,1,13,29,46,5,48586005
41666,0,1794600,1,13,29,46,5,48586005
41667,385,1794600,2,13,29,46,390,48586390
41668,190,1794600,5,13,29,46,580,48586580
41669,183,1794600,1,13,29,46,763,48586763
41670,33,1794600,2,13,29,46,796,48586796
41671,247,1794600,2,13,29,47,43,48587043
41672,797,1794700,2,13,29,47,840,48587840
41673,57,1794700,19,13,29,47,897,48587897
41674,90,1794700,1,13,29,47,987,48587987
41675,57,1794700,2,13,29,48,44,48588044
41676,250,1794700,2,13,29,48,294,48588294
41677,126,1794700,2,13,29,48,420,48588420
41678,1536,1794800,4,13,29,49,956,48589956
41679,92,1794800,1,13,29,50,48,48590048
41680,260,1794700,1,13,29,50,308,48590308
41681,378,1794700,1,13,29,50,686,48590686
41682,163,1794800,1,13,29,50,849,48590849
41683,230,1794700,1,13,29,51,79,48591079
41684,526,1794700,1,13,29,51,605,48591605
41685,94,1794700,2,13,29,51,699,48591699
41686,0,1794700,7,13,29,51,699,48591699
41687,0,1794700,3,13,29,51,699,48591699
41688,0,1794700,4,13,29,51,699,48591699
41689,0,1794700,1,13,29,51,699,48591699
41690,57,1794700,1,13,29,51,756,48591756
41692,1,1794800,12,13,29,51,757,48591757
41694,166,1794800,1,13,29,51,923,48591923
41695,83,1794800,1,13,29,52,6,48592006
41696,420,1794800,4,13,29,52,426,48592426
41698,171,1794800,1,13,29,52,597,48592597
41699,144,1794800,3,13,29,52,741,48592741
41701,192,1794900,1,13,29,52,933,48592933
41702,416,1794900,1,13,29,53,349,48593349
41703,53,1794900,1,13,29,53,402,48593402
41704,88,1794900,18,13,29,53,490,48593490
41705,31,1795000,1,13,29,53,521,48593521
41706,36,1794900,10,13,29,53,557,48593557
41707,111,1794900,1,13,29,53,668,48593668
41708,97,1795000,1,13,29,53,765,48593765
41709,15,1795000,1,13,29,53,780,48593780
41710,9,1794900,1,13,29,53,789,48593789
41712,213,1794900,1,13,29,54,2,48594002
41713,38,1794900,1,13,29,54,40,48594040
41714,1,1794900,1,13,29,54,41,48594041
41715,163,1794900,1,13,29,54,204,48594204
41716,25,1794900,1,13,29,54,229,48594229
41717,1,1794900,1,13,29,54,230,48594230
41718,825,1794900,1,13,29,55,55,48595055
41719,19,1794900,1,13,29,55,74,48595074
41720,84,1794900,3,13,29,55,158,48595158
41721,63,1795000,1,13,29,55,221,48595221
41722,526,1794800,1,13,29,55,747,48595747
41723,151,1795000,18,13,29,55,898,48595898
41724,0,1795000,18,13,29,55,898,48595898
41726,87,1795000,1,13,29,55,985,48595985
41727,3,1795100,1,13,29,55,988,48595988
41728,56,1795100,1,13,29,56,44,48596044
41729,3,1795100,1,13,29,56,47,48596047
41730,3,1795100,1,13,29,56,50,48596050
41731,34,1795100,1,13,29,56,84,48596084
41732,78,1795100,1,13,29,56,162,48596162
41733,64,1795100,2,13,29,56,226,48596226
41734,587,1795000,1,13,29,56,813,48596813
41735,71,1795100,2,13,29,56,884,48596884
41736,27,1794900,1,13,29,56,911,48596911
41737,66,1795000,1,13,29,56,977,48596977
41738,23,1794900,1,13,29,57,0,48597000
41740,176,1794900,1,13,29,57,176,48597176
41741,588,1794900,1,13,29,57,764,48597764
41742,88,1794900,1,13,29,57,852,48597852
41743,72,1794900,1,13,29,57,924,48597924
41744,502,1794900,1,13,29,58,426,48598426
41745,796,1794800,3,13,29,59,222,48599222
41747,136,1794800,1,13,29,59,358,48599358
41748,767,1794800,1,13,30,0,125,48600125
41749,175,1794600,1,13,30,0,300,48600300
41750,4,1794800,1,13,30,0,304,48600304
41751,1,1794600,1,13,30,0,305,48600305
41752,12,1794800,2,13,30,0,317,48600317
41753,21,1794800,1,13,30,0,338,48600338
41754,48,1794800,2,13,30,0,386,48600386
41755,197,1794800,2,13,30,0,583,48600583
41756,32,1794600,1,13,30,0,615,48600615
41757,212,1794800,8,13,30,0,827,48600827
41759,308,1794900,1,13,30,1,135,48601135
41760,91,1794900,1,13,30,1,226,48601226
41761,226,1794700,1,13,30,1,452,48601452
41762,95,1794900,8,13,30,1,547,48601547
41763,1,1794900,7,13,30,1,548,48601548
41765,52,1794800,1,13,30,1,600,48601600
41766,101,1795000,1,13,30,1,701,48601701
41767,39,1794800,1,13,30,1,740,48601740
41768,432,1795000,2,13,30,2,172,48602172
41769,38,1795000,2,13,30,2,210,48602210
41770,1,1795000,6,13,30,2,211,48602211
41771,1,1795000,2,13,30,2,212,48602212
41772,213,1795100,1,13,30,2,425,48602425
41773,121,1795100,2,13,30,2,546,48602546
41774,54,1795100,1,13,30,2,600,48602600
41775,14,1795100,1,13,30,2,614,48602614
41776,216,1795000,1,13,30,2,830,48602830
41777,691,1795100,1,13,30,3,521,48603521
41778,17,1795200,1,13,30,3,538,48603538
41779,98,1795200,1,13,30,3,636,48603636
41780,59,1795200,1,13,30,3,695,48603695
41781,163,1795200,9,13,30,3,858,48603858
41782,59,1795100,1,13,30,3,917,48603917
41783,20,1795100,2,13,30,3,937,48603937
41784,225,1795300,1,13,30,4,162,48604162
41785,68,1795300,2,13,30,4,230,48604230
41786,0,1795300,2,13,30,4,230,48604230
41787,23,1795300,1,13,30,4,253,48604253
41788,30,1795300,2,13,30,4,283,48604283
41789,85,1795300,2,13,30,4,368,48604368
41790,77,1795200,1,13,30,4,445,48604445
41791,49,1795300,2,13,30,4,494,48604494
41793,236,1795400,1,13,30,4,730,48604730
41794,14,1795400,1,13,30,4,744,48604744
41795,201,1795200,3,13,30,4,945,48604945
41796,196,1795400,1,13,30,5,141,48605141
41797,183,1795400,13,13,30,5,324,48605324
41798,210,1795500,1,13,30,5,534,48605534
41799,68,1795500,3,13,30,5,602,48605602
41800,19,1795500,2,13,30,5,621,48605621
41801,77,1795400,1,13,30,5,698,48605698
41802,28,1795400,1,13,30,5,726,48605726
41803,0,1795400,1,13,30,5,726,48605726
41804,22,1795400,1,13,30,5,748,48605748
41806,22,1795300,1,13,30,5,770,48605770
41807,298,1795400,1,13,30,6,68,48606068
41808,54,1795500,9,13,30,6,122,48606122
41809,21,1795500,1,13,30,6,143,48606143
41810,86,1795400,1,13,30,6,229,48606229
41812,390,1795200,2,13,30,6,619,48606619
41813,101,1795200,5,13,30,6,720,48606720
41814,227,1795300,1,13,30,6,947,48606947
41815,198,1795300,1,13,30,7,145,48607145
41816,39,1795300,1,13,30,7,184,48607184
41817,26,1795300,2,13,30,7,210,48607210
41818,15,1795300,1,13,30,7,225,48607225
41819,120,1795100,1,13,30,7,345,48607345
41820,148,1795200,3,13,30,7,493,48607493
41821,589,1795100,3,13,30,8,82,48608082
41822,0,1795100,1,13,30,8,82,48608082
41823,78,1795200,1,13,30,8,160,48608160
41824,199,1795200,2,13,30,8,359,48608359
41825,318,1795100,1,13,30,8,677,48608677
41826,181,1795000,2,13,30,8,858,48608858
41827,545,1795100,1,13,30,9,403,48609403
41828,78,1795100,1,13,30,9,481,48609481
41829,54,1795100,1,13,30,9,535,48609535
41830,10,1795100,1,13,30,9,545,48609545
41831,291,1795100,3,13,30,9,836,48609836
41832,179,1795000,1,13,30,10,15,48610015
41833,24,1795000,1,13,30,10,39,48610039
41834,147,1795100,1,13,30,10,186,48610186
41835,7,1795100,2,13,30,10,193,48610193
41836,158,1794900,2,13,30,10,351,48610351
41837,84,1795100,13,13,30,10,435,48610435
41838,0,1795100,13,13,30,10,435,48610435
41840,10,1795100,1,13,30,10,445,48610445
41841,300,1795000,1,13,30,10,745,48610745
41842,313,1794900,1,13,30,11,58,48611058
41843,1,1794900,2,13,30,11,59,48611059
41844,111,1795000,1,13,30,11,170,48611170
41845,366,1795000,1,13,30,11,536,48611536
41846,641,1795000,1,13,30,12,177,48612177
41847,219,1794900,1,13,30,12,396,48612396
41848,8,1794800,3,13,30,12,404,48612404
41849,111,1794900,1,13,30,12,515,48612515
41850,651,1794900,1,13,30,13,166,48613166
41851,375,1794900,5,13,30,13,541,48613541
41853,551,1794800,1,13,30,14,92,48614092
41854,82,1795000,1,13,30,14,174,48614174
41855,234,1795000,1,13,30,14,408,48614408
41856,754,1795000,1,13,30,15,162,48615162
41857,558,1795000,1,13,30,15,720,48615720
41858,452,1795000,1,13,30,16,172,48616172
41859,183,1795000,2,13,30,16,355,48616355
41860,1,1795000,2,13,30,16,356,48616356
41861,37,1794900,1,13,30,16,393,48616393
41862,307,1795000,2,13,30,16,700,48616700
41863,299,1794900,1,13,30,16,999,48616999
41864,128,1795100,1,13,30,17,127,48617127
41865,54,1795100,1,13,30,17,181,48617181
41866,45,1795100,1,13,30,17,226,48617226
41867,18,1795100,1,13,30,17,244,48617244
41868,960,1794900,1,13,30,18,204,48618204
41869,2,1795000,1,13,30,18,206,48618206
41870,98,1795100,1,13,30,18,304,48618304
41871,372,1795000,1,13,30,18,676,48618676
41872,504,1795100,1,13,30,19,180,48619180
41873,85,1795000,1,13,30,19,265,48619265
41874,632,1795100,1,13,30,19,897,48619897
41875,160,1795100,1,13,30,20,57,48620057
41876,0,1795100,1,13,30,20,57,48620057
41878,131,1795100,1,13,30,20,188,48620188
41879,86,1795000,1,13,30,20,274,48620274
41880,201,1795100,1,13,30,20,475,48620475
41881,188,1794900,1,13,30,20,663,48620663
41882,72,1795000,1,13,30,20,735,48620735
41884,482,1795000,1,13,30,21,217,48621217
41885,536,1795100,1,13,30,21,753,48621753
41886,346,1795100,3,13,30,22,99,48622099
41887,155,1795200,5,13,30,22,254,48622254
41888,545,1795200,1,13,30,22,799,48622799
41889,92,1795100,1,13,30,22,891,48622891
41890,316,1795200,1,13,30,23,207,48623207
41891,232,1795200,3,13,30,23,439,48623439
41892,0,1795200,3,13,30,23,439,48623439
41893,1,1795200,1,13,30,23,440,48623440
41894,1,1795200,1,13,30,23,441,48623441
41895,375,1795100,1,13,30,23,816,48623816
41896,290,1795100,2,13,30,24,106,48624106
41897,181,1795200,1,13,30,24,287,48624287
41898,167,1795100,1,13,30,24,454,48624454
41899,593,1795100,1,13,30,25,47,48625047
41901,196,1795200,2,13,30,25,243,48625243
41902,180,1795200,1,13,30,25,423,48625423
41903,448,1795200,1,13,30,25,871,48625871
41904,60,1795200,4,13,30,25,931,48625931
41905,68,1795100,1,13,30,25,999,48625999
41906,0,1795100,1,13,30,25,999,48625999
41908,147,1795000,2,13,30,26,146,48626146
41909,86,1795200,1,13,30,26,232,48626232
41910,302,1795000,2,13,30,26,534,48626534
41912,217,1795000,1,13,30,26,751,48626751
41913,1,1795100,3,13,30,26,752,48626752
41914,21,1795000,1,13,30,26,773,48626773
41915,181,1795000,2,13,30,26,954,48626954
41917,201,1794900,1,13,30,27,155,48627155
41918,55,1795000,1,13,30,27,210,48627210
41919,17,1795000,1,13,30,27,227,48627227
41920,190,1794900,7,13,30,27,417,48627417
41921,0,1794900,2,13,30,27,417,48627417
41922,0,1794900,1,13,30,27,417,48627417
41923,19,1794900,1,13,30,27,436,48627436
41924,569,1794900,7,13,30,28,5,48628005
41926,263,1795100,1,13,30,28,268,48628268
41927,26,1794900,1,13,30,28,294,48628294
41928,298,1795000,1,13,30,28,592,48628592
41929,155,1794900,3,13,30,28,747,48628747
41930,523,1795100,1,13,30,29,270,48629270
41931,208,1795100,1,13,30,29,478,48629478
41932,399,1795100,2,13,30,29,877,48629877
41933,134,1795100,1,13,30,30,11,48630011
41934,248,1795100,1,13,30,30,259,48630259
41935,28,1795200,3,13,30,30,287,48630287
41936,147,1795300,2,13,30,30,434,48630434
41937,68,1795300,1,13,30,30,502,48630502
41938,117,1795200,1,13,30,30,619,48630619
41939,619,1795300,1,13,30,31,238,48631238
41940,687,1795100,3,13,30,31,925,48631925
41941,1,1795200,5,13,30,31,926,48631926
41942,79,1795100,1,13,30,32,5,48632005
41943,90,1795300,1,13,30,32,95,48632095
41944,25,1795300,1,13,30,32,120,48632120
41945,144,1795300,1,13,30,32,264,48632264
41946,958,1795300,1,13,30,33,222,48633222
41947,11,1795200,2,13,30,33,233,48633233
41948,232,1795300,1,13,30,33,465,48633465
41949,56,1795300,1,13,30,33,521,48633521
41950,10,1795100,3,13,30,33,531,48633531
41952,90,1795000,1,13,30,33,621,48633621
41953,25,1795100,2,13,30,33,646,48633646
41954,346,1795200,2,13,30,33,992,48633992
41955,14,1795000,1,13,30,34,6,48634006
41956,13,1795200,2,13,30,34,19,48634019
41957,215,1795200,2,13,30,34,234,48634234
41958,0,1795200,3,13,30,34,234,48634234
41959,2,1795300,1,13,30,34,236,48634236
41960,44,1795100,1,13,30,34,280,48634280
41961,28,1795300,1,13,30,34,308,48634308
41962,632,1795100,1,13,30,34,940,48634940
41963,19,1795200,1,13,30,34,959,48634959
41964,272,1795200,1,13,30,35,231,48635231
41965,0,1795200,2,13,30,35,231,48635231
41966,664,1795100,1,13,30,35,895,48635895
41967,225,1795200,1,13,30,36,120,48636120
41968,215,1795200,1,13,30,36,335,48636335
41969,79,1795100,1,13,30,36,414,48636414
41970,368,1795100,1,13,30,36,782,48636782
41971,476,1795100,2,13,30,37,258,48637258
41973,50,1795200,1,13,30,37,308,48637308
41974,228,1795200,5,13,30,37,536,48637536
41975,481,1795000,2,13,30,38,17,48638017
41976,211,1795200,1,13,30,38,228,48638228
41977,1085,1795200,1,13,30,39,313,48639313
41978,2,1795200,1,13,30,39,315,48639315
41979,416,1795100,1,13,30,39,731,48639731
41980,306,1795200,2,13,30,40,37,48640037
41982,223,1795300,5,13,30,40,260,48640260
41983,6,1795400,1,13,30,40,266,48640266
41984,7,1795400,1,13,30,40,273,48640273
41985,43,1795200,1,13,30,40,316,48640316
41987,1,1795300,3,13,30,40,317,48640317
41988,25,1795400,2,13,30,40,342,48640342
41989,51,1795400,1,13,30,40,393,48640393
41990,168,1795200,1,13,30,40,561,48640561
41991,672,1795200,9,13,30,41,233,48641233
41992,19,1795200,1,13,30,41,252,48641252
41993,803,1795100,2,13,30,42,55,48642055
41994,201,1795200,1,13,30,42,256,48642256
41995,303,1795100,1,13,30,42,559,48642559
41996,693,1795200,1,13,30,43,252,48643252
41997,534,1795200,4,13,30,43,786,48643786
41998,484,1795300,1,13,30,44,270,48644270
41999,436,1795300,1,13,30,44,706,48644706
42000,26,1795200,2,13,30,44,732,48644732
42001,269,1795200,6,13,30,45,1,48645001
42002,109,1795300,3,13,30,45,110,48645110
42003,149,1795400,1,13,30,45,259,48645259
42004,151,1795300,2,13,30,45,410,48645410
42006,1,1795400,3,13,30,45,411,48645411
42007,845,1795300,1,13,30,46,256,48646256
42008,383,1795200,1,13,30,46,639,48646639
42009,0,1795300,6,13,30,46,639,48646639
42010,441,1795200,1,13,30,47,80,48647080
42011,180,1795300,1,13,30,47,260,48647260
42012,1407,1795300,1,13,30,48,667,48648667
42013,476,1795300,1,13,30,49,143,48649143
42014,204,1795300,1,13,30,49,347,48649347
42015,0,1795300,1,13,30,49,347,48649347
42016,56,1795200,5,13,30,49,403,48649403
42017,102,1795200,5,13,30,49,505,48649505
42018,202,1795300,1,13,30,49,707,48649707
42019,402,1795200,1,13,30,50,109,48650109
42020,163,1795300,1,13,30,50,272,48650272
42021,986,1795300,1,13,30,51,258,48651258
42022,42,1795300,2,13,30,51,300,48651300
42023,235,1795200,1,13,30,51,535,48651535
42024,202,1795200,2,13,30,51,737,48651737
42025,0,1795200,5,13,30,51,737,48651737
42026,534,1795200,1,13,30,52,271,48652271
42027,1017,1795300,1,13,30,53,288,48653288
42028,993,1795300,1,13,30,54,281,48654281
42029,86,1795300,1,13,30,54,367,48654367
42030,467,1795300,2,13,30,54,834,48654834
42031,0,1795300,1,13,30,54,834,48654834
42032,0,1795300,2,13,30,54,834,48654834
42033,441,1795400,1,13,30,55,275,48655275
42034,2,1795400,28,13,30,55,277,48655277
42035,1,1795500,2,13,30,55,278,48655278
42036,0,1795500,1,13,30,55,278,48655278
42037,0,1795500,1,13,30,55,278,48655278
42038,0,1795500,1,13,30,55,278,48655278
42039,1,1795500,1,13,30,55,279,48655279
42040,0,1795500,1,13,30,55,279,48655279
42041,0,1795500,1,13,30,55,279,48655279
42042,0,1795500,1,13,30,55,279,48655279
42043,0,1795500,2,13,30,55,279,48655279
42044,0,1795500,1,13,30,55,279,48655279
42045,0,1795500,5,13,30,55,279,48655279
42046,139,1795500,2,13,30,55,418,48655418
42047,126,1795400,2,13,30,55,544,48655544
42048,124,1795400,2,13,30,55,668,48655668
42049,126,1795400,2,13,30,55,794,48655794
42050,35,1795300,1,13,30,55,829,48655829
42051,83,1795500,1,13,30,55,912,48655912
42052,12,1795600,1,13,30,55,924,48655924
42053,47,1795600,2,13,30,55,971,48655971
42054,44,1795600,1,13,30,56,15,48656015
42055,188,1795400,1,13,30,56,203,48656203
42056,85,1795600,1,13,30,56,288,48656288
42057,940,1795400,3,13,30,57,228,48657228
42058,49,1795500,1,13,30,57,277,48657277
42059,0,1795600,1,13,30,57,277,48657277
42060,1016,1795600,1,13,30,58,293,48658293
42061,482,1795600,2,13,30,58,775,48658775
42062,454,1795600,1,13,30,59,229,48659229
42063,96,1795500,3,13,30,59,325,48659325
42064,18,1795600,1,13,30,59,343,48659343
42065,202,1795600,1,13,30,59,545,48659545
42066,353,1795400,6,13,30,59,898,48659898
42068,250,1795500,3,13,31,0,148,48660148
42069,120,1795500,1,13,31,0,268,48660268
42070,92,1795600,3,13,31,0,360,48660360
42071,10,1795600,1,13,31,0,370,48660370
42072,118,1795500,1,13,31,0,488,48660488
42073,26,1795500,1,13,31,0,514,48660514
42074,62,1795400,2,13,31,0,576,48660576
42076,69,1795400,1,13,31,0,645,48660645
42077,63,1795500,1,13,31,0,708,48660708
42078,88,1795400,1,13,31,0,796,48660796
42079,111,1795500,1,13,31,0,907,48660907
42080,174,1795500,1,13,31,1,81,48661081
42081,169,1795400,1,13,31,1,250,48661250
42082,56,1795600,1,13,31,1,306,48661306
42083,62,1795600,2,13,31,1,368,48661368
42084,845,1795600,1,13,31,2,213,48662213
42085,37,1795600,3,13,31,2,250,48662250
42086,31,1795600,2,13,31,2,281,48662281
42088,98,1795700,1,13,31,2,379,48662379
42089,0,1795700,4,13,31,2,379,48662379
42090,3,1795600,1,13,31,2,382,48662382
42091,16,1795600,1,13,31,2,398,48662398
42092,120,1795700,1,13,31,2,518,48662518
42093,12,1795700,1,13,31,2,530,48662530
42094,11,1795700,7,13,31,2,541,48662541
42095,21,1795700,1,13,31,2,562,48662562
42096,50,1795700,1,13,31,2,612,48662612
42097,1,1795700,3,13,31,2,613,48662613
42098,0,1795700,5,13,31,2,613,48662613
42099,1,1795800,1,13,31,2,614,48662614
42100,140,1795800,4,13,31,2,754,48662754
42101,0,1795800,8,13,31,2,754,48662754
42102,844,1795900,1,13,31,3,598,48663598
42103,65,1795900,2,13,31,3,663,48663663
42104,642,1795900,1,13,31,4,305,48664305
42105,499,1795900,2,13,31,4,804,48664804
42106,509,1795900,1,13,31,5,313,48665313
42107,48,1795900,1,13,31,5,361,48665361
42108,949,1795900,1,13,31,6,310,48666310
42109,179,1795900,1,13,31,6,489,48666489
42110,159,1795900,7,13,31,6,648,48666648
42111,12,1795900,1,13,31,6,660,48666660
42112,0,1796000,26,13,31,6,660,48666660
42113,0,1795900,2,13,31,6,660,48666660
42114,1,1796000,1,13,31,6,661,48666661
42115,0,1796000,1,13,31,6,661,48666661
42116,11,1796100,5,13,31,6,672,48666672
42117,79,1796000,1,13,31,6,751,48666751
42118,1,1796000,1,13,31,6,752,48666752
42119,7,1796100,2,13,31,6,759,48666759
42121,8,1796200,2,13,31,6,767,48666767
42122,142,1796200,1,13,31,6,909,48666909
42123,31,1796200,1,13,31,6,940,48666940
42124,139,1796100,4,13,31,7,79,48667079
42126,22,1796200,1,13,31,7,101,48667101
42127,0,1796200,1,13,31,7,101,48667101
42128,7,1796000,1,13,31,7,108,48667108
42129,33,1796200,1,13,31,7,141,48667141
42130,32,1796200,1,13,31,7,173,48667173
42131,31,1796200,2,13,31,7,204,48667204
42132,29,1796200,1,13,31,7,233,48667233
42133,138,1796100,1,13,31,7,371,48667371
42134,260,1796100,1,13,31,7,631,48667631
42135,31,1796100,1,13,31,7,662,48667662
42136,43,1796100,1,13,31,7,705,48667705
42137,59,1796100,1,13,31,7,764,48667764
42138,13,1796100,1,13,31,7,777,48667777
42139,180,1796100,3,13,31,7,957,48667957
42140,250,1796100,1,13,31,8,207,48668207
42141,33,1796200,1,13,31,8,240,48668240
42142,82,1796200,1,13,31,8,322,48668322
42143,256,1796200,1,13,31,8,578,48668578
42144,77,1796100,1,13,31,8,655,48668655
42145,448,1796200,1,13,31,9,103,48669103
42146,210,1796200,1,13,31,9,313,48669313
42147,17,1796200,1,13,31,9,330,48669330
42148,88,1796200,1,13,31,9,418,48669418
42149,38,1796200,1,13,31,9,456,48669456
42150,229,1796100,1,13,31,9,685,48669685
42151,73,1796200,1,13,31,9,758,48669758
42152,205,1796200,2,13,31,9,963,48669963
42153,12,1796200,1,13,31,9,975,48669975
42154,63,1796200,1,13,31,10,38,48670038
42155,97,1796200,2,13,31,10,135,48670135
42156,151,1796200,2,13,31,10,286,48670286
42157,57,1796200,1,13,31,10,343,48670343
42158,17,1796200,3,13,31,10,360,48670360
42159,0,1796300,8,13,31,10,360,48670360
42160,1,1796300,1,13,31,10,361,48670361
42161,19,1796400,1,13,31,10,380,48670380
42162,0,1796400,4,13,31,10,380,48670380
42163,1,1796400,1,13,31,10,381,48670381
42164,0,1796400,4,13,31,10,381,48670381
42165,125,1796500,1,13,31,10,506,48670506
42166,98,1796500,1,13,31,10,604,48670604
42167,61,1796500,1,13,31,10,665,48670665
42168,209,1796500,1,13,31,10,874,48670874
42169,140,1796400,1,13,31,11,14,48671014
42170,5,1796300,1,13,31,11,19,48671019
42171,33,1796500,1,13,31,11,52,48671052
42172,45,1796400,1,13,31,11,97,48671097
42173,146,1796500,2,13,31,11,243,48671243
42174,62,1796500,2,13,31,11,305,48671305
42175,87,1796500,1,13,31,11,392,48671392
42176,60,1796500,1,13,31,11,452,48671452
42178,52,1796400,3,13,31,11,504,48671504
42179,0,1796400,7,13,31,11,504,48671504
42180,9,1796400,2,13,31,11,513,48671513
42181,9,1796600,1,13,31,11,522,48671522
42182,10,1796600,2,13,31,11,532,48671532
42183,24,1796600,1,13,31,11,556,48671556
42184,10,1796600,1,13,31,11,566,48671566
42185,24,1796600,4,13,31,11,590,48671590
42187,52,1796700,2,13,31,11,642,48671642
42188,93,1796500,1,13,31,11,735,48671735
42189,23,1796500,1,13,31,11,758,48671758
42190,63,1796400,2,13,31,11,821,48671821
42192,62,1796500,1,13,31,11,883,48671883
42193,173,1796500,1,13,31,12,56,48672056
42194,20,1796400,1,13,31,12,76,48672076
42195,5,1796300,1,13,31,12,81,48672081
42196,256,1796500,1,13,31,12,337,48672337
42197,30,1796500,1,13,31,12,367,48672367
42198,36,1796400,1,13,31,12,403,48672403
42199,421,1796400,4,13,31,12,824,48672824
42200,318,1796500,2,13,31,13,142,48673142
42201,196,1796500,1,13,31,13,338,48673338
42202,70,1796400,1,13,31,13,408,48673408
42203,118,1796400,3,13,31,13,526,48673526
42204,87,1796300,1,13,31,13,613,48673613
42205,3,1796400,1,13,31,13,616,48673616
42206,315,1796400,1,13,31,13,931,48673931
42207,373,1796400,2,13,31,14,304,48674304
42208,27,1796500,1,13,31,14,331,48674331
42209,21,1796500,1,13,31,14,352,48674352
42210,14,1796500,7,13,31,14,366,48674366
42211,0,1796500,10,13,31,14,366,48674366
42212,1,1796600,8,13,31,14,367,48674367
42213,7,1796500,3,13,31,14,374,48674374
42214,360,1796500,1,13,31,14,734,48674734
42215,83,1796600,1,13,31,14,817,48674817
42216,47,1796600,1,13,31,14,864,48674864
42217,177,1796700,1,13,31,15,41,48675041
42218,13,1796600,1,13,31,15,54,48675054
42219,92,1796700,1,13,31,15,146,48675146
42220,124,1796500,1,13,31,15,270,48675270
42221,129,1796700,1,13,31,15,399,48675399
42222,77,1796700,5,13,31,15,476,48675476
42223,415,1796500,1,13,31,15,891,48675891
42224,392,1796500,3,13,31,16,283,48676283
42225,126,1796500,1,13,31,16,409,48676409
42226,713,1796500,1,13,31,17,122,48677122
42227,92,1796500,5,13,31,17,214,48677214
42229,191,1796500,2,13,31,17,405,48677405
42230,95,1796500,1,13,31,17,500,48677500
42231,27,1796500,1,13,31,17,527,48677527
42232,14,1796500,5,13,31,17,541,48677541
42233,24,1796500,1,13,31,17,565,48677565
42234,13,1796500,1,13,31,17,578,48677578
42235,76,1796600,1,13,31,17,654,48677654
42236,11,1796500,1,13,31,17,665,48677665
42237,220,1796600,1,13,31,17,885,48677885
42238,222,1796600,3,13,31,18,107,48678107
42240,47,1796500,1,13,31,18,154,48678154
42241,16,1796500,1,13,31,18,170,48678170
42242,50,1796700,5,13,31,18,220,48678220
42243,135,1796700,1,13,31,18,355,48678355
42244,243,1796600,1,13,31,18,598,48678598
42245,349,1796600,4,13,31,18,947,48678947
42247,1,1796500,1,13,31,18,948,48678948
42248,150,1796600,4,13,31,19,98,48679098
42250,258,1796600,1,13,31,19,356,48679356
42251,50,1796700,1,13,31,19,406,48679406
42252,77,1796600,3,13,31,19,483,48679483
42254,105,1796700,1,13,31,19,588,48679588
42255,314,1796700,5,13,31,19,902,48679902
42256,158,1796700,3,13,31,20,60,48680060
42257,301,1796700,1,13,31,20,361,48680361
42258,481,1796600,1,13,31,20,842,48680842
42259,63,1796600,1,13,31,20,905,48680905
42260,61,1796500,2,13,31,20,966,48680966
42262,323,1796500,2,13,31,21,289,48681289
42263,98,1796500,1,13,31,21,387,48681387
42264,378,1796500,1,13,31,21,765,48681765
42265,71,1796500,1,13,31,21,836,48681836
42266,84,1796600,1,13,31,21,920,48681920
42267,48,1796600,1,13,31,21,968,48681968
42268,102,1796500,1,13,31,22,70,48682070
42269,2,1796500,1,13,31,22,72,48682072
42270,207,1796600,1,13,31,22,279,48682279
42271,40,1796600,2,13,31,22,319,48682319
42272,27,1796600,1,13,31,22,346,48682346
42273,51,1796600,1,13,31,22,397,48682397
42274,351,1796600,2,13,31,22,748,48682748
42275,268,1796600,2,13,31,23,16,48683016
42276,486,1796600,1,13,31,23,502,48683502
42277,9,1796500,1,13,31,23,511,48683511
42278,843,1796600,1,13,31,24,354,48684354
42279,68,1796500,1,13,31,24,422,48684422
42280,238,1796500,1,13,31,24,660,48684660
42281,107,1796500,1,13,31,24,767,48684767
42282,225,1796500,1,13,31,24,992,48684992
42283,16,1796500,2,13,31,25,8,48685008
42284,246,1796500,2,13,31,25,254,48685254
42285,126,1796500,1,13,31,25,380,48685380
42286,46,1796500,1,13,31,25,426,48685426
42287,377,1796500,1,13,31,25,803,48685803
42288,92,1796400,1,13,31,25,895,48685895
42289,153,1796500,1,13,31,26,48,48686048
42290,280,1796500,1,13,31,26,328,48686328
42291,50,1796500,1,13,31,26,378,48686378
42292,415,1796400,1,13,31,26,793,48686793
42293,125,1796400,1,13,31,26,918,48686918
42294,18,1796500,2,13,31,26,936,48686936
42295,37,1796500,2,13,31,26,973,48686973
42296,82,1796400,1,13,31,27,55,48687055
42297,0,1796400,7,13,31,27,55,48687055
42298,45,1796500,1,13,31,27,100,48687100
42299,213,1796500,1,13,31,27,313,48687313
42300,67,1796500,1,13,31,27,380,48687380
42301,258,1796500,3,13,31,27,638,48687638
42302,14,1796500,8,13,31,27,652,48687652
42303,1,1796600,1,13,31,27,653,48687653
42304,1,1796600,4,13,31,27,654,48687654
42305,0,1796600,1,13,31,27,654,48687654
42306,0,1796600,1,13,31,27,654,48687654
42307,0,1796600,1,13,31,27,654,48687654
42308,0,1796600,11,13,31,27,654,48687654
42309,0,1796600,8,13,31,27,654,48687654
42310,0,1796600,1,13,31,27,654,48687654
42311,0,1796600,1,13,31,27,654,48687654
42312,40,1796700,1,13,31,27,694,48687694
42313,98,1796600,2,13,31,27,792,48687792
42314,1,1796700,3,13,31,27,793,48687793
42315,141,1796600,4,13,31,27,934,48687934
42317,20,1796500,2,13,31,27,954,48687954
42318,470,1796600,1,13,31,28,424,48688424
42319,167,1796700,1,13,31,28,591,48688591
42320,9,1796700,1,13,31,28,600,48688600
42321,168,1796700,1,13,31,28,768,48688768
42322,0,1796700,1,13,31,28,768,48688768
42323,51,1796700,1,13,31,28,819,48688819
42324,5,1796800,2,13,31,28,824,48688824
42325,56,1796700,1,13,31,28,880,48688880
42326,475,1796700,1,13,31,29,355,48689355
42327,21,1796800,1,13,31,29,376,48689376
42328,700,1796700,2,13,31,30,76,48690076
42329,171,1796700,1,13,31,30,247,48690247
42330,222,1796800,1,13,31,30,469,48690469
42331,40,1796700,1,13,31,30,509,48690509
42332,60,1796700,1,13,31,30,569,48690569
42333,0,1796700,2,13,31,30,569,48690569
42334,181,1796600,1,13,31,30,750,48690750
42335,655,1796700,1,13,31,31,405,48691405
42336,114,1796700,2,13,31,31,519,48691519
42337,348,1796700,3,13,31,31,867,48691867
42338,142,1796600,4,13,31,32,9,48692009
42339,316,1796700,4,13,31,32,325,48692325
42340,85,1796700,1,13,31,32,410,48692410
42341,78,1796700,1,13,31,32,488,48692488
42342,142,1796500,5,13,31,32,630,48692630
42343,74,1796700,1,13,31,32,704,48692704
42344,65,1796700,3,13,31,32,769,48692769
42345,111,1796700,1,13,31,32,880,48692880
42346,72,1796600,1,13,31,32,952,48692952
42347,8,1796700,1,13,31,32,960,48692960
42348,99,1796700,4,13,31,33,59,48693059
42349,1,1796700,1,13,31,33,60,48693060
42350,231,1796700,1,13,31,33,291,48693291
42351,257,1796700,2,13,31,33,548,48693548
42352,0,1796700,1,13,31,33,548,48693548
42353,139,1796800,1,13,31,33,687,48693687
42354,18,1796700,3,13,31,33,705,48693705
42355,0,1796700,3,13,31,33,705,48693705
42357,133,1796500,2,13,31,33,838,48693838
42358,371,1796500,1,13,31,34,209,48694209
42359,184,1796600,1,13,31,34,393,48694393
42360,177,1796600,1,13,31,34,570,48694570
42361,313,1796700,1,13,31,34,883,48694883
42362,362,1796500,1,13,31,35,245,48695245
42363,162,1796600,1,13,31,35,407,48695407
42364,121,1796600,1,13,31,35,528,48695528
42365,380,1796600,1,13,31,35,908,48695908
42366,8,1796600,3,13,31,35,916,48695916
42367,36,1796600,3,13,31,35,952,48695952
42368,47,1796600,1,13,31,35,999,48695999
42369,361,1796700,1,13,31,36,360,48696360
42370,34,1796700,1,13,31,36,394,48696394
42371,26,1796700,1,13,31,36,420,48696420
42372,272,1796600,1,13,31,36,692,48696692
42373,102,1796600,3,13,31,36,794,48696794
42374,42,1796700,1,13,31,36,836,48696836
42375,325,1796600,2,13,31,37,161,48697161
42376,252,1796600,2,13,31,37,413,48697413
42378,1,1796600,1,13,31,37,414,48697414
42379,2,1796700,1,13,31,37,416,48697416
42380,7,1796700,1,13,31,37,423,48697423
42381,624,1796700,1,13,31,38,47,48698047
42382,393,1796700,1,13,31,38,440,48698440
42383,6,1796800,1,13,31,38,446,48698446
42384,66,1796700,1,13,31,38,512,48698512
42385,76,1796800,2,13,31,38,588,48698588
42386,68,1796800,1,13,31,38,656,48698656
42387,231,1796700,2,13,31,38,887,48698887
42388,180,1796700,2,13,31,39,67,48699067
42389,0,1796700,2,13,31,39,67,48699067
42391,21,1796700,1,13,31,39,88,48699088
42392,298,1796600,1,13,31,39,386,48699386
42393,19,1796700,1,13,31,39,405,48699405
42394,1096,1796800,1,13,31,40,501,48700501
42395,40,1796700,1,13,31,40,541,48700541
42396,278,1796700,1,13,31,40,819,48700819
42397,408,1796700,2,13,31,41,227,48701227
42399,40,1796700,4,13,31,41,267,48701267
42400,89,1796700,1,13,31,41,356,48701356
42401,56,1796700,1,13,31,41,412,48701412
42402,158,1796600,1,13,31,41,570,48701570
42403,30,1796700,1,13,31,41,600,48701600
42404,65,1796600,2,13,31,41,665,48701665
42405,19,1796700,2,13,31,41,684,48701684
42406,226,1796700,1,13,31,41,910,48701910
42407,213,1796700,1,13,31,42,123,48702123
42408,286,1796800,1,13,31,42,409,48702409
42409,1020,1796700,1,13,31,43,429,48703429
42410,72,1796800,1,13,31,43,501,48703501
42411,18,1796700,1,13,31,43,519,48703519
42412,908,1796800,1,13,31,44,427,48704427
42413,336,1796800,5,13,31,44,763,48704763
42414,0,1796800,1,13,31,44,763,48704763
42415,101,1796700,1,13,31,44,864,48704864
42416,551,1796800,1,13,31,45,415,48705415
42417,775,1796700,1,13,31,46,190,48706190
42418,253,1796800,1,13,31,46,443,48706443
42419,239,1796700,1,13,31,46,682,48706682
42420,752,1796800,1,13,31,47,434,48707434
42421,58,1796800,1,13,31,47,492,48707492
42422,253,1796700,1,13,31,47,745,48707745
42423,101,1796700,1,13,31,47,846,48707846
42424,88,1796700,1,13,31,47,934,48707934
42425,456,1796700,1,13,31,48,390,48708390
42426,46,1796800,1,13,31,48,436,48708436
42427,138,1796700,1,13,31,48,574,48708574
42428,540,1796600,5,13,31,49,114,48709114
42429,320,1796700,1,13,31,49,434,48709434
42430,162,1796700,1,13,31,49,596,48709596
42431,50,1796700,1,13,31,49,646,48709646
42432,102,1796700,1,13,31,49,748,48709748
42433,127,1796700,1,13,31,49,875,48709875
42434,335,1796700,1,13,31,50,210,48710210
42435,220,1796700,1,13,31,50,430,48710430
42436,5,1796500,1,13,31,50,435,48710435
42437,1000,1796600,1,13,31,51,435,48711435
42438,193,1796700,1,13,31,51,628,48711628
42439,19,1796700,2,13,31,51,647,48711647
42440,49,1796700,1,13,31,51,696,48711696
42441,20,1796700,1,13,31,51,716,48711716
42442,55,1796700,1,13,31,51,771,48711771
42443,44,1796700,1,13,31,51,815,48711815
42444,241,1796700,1,13,31,52,56,48712056
42445,395,1796600,1,13,31,52,451,48712451
42446,257,1796500,1,13,31,52,708,48712708
42447,758,1796700,1,13,31,53,466,48713466
42448,82,1796500,2,13,31,53,548,48713548
42449,116,1796500,17,13,31,53,664,48713664
42450,0,1796500,2,13,31,53,664,48713664
42451,1,1796500,2,13,31,53,665,48713665
42452,0,1796500,1,13,31,53,665,48713665
42453,0,1796500,1,13,31,53,665,48713665
42454,0,1796500,8,13,31,53,665,48713665
42455,0,1796500,1,13,31,53,665,48713665
42456,0,1796500,1,13,31,53,665,48713665
42457,0,1796500,1,13,31,53,665,48713665
42458,0,1796500,1,13,31,53,665,48713665
42459,298,1796500,1,13,31,53,963,48713963
42460,273,1796400,1,13,31,54,236,48714236
42461,0,1796400,4,13,31,54,236,48714236
42462,0,1796400,1,13,31,54,236,48714236
42463,206,1796500,1,13,31,54,442,48714442
42464,575,1796400,1,13,31,55,17,48715017
42465,199,1796400,1,13,31,55,216,48715216
42466,28,1796400,1,13,31,55,244,48715244
42467,178,1796300,1,13,31,55,422,48715422
42468,25,1796400,1,13,31,55,447,48715447
42469,185,1796400,3,13,31,55,632,48715632
42470,40,1796400,1,13,31,55,672,48715672
42471,83,1796500,2,13,31,55,755,48715755
42472,40,1796500,1,13,31,55,795,48715795
42473,23,1796400,1,13,31,55,818,48715818
42474,198,1796400,1,13,31,56,16,48716016
42475,294,1796400,1,13,31,56,310,48716310
42476,181,1796500,1,13,31,56,491,48716491
42477,397,1796500,1,13,31,56,888,48716888
42478,72,1796300,8,13,31,56,960,48716960
42479,20,1796200,1,13,31,56,980,48716980
42480,193,1796400,1,13,31,57,173,48717173
42481,16,1796200,20,13,31,57,189,48717189
42482,7,1796300,1,13,31,57,196,48717196
42483,56,1796300,1,13,31,57,252,48717252
42484,16,1796300,1,13,31,57,268,48717268
42485,52,1796300,1,13,31,57,320,48717320
42486,40,1796300,3,13,31,57,360,48717360
42487,22,1796400,1,13,31,57,382,48717382
42488,9,1796200,1,13,31,57,391,48717391
42489,33,1796400,1,13,31,57,424,48717424
42490,22,1796400,1,13,31,57,446,48717446
42491,230,1796400,1,13,31,57,676,48717676
42492,352,1796400,1,13,31,58,28,48718028
42493,201,1796500,1,13,31,58,229,48718229
42494,91,1796300,1,13,31,58,320,48718320
42495,103,1796300,1,13,31,58,423,48718423
42496,53,1796400,1,13,31,58,476,48718476
42497,320,1796400,1,13,31,58,796,48718796
42498,44,1796400,1,13,31,58,840,48718840
42499,182,1796200,8,13,31,59,22,48719022
42500,220,1796200,1,13,31,59,242,48719242
42501,136,1796200,1,13,31,59,378,48719378
42502,100,1796400,1,13,31,59,478,48719478
42503,239,1796200,1,13,31,59,717,48719717
42504,754,1796300,1,13,32,0,471,48720471
42505,16,1796400,3,13,32,0,487,48720487
42506,202,1796200,1,13,32,0,689,48720689
42507,188,1796400,1,13,32,0,877,48720877
42508,19,1796400,3,13,32,0,896,48720896
42509,188,1796400,5,13,32,1,84,48721084
42510,395,1796400,1,13,32,1,479,48721479
42511,82,1796400,1,13,32,1,561,48721561
42512,55,1796400,2,13,32,1,616,48721616
42513,46,1796400,1,13,32,1,662,48721662
42514,25,1796400,1,13,32,1,687,48721687
42515,73,1796500,1,13,32,1,760,48721760
42516,19,1796500,1,13,32,1,779,48721779
42517,81,1796500,1,13,32,1,860,48721860
42518,631,1796500,1,13,32,2,491,48722491
42519,605,1796500,1,13,32,3,96,48723096
42520,365,1796500,1,13,32,3,461,48723461
42521,139,1796400,1,13,32,3,600,48723600
42522,56,1796500,1,13,32,3,656,48723656
42523,1,1796500,1,13,32,3,657,48723657
42524,0,1796500,2,13,32,3,657,48723657
42525,0,1796500,2,13,32,3,657,48723657
42526,379,1796500,1,13,32,4,36,48724036
42527,341,1796500,1,13,32,4,377,48724377
42528,114,1796600,1,13,32,4,491,48724491
42529,41,1796500,2,13,32,4,532,48724532
42530,744,1796500,1,13,32,5,276,48725276
42531,217,1796500,1,13,32,5,493,48725493
42532,257,1796500,1,13,32,5,750,48725750
42533,311,1796400,1,13,32,6,61,48726061
42534,503,1796600,1,13,32,6,564,48726564
42535,721,1796400,3,13,32,7,285,48727285
42536,6,1796400,2,13,32,7,291,48727291
42537,586,1796500,1,13,32,7,877,48727877
42538,606,1796400,1,13,32,8,483,48728483
42539,154,1796400,1,13,32,8,637,48728637
42540,23,1796400,1,13,32,8,660,48728660
42541,96,1796400,1,13,32,8,756,48728756
42542,19,1796400,2,13,32,8,775,48728775
42543,847,1796500,1,13,32,9,622,48729622
42544,903,1796500,1,13,32,10,525,48730525
42545,910,1796400,1,13,32,11,435,48731435
42546,171,1796400,1,13,32,11,606,48731606
42547,607,1796300,9,13,32,12,213,48732213
42548,219,1796400,1,13,32,12,432,48732432
42549,40,1796400,3,13,32,12,472,48732472
42550,22,1796400,1,13,32,12,494,48732494
42551,106,1796300,3,13,32,12,600,48732600
42553,611,1796400,1,13,32,13,211,48733211
42554,422,1796300,1,13,32,13,633,48733633
42555,942,1796400,1,13,32,14,575,48734575
42556,575,1796400,2,13,32,15,150,48735150
42557,425,1796400,1,13,32,15,575,48735575
42558,427,1796200,1,13,32,16,2,48736002
42559,514,1796400,1,13,32,16,516,48736516
42560,601,1796200,1,13,32,17,117,48737117
42561,118,1796200,1,13,32,17,235,48737235
42562,239,1796200,2,13,32,17,474,48737474
42563,1,1796100,2,13,32,17,475,48737475
42564,24,1796300,1,13,32,17,499,48737499
42565,572,1796200,1,13,32,18,71,48738071
42566,45,1796300,2,13,32,18,116,48738116
42567,0,1796400,3,13,32,18,116,48738116
42568,96,1796300,2,13,32,18,212,48738212
42569,279,1796400,1,13,32,18,491,48738491
42570,8,1796300,2,13,32,18,499,48738499
42571,14,1796400,1,13,32,18,513,48738513
42572,71,1796400,7,13,32,18,584,48738584
42573,151,1796500,3,13,32,18,735,48738735
42574,9,1796400,1,13,32,18,744,48738744
42575,832,1796400,1,13,32,19,576,48739576
42577,19,1796500,1,13,32,19,595,48739595
42578,759,1796300,1,13,32,20,354,48740354
42579,194,1796500,1,13,32,20,548,48740548
42580,990,1796500,1,13,32,21,538,48741538
42581,3,1796300,2,13,32,21,541,48741541
42582,757,1796300,1,13,32,22,298,48742298
42584,279,1796400,1,13,32,22,577,48742577
42585,251,1796300,1,13,32,22,828,48742828
42586,90,1796300,1,13,32,22,918,48742918
42587,616,1796300,1,13,32,23,534,48743534
42588,575,1796300,1,13,32,24,109,48744109
42589,432,1796400,1,13,32,24,541,48744541
42590,983,1796400,1,13,32,25,524,48745524
42591,361,1796200,1,13,32,25,885,48745885
42592,639,1796400,1,13,32,26,524,48746524
42593,948,1796200,3,13,32,27,472,48747472
42594,0,1796200,2,13,32,27,472,48747472
42595,1,1796100,1,13,32,27,473,48747473
42596,59,1796200,1,13,32,27,532,48747532
42597,129,1796100,2,13,32,27,661,48747661
42598,50,1796200,1,13,32,27,711,48747711
42599,275,1796200,1,13,32,27,986,48747986
42600,250,1796300,1,13,32,28,236,48748236
42601,299,1796300,1,13,32,28,535,48748535
42602,1001,1796300,1,13,32,29,536,48749536
42603,1209,1796300,1,13,32,30,745,48750745
42604,833,1796300,1,13,32,31,578,48751578
42605,1012,1796200,1,13,32,32,590,48752590
42606,427,1796200,1,13,32,33,17,48753017
42607,528,1796300,1,13,32,33,545,48753545
42608,770,1796200,1,13,32,34,315,48754315
42609,260,1796300,1,13,32,34,575,48754575
42610,106,1796300,1,13,32,34,681,48754681
42611,384,1796100,1,13,32,35,65,48755065
42612,493,1796200,1,13,32,35,558,48755558
42613,956,1796100,6,13,32,36,514,48756514
42614,1,1796100,18,13,32,36,515,48756515
42615,0,1796100,12,13,32,36,515,48756515
42616,0,1796100,2,13,32,36,515,48756515
42617,1,1796100,4,13,32,36,516,48756516
42618,9,1796100,1,13,32,36,525,48756525
42619,34,1796100,1,13,32,36,559,48756559
42620,1005,1796000,7,13,32,37,564,48757564
42622,9,1796100,1,13,32,37,573,48757573
42623,48,1796100,1,13,32,37,621,48757621
42624,16,1795900,1,13,32,37,637,48757637
42625,448,1795900,8,13,32,38,85,48758085
42626,490,1796000,1,13,32,38,575,48758575
42627,103,1796000,3,13,32,38,678,48758678
42628,257,1796000,1,13,32,38,935,48758935
42629,589,1796000,1,13,32,39,524,48759524
42630,46,1795900,1,13,32,39,570,48759570
42631,6,1796100,1,13,32,39,576,48759576
42632,662,1795900,2,13,32,40,238,48760238
42633,303,1795800,1,13,32,40,541,48760541
42634,40,1796000,1,13,32,40,581,48760581
42635,1056,1796000,1,13,32,41,637,48761637
42636,200,1796000,1,13,32,41,837,48761837
42637,46,1796000,2,13,32,41,883,48761883
42638,42,1796000,1,13,32,41,925,48761925
42639,1,1796000,1,13,32,41,926,48761926
42640,267,1796000,1,13,32,42,193,48762193
42641,381,1796000,1,13,32,42,574,48762574
42642,1015,1796000,1,13,32,43,589,48763589
42643,446,1795900,1,13,32,44,35,48764035
42644,38,1795900,1,13,32,44,73,48764073
42645,223,1795900,1,13,32,44,296,48764296
42646,293,1796000,1,13,32,44,589,48764589
42647,96,1796000,1,13,32,44,685,48764685
42648,910,1796000,1,13,32,45,595,48765595
42649,1014,1796000,1,13,32,46,609,48766609
42650,69,1796000,1,13,32,46,678,48766678
42651,908,1796000,1,13,32,47,586,48767586
42652,1027,1796100,1,13,32,48,613,48768613
42653,699,1796100,3,13,32,49,312,48769312
42654,301,1796100,1,13,32,49,613,48769613
42655,307,1796000,1,13,32,49,920,48769920
42656,330,1796000,2,13,32,50,250,48770250
42657,75,1796000,1,13,32,50,325,48770325
42658,51,1796000,4,13,32,50,376,48770376
42659,73,1796000,1,13,32,50,449,48770449
42660,142,1796100,1,13,32,50,591,48770591
42661,392,1796000,1,13,32,50,983,48770983
42662,58,1795900,2,13,32,51,41,48771041
42663,554,1796000,1,13,32,51,595,48771595
42664,201,1795900,1,13,32,51,796,48771796
42666,815,1796100,1,13,32,52,611,48772611
42667,720,1796000,1,13,32,53,331,48773331
42668,82,1796100,1,13,32,53,413,48773413
42669,56,1795900,4,13,32,53,469,48773469
42670,144,1796100,1,13,32,53,613,48773613
42671,993,1796100,1,13,32,54,606,48774606
42672,1034,1796100,1,13,32,55,640,48775640
42673,986,1796000,1,13,32,56,626,48776626
42674,462,1795900,1,13,32,57,88,48777088
42675,539,1796000,1,13,32,57,627,48777627
42676,1037,1796000,1,13,32,58,664,48778664
42677,963,1796000,1,13,32,59,627,48779627
42678,975,1795900,7,13,33,0,602,48780602
42679,27,1796000,1,13,33,0,629,48780629
42680,177,1796000,1,13,33,0,806,48780806
42681,3,1795900,1,13,33,0,809,48780809
42682,62,1796000,2,13,33,0,871,48780871
42683,780,1796000,1,13,33,1,651,48781651
42684,351,1796000,1,13,33,2,2,48782002
42685,38,1796000,1,13,33,2,40,48782040
42686,99,1796000,1,13,33,2,139,48782139
42687,323,1796100,1,13,33,2,462,48782462
42688,268,1796100,1,13,33,2,730,48782730
42689,1,1796000,1,13,33,2,731,48782731
42690,916,1796000,1,13,33,3,647,48783647
42691,401,1795900,1,13,33,4,48,48784048
42692,599,1796000,1,13,33,4,647,48784647
42693,25,1795900,1,13,33,4,672,48784672
42694,1,1795900,1,13,33,4,673,48784673
42695,370,1795900,1,13,33,5,43,48785043
42696,608,1795900,1,13,33,5,651,48785651
42697,381,1795800,3,13,33,6,32,48786032
42698,579,1795800,1,13,33,6,611,48786611
42699,41,1795900,1,13,33,6,652,48786652
42700,621,1795800,2,13,33,7,273,48787273
42701,55,1795900,2,13,33,7,328,48787328
42702,444,1795800,2,13,33,7,772,48787772
42703,136,1795900,1,13,33,7,908,48787908
42704,272,1795900,1,13,33,8,180,48788180
42705,243,1795800,1,13,33,8,423,48788423
42706,205,1795900,1,13,33,8,628,48788628
42707,29,1795900,1,13,33,8,657,48788657
42708,387,1795700,1,13,33,9,44,48789044
42709,376,1795700,1,13,33,9,420,48789420
42710,238,1795900,1,13,33,9,658,48789658
42711,560,1795700,1,13,33,10,218,48790218
42712,1,1795700,3,13,33,10,219,48790219
42713,0,1795700,3,13,33,10,219,48790219
42714,0,1795700,1,13,33,10,219,48790219
42715,0,1795700,1,13,33,10,219,48790219
42716,0,1795700,1,13,33,10,219,48790219
42717,1,1795700,2,13,33,10,220,48790220
42718,444,1795800,1,13,33,10,664,48790664
42719,869,1795800,1,13,33,11,533,48791533
42720,323,1795800,1,13,33,11,856,48791856
42721,644,1795700,1,13,33,12,500,48792500
42722,82,1795700,1,13,33,12,582,48792582
42723,180,1795800,1,13,33,12,762,48792762
42724,541,1795700,3,13,33,13,303,48793303
42725,221,1795700,1,13,33,13,524,48793524
42726,1,1795700,1,13,33,13,525,48793525
42727,159,1795800,1,13,33,13,684,48793684
42728,845,1795700,1,13,33,14,529,48794529
42729,149,1795800,1,13,33,14,678,48794678
42730,1000,1795800,1,13,33,15,678,48795678
42731,960,1795600,2,13,33,16,638,48796638
42732,42,1795800,1,13,33,16,680,48796680
42733,363,1795600,1,13,33,17,43,48797043
42734,345,1795800,1,13,33,17,388,48797388
42735,279,1795800,1,13,33,17,667,48797667
42736,1000,1795800,1,13,33,18,667,48798667
42737,166,1795800,2,13,33,18,833,48798833
42738,119,1795800,2,13,33,18,952,48798952
42739,84,1795800,1,13,33,19,36,48799036
42740,148,1795800,1,13,33,19,184,48799184
42741,72,1795800,1,13,33,19,256,48799256
42742,44,1795800,3,13,33,19,300,48799300
42743,1,1795800,2,13,33,19,301,48799301
42744,402,1795800,1,13,33,19,703,48799703
42745,793,1795700,6,13,33,20,496,48800496
42746,76,1795800,1,13,33,20,572,48800572
42747,37,1795800,1,13,33,20,609,48800609
42748,136,1795800,1,13,33,20,745,48800745
42749,61,1795800,1,13,33,20,806,48800806
42750,63,1795800,1,13,33,20,869,48800869
42751,32,1795800,2,13,33,20,901,48800901
42752,76,1795800,1,13,33,20,977,48800977
42753,56,1795900,6,13,33,21,33,48801033
42754,43,1795900,2,13,33,21,76,48801076
42755,156,1795900,1,13,33,21,232,48801232
42756,179,1795800,1,13,33,21,411,48801411
42757,45,1795800,1,13,33,21,456,48801456
42758,246,1795800,1,13,33,21,702,48801702
42759,74,1795700,1,13,33,21,776,48801776
42760,390,1795900,1,13,33,22,166,48802166
42761,40,1795900,1,13,33,22,206,48802206
42762,113,1795700,1,13,33,22,319,48802319
42763,15,1795900,1,13,33,22,334,48802334
42764,28,1795900,1,13,33,22,362,48802362
42765,72,1795900,3,13,33,22,434,48802434
42766,28,1795900,1,13,33,22,462,48802462
42767,293,1795900,1,13,33,22,755,48802755
42768,768,1795700,1,13,33,23,523,48803523
42769,187,1795800,1,13,33,23,710,48803710
42770,988,1795800,1,13,33,24,698,48804698
42771,572,1795800,1,13,33,25,270,48805270
42772,205,1795800,1,13,33,25,475,48805475
42773,226,1795800,1,13,33,25,701,48805701
42774,940,1795700,1,13,33,26,641,48806641
42775,60,1795800,1,13,33,26,701,48806701
42776,565,1795700,2,13,33,27,266,48807266
42777,365,1795700,1,13,33,27,631,48807631
42778,667,1795700,1,13,33,28,298,48808298
42779,12,1795600,6,13,33,28,310,48808310
42780,180,1795700,1,13,33,28,490,48808490
42781,94,1795700,1,13,33,28,584,48808584
42782,767,1795800,1,13,33,29,351,48809351
42783,39,1795800,1,13,33,29,390,48809390
42784,394,1795700,1,13,33,29,784,48809784
42785,1359,1795800,1,13,33,31,143,48811143
42786,47,1795800,1,13,33,31,190,48811190
42787,104,1795900,2,13,33,31,294,48811294
42788,36,1795900,1,13,33,31,330,48811330
42789,95,1795700,1,13,33,31,425,48811425
42790,170,1795900,1,13,33,31,595,48811595
42791,2326,1795700,1,13,33,33,921,48813921
42792,1807,1795700,2,13,33,35,728,48815728
42793,82,1795700,2,13,33,35,810,48815810
42794,0,1795700,1,13,33,35,810,48815810
42795,1,1795700,1,13,33,35,811,48815811
42796,0,1795700,1,13,33,35,811,48815811
42797,1333,1795700,1,13,33,37,144,48817144
42798,2156,1795700,1,13,33,39,300,48819300
42799,128,1795800,1,13,33,39,428,48819428
42800,1433,1795700,1,13,33,40,861,48820861
42801,726,1795700,1,13,33,41,587,48821587
42802,432,1795800,1,13,33,42,19,48822019
42803,640,1795700,1,13,33,42,659,48822659
42804,2988,1795700,1,13,33,45,647,48825647
42805,202,1795700,1,13,33,45,849,48825849
42806,1161,1795700,2,13,33,47,10,48827010
42807,1192,1795700,1,13,33,48,202,48828202
42808,67,1795700,2,13,33,48,269,48828269
42809,135,1795700,1,13,33,48,404,48828404
42810,96,1795700,1,13,33,48,500,48828500
42811,838,1795700,2,13,33,49,338,48829338
42812,533,1795700,4,13,33,49,871,48829871
42813,123,1795700,1,13,33,49,994,48829994
42814,436,1795700,1,13,33,50,430,48830430
42815,383,1795800,4,13,33,50,813,48830813
42816,0,1795800,1,13,33,50,813,48830813
42817,404,1795600,1,13,33,51,217,48831217
42818,359,1795700,4,13,33,51,576,48831576
42819,860,1795700,3,13,33,52,436,48832436
42820,117,1795700,2,13,33,52,553,48832553
42821,551,1795700,2,13,33,53,104,48833104
42822,702,1795600,1,13,33,53,806,48833806
42823,1772,1795600,1,13,33,55,578,48835578
42824,1366,1795800,5,13,33,56,944,48836944
42825,16,1795700,2,13,33,56,960,48836960
42826,0,1795700,2,13,33,56,960,48836960
42827,1131,1795600,1,13,33,58,91,48838091
42828,1312,1795600,2,13,33,59,403,48839403
42829,691,1795800,2,13,34,0,94,48840094
42830,72,1795600,2,13,34,0,166,48840166
42831,142,1795800,1,13,34,0,308,48840308
42832,641,1795600,1,13,34,0,949,48840949
42833,1055,1795700,1,13,34,2,4,48842004
42834,101,1795700,1,13,34,2,105,48842105
42835,446,1795800,1,13,34,2,551,48842551
42836,73,1795700,1,13,34,2,624,48842624
42837,157,1795700,1,13,34,2,781,48842781
42838,119,1795700,1,13,34,2,900,48842900
42839,327,1795700,1,13,34,3,227,48843227
42840,32,1795700,1,13,34,3,259,48843259
42841,1025,1795800,1,13,34,4,284,48844284
42842,43,1795700,1,13,34,4,327,48844327
42843,791,1795600,2,13,34,5,118,48845118
42844,861,1795600,1,13,34,5,979,48845979
42845,117,1795700,1,13,34,6,96,48846096
42846,1550,1795700,1,13,34,7,646,48847646
42847,394,1795700,1,13,34,8,40,48848040
42848,256,1795700,1,13,34,8,296,48848296
42849,136,1795800,1,13,34,8,432,48848432
42850,148,1795800,1,13,34,8,580,48848580
42851,988,1795800,1,13,34,9,568,48849568
42852,153,1795800,1,13,34,9,721,48849721
42853,967,1795800,1,13,34,10,688,48850688
42854,1529,1795700,2,13,34,12,217,48852217
42855,683,1795700,2,13,34,12,900,48852900
42856,636,1795700,1,13,34,13,536,48853536
42857,27,1795700,1,13,34,13,563,48853563
42858,29,1795700,3,13,34,13,592,48853592
42859,72,1795800,2,13,34,13,664,48853664
42860,638,1795800,2,13,34,14,302,48854302
42861,763,1795700,1,13,34,15,65,48855065
42862,269,1795700,7,13,34,15,334,48855334
42863,66,1795700,1,13,34,15,400,48855400
42864,765,1795600,1,13,34,16,165,48856165
42865,231,1795600,1,13,34,16,396,48856396
42866,826,1795600,1,13,34,17,222,48857222
42867,346,1795700,1,13,34,17,568,48857568
42868,48,1795700,1,13,34,17,616,48857616
42869,32,1795700,1,13,34,17,648,48857648
42870,128,1795700,1,13,34,17,776,48857776
42871,98,1795700,2,13,34,17,874,48857874
42872,1200,1795700,1,13,34,19,74,48859074
42873,282,1795700,1,13,34,19,356,48859356
42874,0,1795700,1,13,34,19,356,48859356
42875,341,1795700,1,13,34,19,697,48859697
42876,474,1795600,1,13,34,20,171,48860171
42877,0,1795600,3,13,34,20,171,48860171
42878,78,1795600,1,13,34,20,249,48860249
42879,0,1795600,1,13,34,20,249,48860249
42880,0,1795600,9,13,34,20,249,48860249
42881,327,1795500,1,13,34,20,576,48860576
42882,625,1795500,3,13,34,21,201,48861201
42883,307,1795700,1,13,34,21,508,48861508
42884,48,1795700,1,13,34,21,556,48861556
42885,19,1795700,1,13,34,21,575,48861575
42886,56,1795700,1,13,34,21,631,48861631
42887,25,1795700,1,13,34,21,656,48861656
42888,35,1795700,1,13,34,21,691,48861691
42889,28,1795700,1,13,34,21,719,48861719
42890,245,1795700,1,13,34,21,964,48861964
42891,19,1795700,1,13,34,21,983,48861983
42892,109,1795700,1,13,34,22,92,48862092
42893,1,1795600,2,13,34,22,93,48862093
42894,219,1795600,1,13,34,22,312,48862312
42895,80,1795600,2,13,34,22,392,48862392
42896,141,1795600,2,13,34,22,533,48862533
42897,361,1795500,2,13,34,22,894,48862894
42898,931,1795600,2,13,34,23,825,48863825
42899,4490,1795600,7,13,34,28,315,48868315
42900,1853,1795500,2,13,34,30,168,48870168
42901,496,1795500,2,13,34,30,664,48870664
42902,509,1795500,6,13,34,31,173,48871173
42903,0,1795500,23,13,34,31,173,48871173
42904,0,1795500,1,13,34,31,173,48871173
42905,83,1795400,5,13,34,31,256,48871256
42906,1002,1795400,1,13,34,32,258,48872258
42907,570,1795400,1,13,34,32,828,48872828
42908,55,1795400,1,13,34,32,883,48872883
42909,196,1795300,1,13,34,33,79,48873079
42910,41,1795300,1,13,34,33,120,48873120
42911,264,1795300,2,13,34,33,384,48873384
42912,1564,1795400,1,13,34,34,948,48874948
42913,88,1795400,1,13,34,35,36,48875036
42914,192,1795400,1,13,34,35,228,48875228
42915,324,1795400,1,13,34,35,552,48875552
42916,156,1795400,1,13,34,35,708,48875708
42917,52,1795400,1,13,34,35,760,48875760
42918,68,1795400,2,13,34,35,828,48875828
42919,628,1795400,1,13,34,36,456,48876456
42920,208,1795400,1,13,34,36,664,48876664
42921,113,1795400,13,13,34,36,777,48876777
42922,23,1795500,1,13,34,36,800,48876800
42923,0,1795500,1,13,34,36,800,48876800
42924,0,1795500,8,13,34,36,800,48876800
42925,0,1795500,1,13,34,36,800,48876800
42926,0,1795500,1,13,34,36,800,48876800
42927,9,1795500,1,13,34,36,809,48876809
42928,479,1795500,3,13,34,37,288,48877288
42929,122,1795600,3,13,34,37,410,48877410
42930,7,1795400,1,13,34,37,417,48877417
42931,203,1795600,7,13,34,37,620,48877620
42932,232,1795500,1,13,34,37,852,48877852
42933,1107,1795400,1,13,34,38,959,48878959
42934,702,1795400,1,13,34,39,661,48879661
42935,510,1795500,2,13,34,40,171,48880171
42937,1269,1795400,1,13,34,41,440,48881440
42938,319,1795400,1,13,34,41,759,48881759
42939,4116,1795400,2,13,34,45,875,48885875
42940,743,1795400,1,13,34,46,618,48886618
42941,2051,1795500,3,13,34,48,669,48888669
42942,0,1795500,2,13,34,48,669,48888669
42943,363,1795600,1,13,34,49,32,48889032
42944,19,1795600,1,13,34,49,51,48889051
42945,277,1795600,2,13,34,49,328,48889328
42946,196,1795600,2,13,34,49,524,48889524
42947,1,1795600,1,13,34,49,525,48889525
42948,63,1795600,1,13,34,49,588,48889588
42949,33,1795600,1,13,34,49,621,48889621
42950,61,1795500,1,13,34,49,682,48889682
42951,70,1795600,1,13,34,49,752,48889752
42952,216,1795600,1,13,34,49,968,48889968
42953,64,1795600,1,13,34,50,32,48890032
42954,344,1795600,1,13,34,50,376,48890376
42955,20,1795700,1,13,34,50,396,48890396
42956,75,1795700,1,13,34,50,471,48890471
42957,445,1795700,1,13,34,50,916,48890916
42958,18,1795700,3,13,34,50,934,48890934
42959,476,1795600,2,13,34,51,410,48891410
42960,1665,1795600,1,13,34,53,75,48893075
42961,693,1795700,1,13,34,53,768,48893768
42962,617,1795600,1,13,34,54,385,48894385
42963,1371,1795600,1,13,34,55,756,48895756
42964,927,1795500,1,13,34,56,683,48896683
42965,4132,1795400,2,13,35,0,815,48900815
42966,268,1795600,2,13,35,1,83,48901083
42967,104,1795600,1,13,35,1,187,48901187
42968,1303,1795500,1,13,35,2,490,48902490
42969,20,1795600,1,13,35,2,510,48902510
42970,1059,1795400,1,13,35,3,569,48903569
42971,1611,1795600,2,13,35,5,180,48905180
42972,648,1795600,2,13,35,5,828,48905828
42973,139,1795600,11,13,35,5,967,48905967
42974,321,1795700,1,13,35,6,288,48906288
42975,0,1795700,20,13,35,6,288,48906288
42976,205,1795700,1,13,35,6,493,48906493
42977,57,1795700,2,13,35,6,550,48906550
42978,79,1795800,1,13,35,6,629,48906629
42979,0,1795800,1,13,35,6,629,48906629
42980,0,1795800,16,13,35,6,629,48906629
42981,0,1795800,1,13,35,6,629,48906629
42982,1,1795800,3,13,35,6,630,48906630
42983,0,1795800,4,13,35,6,630,48906630
42984,230,1795800,1,13,35,6,860,48906860
42985,61,1795800,2,13,35,6,921,48906921
42986,1,1795800,1,13,35,6,922,48906922
42987,277,1795800,2,13,35,7,199,48907199
42989,351,1795800,2,13,35,7,550,48907550
42990,131,1795800,2,13,35,7,681,48907681
42991,200,1795800,1,13,35,7,881,48907881
42992,32,1795800,1,13,35,7,913,48907913
42993,171,1795900,1,13,35,8,84,48908084
42994,27,1795900,5,13,35,8,111,48908111
42995,57,1795900,1,13,35,8,168,48908168
42996,5,1795800,2,13,35,8,173,48908173
42997,235,1795900,1,13,35,8,408,48908408
42998,163,1795800,1,13,35,8,571,48908571
42999,34,1795900,1,13,35,8,605,48908605
43000,264,1795800,2,13,35,8,869,48908869
43001,103,1795900,1,13,35,8,972,48908972
43002,28,1795800,1,13,35,9,0,48909000
43003,512,1795900,1,13,35,9,512,48909512
43004,160,1795800,1,13,35,9,672,48909672
43005,35,1795900,1,13,35,9,707,48909707
43006,346,1795900,3,13,35,10,53,48910053
43007,60,1795900,24,13,35,10,113,48910113
43008,2,1796000,2,13,35,10,115,48910115
43009,1,1796000,1,13,35,10,116,48910116
43010,0,1796000,1,13,35,10,116,48910116
43011,0,1796000,12,13,35,10,116,48910116
43012,0,1796000,1,13,35,10,116,48910116
43013,687,1795900,2,13,35,10,803,48910803
43014,246,1796000,2,13,35,11,49,48911049
43015,15,1796100,2,13,35,11,64,48911064
43016,31,1795900,1,13,35,11,95,48911095
43017,150,1796000,1,13,35,11,245,48911245
43018,46,1796000,1,13,35,11,291,48911291
43019,340,1795900,1,13,35,11,631,48911631
43020,85,1796000,1,13,35,11,716,48911716
43021,64,1796000,1,13,35,11,780,48911780
43022,59,1796000,1,13,35,11,839,48911839
43023,897,1796100,1,13,35,12,736,48912736
43024,392,1796100,1,13,35,13,128,48913128
43025,207,1796000,2,13,35,13,335,48913335
43026,131,1796000,2,13,35,13,466,48913466
43027,882,1796000,1,13,35,14,348,48914348
43028,416,1796000,1,13,35,14,764,48914764
43029,1978,1796100,1,13,35,16,742,48916742
43030,1139,1796100,1,13,35,17,881,48917881
43031,1107,1796000,1,13,35,18,988,48918988
43032,1696,1796100,1,13,35,20,684,48920684
43033,531,1796100,1,13,35,21,215,48921215
43034,21,1796100,1,13,35,21,236,48921236
43035,114,1796000,1,13,35,21,350,48921350
43036,771,1796000,1,13,35,22,121,48922121
43037,316,1796000,1,13,35,22,437,48922437
43038,2,1795900,1,13,35,22,439,48922439
43039,1122,1795800,2,13,35,23,561,48923561
43040,32,1795800,1,13,35,23,593,48923593
43041,3840,1795800,1,13,35,27,433,48927433
43042,259,1795800,2,13,35,27,692,48927692
43043,0,1795800,2,13,35,27,692,48927692
43044,141,1795800,1,13,35,27,833,48927833
43046,123,1795800,1,13,35,27,956,48927956
43047,274,1795700,2,13,35,28,230,48928230
43048,1,1795700,8,13,35,28,231,48928231
43049,912,1795600,1,13,35,29,143,48929143
43050,329,1795500,1,13,35,29,472,48929472
43051,2,1795600,2,13,35,29,474,48929474
43052,1371,1795600,1,13,35,30,845,48930845
43053,213,1795600,1,13,35,31,58,48931058
43054,8,1795600,2,13,35,31,66,48931066
43055,449,1795500,1,13,35,31,515,48931515
43056,3178,1795600,1,13,35,34,693,48934693
43057,940,1795600,2,13,35,35,633,48935633
43058,627,1795600,1,13,35,36,260,48936260
43059,380,1795600,1,13,35,36,640,48936640
43060,1302,1795600,2,13,35,37,942,48937942
43061,634,1795600,5,13,35,38,576,48938576
43062,996,1795600,9,13,35,39,572,48939572
43063,19,1795600,1,13,35,39,591,48939591
43064,1485,1795600,2,13,35,41,76,48941076
43065,10,1795600,1,13,35,41,86,48941086
43066,1006,1795600,1,13,35,42,92,48942092
43067,19,1795600,2,13,35,42,111,48942111
43068,198,1795600,1,13,35,42,309,48942309
43069,1104,1795600,1,13,35,43,413,48943413
43070,104,1795500,2,13,35,43,517,48943517
43071,879,1795600,5,13,35,44,396,48944396
43072,2265,1795500,1,13,35,46,661,48946661
43073,0,1795500,12,13,35,46,661,48946661
43074,515,1795500,1,13,35,47,176,48947176
43075,287,1795400,3,13,35,47,463,48947463
43076,148,1795400,1,13,35,47,611,48947611
43077,224,1795400,1,13,35,47,835,48947835
43078,195,1795400,1,13,35,48,30,48948030
43079,230,1795500,4,13,35,48,260,48948260
43080,280,1795600,1,13,35,48,540,48948540
43081,99,1795600,1,13,35,48,639,48948639
43082,1350,1795500,1,13,35,49,989,48949989
43083,1051,1795500,1,13,35,51,40,48951040
43084,15,1795500,1,13,35,51,55,48951055
43085,133,1795400,10,13,35,51,188,48951188
43086,1,1795400,1,13,35,51,189,48951189
43087,664,1795400,1,13,35,51,853,48951853
43088,261,1795300,1,13,35,52,114,48952114
43089,430,1795300,2,13,35,52,544,48952544
43090,2230,1795400,4,13,35,54,774,48954774
43091,398,1795400,1,13,35,55,172,48955172
43092,198,1795300,1,13,35,55,370,48955370
43093,61,1795400,1,13,35,55,431,48955431
43094,88,1795500,1,13,35,55,519,48955519
43095,1234,1795300,1,13,35,56,753,48956753
43096,505,1795400,1,13,35,57,258,48957258
43097,1385,1795300,1,13,35,58,643,48958643
43098,0,1795300,1,13,35,58,643,48958643
43099,0,1795300,2,13,35,58,643,48958643
43100,0,1795300,2,13,35,58,643,48958643
43101,2187,1795200,1,13,36,0,830,48960830
43102,337,1795200,1,13,36,1,167,48961167
43103,341,1795300,1,13,36,1,508,48961508
43104,167,1795200,3,13,36,1,675,48961675
43105,0,1795200,1,13,36,1,675,48961675
43106,0,1795200,3,13,36,1,675,48961675
43107,0,1795200,1,13,36,1,675,48961675
43108,267,1795100,7,13,36,1,942,48961942
43109,0,1795100,1,13,36,1,942,48961942
43110,0,1795100,2,13,36,1,942,48961942
43111,0,1795100,3,13,36,1,942,48961942
43112,0,1795100,5,13,36,1,942,48961942
43113,10,1795000,5,13,36,1,952,48961952
43114,0,1795000,1,13,36,1,952,48961952
43115,0,1795000,1,13,36,1,952,48961952
43116,0,1795000,1,13,36,1,952,48961952
43117,0,1795000,1,13,36,1,952,48961952
43118,0,1795000,5,13,36,1,952,48961952
43119,155,1795100,1,13,36,2,107,48962107
43120,32,1795100,2,13,36,2,139,48962139
43121,106,1794900,1,13,36,2,245,48962245
43122,6,1794900,1,13,36,2,251,48962251
43123,387,1795100,1,13,36,2,638,48962638
43124,52,1795000,1,13,36,2,690,48962690
43125,73,1795000,1,13,36,2,763,48962763
43126,478,1795000,1,13,36,3,241,48963241
43127,1300,1795100,3,13,36,4,541,48964541
43128,363,1795100,1,13,36,4,904,48964904
43129,198,1795000,1,13,36,5,102,48965102
43130,1123,1795100,1,13,36,6,225,48966225
43131,1286,1795100,1,13,36,7,511,48967511
43132,1629,1795100,1,13,36,9,140,48969140
43133,196,1795100,5,13,36,9,336,48969336
43134,239,1795100,1,13,36,9,575,48969575
43135,624,1795000,14,13,36,10,199,48970199
43136,47,1795000,1,13,36,10,246,48970246
43137,346,1795000,1,13,36,10,592,48970592
43138,440,1795000,2,13,36,11,32,48971032
43139,5,1795000,3,13,36,11,37,48971037
43141,6,1795100,1,13,36,11,43,48971043
43142,1781,1795100,1,13,36,12,824,48972824
43143,643,1795000,3,13,36,13,467,48973467
43144,616,1795000,1,13,36,14,83,48974083
43145,504,1795000,1,13,36,14,587,48974587
43146,1,1795000,2,13,36,14,588,48974588
43147,1520,1795000,1,13,36,16,108,48976108
43148,2144,1795100,1,13,36,18,252,48978252
43149,543,1794900,1,13,36,18,795,48978795
43150,1025,1794900,11,13,36,19,820,48979820
43151,6,1794800,5,13,36,19,826,48979826
43152,0,1794800,4,13,36,19,826,48979826
43153,0,1794800,1,13,36,19,826,48979826
43154,2,1794700,9,13,36,19,828,48979828
43155,212,1794700,2,13,36,20,40,48980040
43156,818,1794700,1,13,36,20,858,48980858
43157,58,1794600,5,13,36,20,916,48980916
43158,1,1794600,3,13,36,20,917,48980917
43159,64,1794700,2,13,36,20,981,48980981
43161,65,1794600,1,13,36,21,46,48981046
43162,83,1794800,1,13,36,21,129,48981129
43163,11,1794800,2,13,36,21,140,48981140
43164,337,1794800,1,13,36,21,477,48981477
43165,1371,1794800,1,13,36,22,848,48982848
43166,184,1794700,1,13,36,23,32,48983032
43167,18,1794700,2,13,36,23,50,48983050
43168,58,1794800,1,13,36,23,108,48983108
43169,60,1794600,2,13,36,23,168,48983168
43170,6,1794600,5,13,36,23,174,48983174
43171,1149,1794600,1,13,36,24,323,48984323
43172,29,1794500,22,13,36,24,352,48984352
43173,18,1794400,1,13,36,24,370,48984370
43174,97,1794500,1,13,36,24,467,48984467
43175,38,1794400,1,13,36,24,505,48984505
43176,179,1794500,1,13,36,24,684,48984684
43177,182,1794500,3,13,36,24,866,48984866
43178,770,1794400,5,13,36,25,636,48985636
43179,584,1794400,5,13,36,26,220,48986220
43180,142,1794500,3,13,36,26,362,48986362
43181,0,1794500,1,13,36,26,362,48986362
43182,0,1794500,1,13,36,26,362,48986362
43183,2,1794500,1,13,36,26,364,48986364
43184,1268,1794500,1,13,36,27,632,48987632
43185,1183,1794500,4,13,36,28,815,48988815
43186,126,1794600,3,13,36,28,941,48988941
43187,170,1794600,3,13,36,29,111,48989111
43189,473,1794700,1,13,36,29,584,48989584
43190,937,1794600,2,13,36,30,521,48990521
43191,397,1794600,1,13,36,30,918,48990918
43192,153,1794700,1,13,36,31,71,48991071
43193,20,1794700,1,13,36,31,91,48991091
43194,1911,1794600,1,13,36,33,2,48993002
43195,709,1794600,5,13,36,33,711,48993711
43196,82,1794600,1,13,36,33,793,48993793
43197,33,1794700,1,13,36,33,826,48993826
43198,727,1794600,6,13,36,34,553,48994553
43200,2113,1794600,1,13,36,36,666,48996666
43201,3193,1794600,1,13,36,39,859,48999859
43202,874,1794700,3,13,36,40,733,49000733
43203,326,1794700,2,13,36,41,59,49001059
43204,8,1794700,1,13,36,41,67,49001067
43205,106,1794700,3,13,36,41,173,49001173
43206,81,1794800,1,13,36,41,254,49001254
43207,2473,1794600,1,13,36,43,727,49003727
43208,2,1794800,1,13,36,43,729,49003729
43209,1384,1794600,2,13,36,45,113,49005113
43210,321,1794700,2,13,36,45,434,49005434
43211,1048,1794700,3,13,36,46,482,49006482
43212,0,1794700,3,13,36,46,482,49006482
43214,2,1794600,1,13,36,46,484,49006484
43215,121,1794700,1,13,36,46,605,49006605
43216,1056,1794600,3,13,36,47,661,49007661
43217,1201,1794600,3,13,36,48,862,49008862
43218,0,1794600,7,13,36,48,862,49008862
43219,46,1794500,1,13,36,48,908,49008908
43220,316,1794700,3,13,36,49,224,49009224
43221,1,1794700,1,13,36,49,225,49009225
43222,0,1794700,1,13,36,49,225,49009225
43223,1898,1794600,1,13,36,51,123,49011123
43224,18,1794600,2,13,36,51,141,49011141
43225,762,1794500,1,13,36,51,903,49011903
43226,34,1794600,1,13,36,51,937,49011937
43227,1396,1794600,3,13,36,53,333,49013333
43228,1,1794600,1,13,36,53,334,49013334
43229,66,1794600,1,13,36,53,400,49013400
43230,57,1794600,2,13,36,53,457,49013457
43231,19,1794600,1,13,36,53,476,49013476
43232,13,1794600,1,13,36,53,489,49013489
43233,59,1794600,1,13,36,53,548,49013548
43234,327,1794600,1,13,36,53,875,49013875
43235,63,1794500,1,13,36,53,938,49013938
43236,991,1794600,1,13,36,54,929,49014929
43237,32,1794500,1,13,36,54,961,49014961
43238,42,1794500,5,13,36,55,3,49015003
43239,1051,1794500,1,13,36,56,54,49016054
43240,465,1794500,1,13,36,56,519,49016519
43241,1705,1794400,10,13,36,58,224,49018224
43242,0,1794400,1,13,36,58,224,49018224
43243,1032,1794500,2,13,36,59,256,49019256
43244,41,1794500,1,13,36,59,297,49019297
43245,18,1794500,1,13,36,59,315,49019315
43246,9,1794500,1,13,36,59,324,49019324
43247,44,1794500,1,13,36,59,368,49019368
43248,0,1794500,1,13,36,59,368,49019368
43249,21,1794300,2,13,36,59,389,49019389
43250,504,1794400,1,13,36,59,893,49019893
43251,1275,1794400,1,13,37,1,168,49021168
43252,49,1794400,1,13,37,1,217,49021217
43253,32,1794500,1,13,37,1,249,49021249
43254,1,1794500,1,13,37,1,250,49021250
43255,0,1794500,1,13,37,1,250,49021250
43256,0,1794500,2,13,37,1,250,49021250
43257,130,1794500,1,13,37,1,380,49021380
43258,23,1794500,1,13,37,1,403,49021403
43259,10,1794500,1,13,37,1,413,49021413
43260,4,1794500,1,13,37,1,417,49021417
43261,183,1794600,1,13,37,1,600,49021600
43262,216,1794600,1,13,37,1,816,49021816
43263,379,1794500,2,13,37,2,195,49022195
43264,82,1794600,16,13,37,2,277,49022277
43265,1,1794600,3,13,37,2,278,49022278
43266,60,1794600,1,13,37,2,338,49022338
43267,18,1794600,1,13,37,2,356,49022356
43268,399,1794500,2,13,37,2,755,49022755
43269,1562,1794600,1,13,37,4,317,49024317
43270,600,1794500,2,13,37,4,917,49024917
43271,591,1794500,1,13,37,5,508,49025508
43272,112,1794500,1,13,37,5,620,49025620
43273,623,1794500,1,13,37,6,243,49026243
43274,576,1794500,1,13,37,6,819,49026819
43275,565,1794500,3,13,37,7,384,49027384
43276,2,1794500,1,13,37,7,386,49027386
43277,25,1794600,1,13,37,7,411,49027411
43278,67,1794600,3,13,37,7,478,49027478
43279,63,1794600,2,13,37,7,541,49027541
43280,588,1794600,2,13,37,8,129,49028129
43281,319,1794600,1,13,37,8,448,49028448
43282,308,1794600,1,13,37,8,756,49028756
43283,308,1794600,1,13,37,9,64,49029064
43284,464,1794500,1,13,37,9,528,49029528
43285,144,1794600,1,13,37,9,672,49029672
43286,10,1794500,1,13,37,9,682,49029682
43287,429,1794500,1,13,37,10,111,49030111
43288,284,1794500,1,13,37,10,395,49030395
43289,651,1794700,2,13,37,11,46,49031046
43290,15,1794700,2,13,37,11,61,49031061
43291,1884,1794700,1,13,37,12,945,49032945
43292,2484,1794700,1,13,37,15,429,49035429
43293,203,1794700,2,13,37,15,632,49035632
43294,2098,1794600,22,13,37,17,730,49037730
43295,3,1794500,1,13,37,17,733,49037733
43296,0,1794500,1,13,37,17,733,49037733
43297,780,1794600,1,13,37,18,513,49038513
43298,2592,1794600,1,13,37,21,105,49041105
43299,5,1794600,1,13,37,21,110,49041110
43300,66,1794500,2,13,37,21,176,49041176
43301,1833,1794500,1,13,37,23,9,49043009
43302,472,1794500,1,13,37,23,481,49043481
43303,3623,1794500,2,13,37,27,104,49047104
43304,21,1794500,4,13,37,27,125,49047125
43306,496,1794400,1,13,37,27,621,49047621
43307,1991,1794500,2,13,37,29,612,49049612
43308,439,1794400,1,13,37,30,51,49050051
43309,615,1794400,1,13,37,30,666,49050666
43310,489,1794500,1,13,37,31,155,49051155
43311,6,1794500,1,13,37,31,161,49051161
43312,19,1794400,3,13,37,31,180,49051180
43313,926,1794400,1,13,37,32,106,49052106
43314,822,1794500,1,13,37,32,928,49052928
43315,294,1794400,1,13,37,33,222,49053222
43316,534,1794500,3,13,37,33,756,49053756
43317,651,1794600,7,13,37,34,407,49054407
43318,11,1794600,2,13,37,34,418,49054418
43319,739,1794600,2,13,37,35,157,49055157
43320,166,1794500,2,13,37,35,323,49055323
43321,2439,1794500,1,13,37,37,762,49057762
43322,1717,1794600,1,13,37,39,479,49059479
43323,229,1794700,1,13,37,39,708,49059708
43324,0,1794700,3,13,37,39,708,49059708
43325,70,1794700,1,13,37,39,778,49059778
43326,516,1794800,2,13,37,40,294,49060294
43327,211,1794700,1,13,37,40,505,49060505
43329,53,1794800,3,13,37,40,558,49060558
43330,519,1794800,2,13,37,41,77,49061077
43331,7,1794800,2,13,37,41,84,49061084
43332,40,1794800,2,13,37,41,124,49061124
43333,183,1794800,1,13,37,41,307,49061307
43334,906,1794800,4,13,37,42,213,49062213
43335,408,1794900,2,13,37,42,621,49062621
43336,1,1794900,1,13,37,42,622,49062622
43337,274,1795000,2,13,37,42,896,49062896
43338,302,1795000,2,13,37,43,198,49063198
43339,1,1795000,3,13,37,43,199,49063199
43340,1,1795000,1,13,37,43,200,49063200
43341,0,1795000,3,13,37,43,200,49063200
43342,199,1795100,3,13,37,43,399,49063399
43343,44,1795100,2,13,37,43,443,49063443
43344,187,1795100,1,13,37,43,630,49063630
43345,160,1795100,2,13,37,43,790,49063790
43346,48,1795100,3,13,37,43,838,49063838
43347,253,1795000,1,13,37,44,91,49064091
43348,734,1795000,3,13,37,44,825,49064825
43349,812,1795000,1,13,37,45,637,49065637
43350,1277,1795000,1,13,37,46,914,49066914
43351,695,1794900,1,13,37,47,609,49067609
43352,1128,1794900,7,13,37,48,737,49068737
43353,4,1794800,1,13,37,48,741,49068741
43354,103,1794900,1,13,37,48,844,49068844
43355,1645,1794800,1,13,37,50,489,49070489
43357,702,1794800,1,13,37,51,191,49071191
43358,18,1794800,1,13,37,51,209,49071209
43359,20,1794900,1,13,37,51,229,49071229
43360,3437,1794900,2,13,37,54,666,49074666
43361,2707,1794900,1,13,37,57,373,49077373
43362,1341,1794800,5,13,37,58,714,49078714
43363,3510,1794700,1,13,38,2,224,49082224
43364,52,1794800,1,13,38,2,276,49082276
43365,65,1794800,2,13,38,2,341,49082341
43366,103,1794700,1,13,38,2,444,49082444
43367,1,1794700,1,13,38,2,445,49082445
43368,139,1794700,1,13,38,2,584,49082584
43369,61,1794700,1,13,38,2,645,49082645
43370,1086,1794700,5,13,38,3,731,49083731
43371,82,1794700,1,13,38,3,813,49083813
43372,1760,1794600,3,13,38,5,573,49085573
43373,42,1794600,1,13,38,5,615,49085615
43374,53,1794600,1,13,38,5,668,49085668
43375,416,1794700,1,13,38,6,84,49086084
43376,832,1794600,1,13,38,6,916,49086916
43377,1193,1794700,2,13,38,8,109,49088109
43378,77,1794700,8,13,38,8,186,49088186
43379,1,1794700,1,13,38,8,187,49088187
43380,59,1794800,1,13,38,8,246,49088246
43381,22,1794800,1,13,38,8,268,49088268
43382,1774,1794800,4,13,38,10,42,49090042
43383,3,1794800,1,13,38,10,45,49090045
43384,1040,1794900,2,13,38,11,85,49091085
43385,15,1794900,1,13,38,11,100,49091100
43386,3742,1794700,6,13,38,14,842,49094842
43387,511,1794700,1,13,38,15,353,49095353
43388,347,1794700,1,13,38,15,700,49095700
43389,466,1794600,3,13,38,16,166,49096166
43390,273,1794600,2,13,38,16,439,49096439
43391,1629,1794700,1,13,38,18,68,49098068
43392,1642,1794700,1,13,38,19,710,49099710
43393,1383,1794700,1,13,38,21,93,49101093
43394,64,1794700,1,13,38,21,157,49101157
43395,51,1794700,1,13,38,21,208,49101208
43396,2315,1794700,1,13,38,23,523,49103523
43397,966,1794700,4,13,38,24,489,49104489
43398,1,1794700,6,13,38,24,490,49104490
43399,75,1794700,1,13,38,24,565,49104565
43400,1026,1794600,2,13,38,25,591,49105591
43401,1845,1794700,1,13,38,27,436,49107436
43402,2629,1794600,1,13,38,30,65,49110065
43403,1204,1794700,1,13,38,31,269,49111269
43404,16,1794700,2,13,38,31,285,49111285
43405,113,1794700,1,13,38,31,398,49111398
43406,304,1794700,1,13,38,31,702,49111702
43407,1067,1794700,1,13,38,32,769,49112769
43408,1927,1794800,2,13,38,34,696,49114696
43409,2869,1794800,1,13,38,37,565,49117565
43410,648,1794800,1,13,38,38,213,49118213
43411,0,1794800,1,13,38,38,213,49118213
43412,846,1794900,2,13,38,39,59,49119059
43413,1,1794900,1,13,38,39,60,49119060
43414,0,1794900,3,13,38,39,60,49119060
43415,0,1794900,11,13,38,39,60,49119060
43416,0,1794900,1,13,38,39,60,49119060
43417,638,1794900,1,13,38,39,698,49119698
43418,1359,1795000,2,13,38,41,57,49121057
43419,7,1795000,1,13,38,41,64,49121064
43420,67,1795000,3,13,38,41,131,49121131
43421,1,1795000,2,13,38,41,132,49121132
43422,0,1795000,1,13,38,41,132,49121132
43423,0,1795000,6,13,38,41,132,49121132
43424,17,1795000,1,13,38,41,149,49121149
43425,1125,1795000,1,13,38,42,274,49122274
43426,1163,1795000,1,13,38,43,437,49123437
43427,2342,1794900,2,13,38,45,779,49125779
43428,1585,1794900,1,13,38,47,364,49127364
43429,846,1794900,1,13,38,48,210,49128210
43430,336,1794800,2,13,38,48,546,49128546
43431,2431,1794900,2,13,38,50,977,49130977
43432,226,1794900,2,13,38,51,203,49131203
43433,11,1794900,1,13,38,51,214,49131214
43434,17,1794900,2,13,38,51,231,49131231
43435,615,1794900,2,13,38,51,846,49131846
43436,1138,1794900,1,13,38,52,984,49132984
43437,25,1794900,4,13,38,53,9,49133009
43439,350,1794900,1,13,38,53,359,49133359
43440,3527,1795000,7,13,38,56,886,49136886
43441,795,1795100,10,13,38,57,681,49137681
43442,451,1795000,1,13,38,58,132,49138132
43443,2982,1795100,3,13,39,1,114,49141114
43444,172,1795100,3,13,39,1,286,49141286
43445,77,1795000,1,13,39,1,363,49141363
43446,1,1795100,3,13,39,1,364,49141364
43447,35,1795000,1,13,39,1,399,49141399
43448,40,1795000,1,13,39,1,439,49141439
43449,6,1795000,1,13,39,1,445,49141445
43450,9,1795000,1,13,39,1,454,49141454
43451,17,1795100,2,13,39,1,471,49141471
43452,26,1795100,2,13,39,1,497,49141497
43453,66,1795100,2,13,39,1,563,49141563
43454,26,1795000,1,13,39,1,589,49141589
43455,8,1795100,2,13,39,1,597,49141597
43456,58,1795000,1,13,39,1,655,49141655
43457,42,1795000,1,13,39,1,697,49141697
43458,7,1795000,1,13,39,1,704,49141704
43459,90,1795000,1,13,39,1,794,49141794
43460,41,1795100,1,13,39,1,835,49141835
43461,51,1795000,1,13,39,1,886,49141886
43462,149,1795100,1,13,39,2,35,49142035
43463,9,1795100,1,13,39,2,44,49142044
43464,1127,1795100,25,13,39,3,171,49143171
43465,21,1795100,1,13,39,3,192,49143192
43466,360,1795200,10,13,39,3,552,49143552
43467,1200,1795200,1,13,39,4,752,49144752
43468,0,1795200,1,13,39,4,752,49144752
43469,306,1795200,2,13,39,5,58,49145058
43470,282,1795300,1,13,39,5,340,49145340
43471,198,1795200,1,13,39,5,538,49145538
43472,0,1795200,1,13,39,5,538,49145538
43473,0,1795200,1,13,39,5,538,49145538
43474,308,1795200,1,13,39,5,846,49145846
43475,1301,1795200,1,13,39,7,147,49147147
43476,866,1795200,5,13,39,8,13,49148013
43477,429,1795100,3,13,39,8,442,49148442
43478,3,1795000,2,13,39,8,445,49148445
43479,51,1795100,1,13,39,8,496,49148496
43480,148,1795000,1,13,39,8,644,49148644
43482,114,1795100,2,13,39,8,758,49148758
43483,164,1795100,1,13,39,8,922,49148922
43484,1063,1795000,1,13,39,9,985,49149985
43485,1,1795000,1,13,39,9,986,49149986
43486,1182,1795000,1,13,39,11,168,49151168
43488,16,1795100,1,13,39,11,184,49151184
43489,654,1794900,2,13,39,11,838,49151838
43490,11,1795000,1,13,39,11,849,49151849
43492,1603,1795000,1,13,39,13,452,49153452
43493,183,1795000,1,13,39,13,635,49153635
43494,16,1794900,1,13,39,13,651,49153651
43495,1095,1795000,1,13,39,14,746,49154746
43497,437,1795000,1,13,39,15,183,49155183
43498,1354,1795000,1,13,39,16,537,49156537
43499,69,1795100,2,13,39,16,606,49156606
43500,269,1795100,1,13,39,16,875,49156875
43501,299,1795100,1,13,39,17,174,49157174
43502,1303,1795100,1,13,39,18,477,49158477
43503,0,1795100,1,13,39,18,477,49158477
43504,1,1795100,1,13,39,18,478,49158478
43505,0,1795100,1,13,39,18,478,49158478
43506,0,1795100,2,13,39,18,478,49158478
43507,180,1795100,2,13,39,18,658,49158658
43508,1352,1795100,2,13,39,20,10,49160010
43509,1055,1795200,1,13,39,21,65,49161065
43510,4,1795200,2,13,39,21,69,49161069
43511,0,1795200,4,13,39,21,69,49161069
43512,68,1795300,1,13,39,21,137,49161137
43513,1811,1795200,3,13,39,22,948,49162948
43514,0,1795200,1,13,39,22,948,49162948
43515,67,1795200,1,13,39,23,15,49163015
43516,605,1795200,1,13,39,23,620,49163620
43517,1085,1795200,2,13,39,24,705,49164705
43518,648,1795200,1,13,39,25,353,49165353
43519,1370,1795200,2,13,39,26,723,49166723
43521,65,1795100,2,13,39,26,788,49166788
43522,3036,1795100,1,13,39,29,824,49169824
43523,131,1795100,1,13,39,29,955,49169955
43524,1245,1795200,1,13,39,31,200,49171200
43525,16,1795200,1,13,39,31,216,49171216
43526,377,1795200,2,13,39,31,593,49171593
43527,535,1795200,2,13,39,32,128,49172128
43528,2110,1795300,5,13,39,34,238,49174238
43529,8,1795200,1,13,39,34,246,49174246
43530,199,1795300,2,13,39,34,445,49174445
43531,33,1795300,11,13,39,34,478,49174478
43532,1129,1795200,1,13,39,35,607,49175607
43533,112,1795300,1,13,39,35,719,49175719
43534,452,1795300,2,13,39,36,171,49176171
43536,3697,1795300,2,13,39,39,868,49179868
43537,112,1795300,1,13,39,39,980,49179980
43538,1002,1795300,2,13,39,40,982,49180982
43539,21,1795300,1,13,39,41,3,49181003
43540,236,1795400,2,13,39,41,239,49181239
43541,2,1795400,1,13,39,41,241,49181241
43542,0,1795400,1,13,39,41,241,49181241
43543,16,1795500,2,13,39,41,257,49181257
43544,735,1795400,9,13,39,41,992,49181992
43545,0,1795400,1,13,39,41,992,49181992
43546,131,1795400,1,13,39,42,123,49182123
43547,196,1795400,2,13,39,42,319,49182319
43548,435,1795300,2,13,39,42,754,49182754
43549,585,1795400,1,13,39,43,339,49183339
43550,0,1795500,2,13,39,43,339,49183339
43551,0,1795500,3,13,39,43,339,49183339
43552,241,1795400,2,13,39,43,580,49183580
43553,109,1795300,1,13,39,43,689,49183689
43554,640,1795400,1,13,39,44,329,49184329
43555,777,1795500,1,13,39,45,106,49185106
43556,99,1795500,5,13,39,45,205,49185205
43557,0,1795500,8,13,39,45,205,49185205
43558,306,1795500,1,13,39,45,511,49185511
43559,29,1795400,1,13,39,45,540,49185540
43560,2163,1795500,1,13,39,47,703,49187703
43561,356,1795400,5,13,39,48,59,49188059
43562,1,1795500,1,13,39,48,60,49188060
43563,2409,1795500,2,13,39,50,469,49190469
43565,146,1795600,3,13,39,50,615,49190615
43566,541,1795600,1,13,39,51,156,49191156
43567,16,1795600,1,13,39,51,172,49191172
43568,1130,1795500,1,13,39,52,302,49192302
43569,0,1795500,1,13,39,52,302,49192302
43570,642,1795500,2,13,39,52,944,49192944
43571,16,1795600,2,13,39,52,960,49192960
43572,358,1795400,1,13,39,53,318,49193318
43573,1676,1795500,2,13,39,54,994,49194994
43574,130,1795500,1,13,39,55,124,49195124
43575,3143,1795500,1,13,39,58,267,49198267
43576,1733,1795400,1,13,40,0,0,49200000
43577,98,1795400,1,13,40,0,98,49200098
43578,4,1795500,1,13,40,0,102,49200102
43579,0,1795500,1,13,40,0,102,49200102
43580,0,1795500,3,13,40,0,102,49200102
43581,0,1795600,1,13,40,0,102,49200102
43582,1,1795600,1,13,40,0,103,49200103
43583,1,1795600,1,13,40,0,104,49200104
43584,9,1795600,6,13,40,0,113,49200113
43585,85,1795500,4,13,40,0,198,49200198
43587,20,1795400,1,13,40,0,218,49200218
43588,2,1795300,1,13,40,0,220,49200220
43589,39,1795300,1,13,40,0,259,49200259
43590,2,1795400,2,13,40,0,261,49200261
43591,0,1795400,2,13,40,0,261,49200261
43593,23,1795600,2,13,40,0,284,49200284
43594,28,1795600,2,13,40,0,312,49200312
43595,6,1795600,2,13,40,0,318,49200318
43596,2,1795400,1,13,40,0,320,49200320
43597,108,1795600,1,13,40,0,428,49200428
43598,5,1795600,1,13,40,0,433,49200433
43599,1,1795600,1,13,40,0,434,49200434
43600,0,1795600,1,13,40,0,434,49200434
43601,8,1795700,2,13,40,0,442,49200442
43602,5,1795700,1,13,40,0,447,49200447
43603,16,1795700,1,13,40,0,463,49200463
43604,15,1795700,1,13,40,0,478,49200478
43605,18,1795700,1,13,40,0,496,49200496
43606,78,1795500,2,13,40,0,574,49200574
43607,1,1795500,1,13,40,0,575,49200575
43608,48,1795700,1,13,40,0,623,49200623
43609,70,1795700,1,13,40,0,693,49200693
43610,758,1795500,1,13,40,1,451,49201451
43611,97,1795600,5,13,40,1,548,49201548
43612,316,1795600,1,13,40,1,864,49201864
43613,248,1795600,1,13,40,2,112,49202112
43614,5,1795600,1,13,40,2,117,49202117
43615,107,1795400,4,13,40,2,224,49202224
43616,943,1795400,1,13,40,3,167,49203167
43617,515,1795400,2,13,40,3,682,49203682
43619,1,1795500,1,13,40,3,683,49203683
43620,0,1795500,9,13,40,3,683,49203683
43621,3735,1795400,3,13,40,7,418,49207418
43622,594,1795400,4,13,40,8,12,49208012
43623,2,1795400,11,13,40,8,14,49208014
43624,86,1795400,1,13,40,8,100,49208100
43625,0,1795400,1,13,40,8,100,49208100
43626,0,1795400,1,13,40,8,100,49208100
43627,1297,1795300,3,13,40,9,397,49209397
43628,1695,1795400,2,13,40,11,92,49211092
43629,15,1795400,1,13,40,11,107,49211107
43631,4187,1795500,1,13,40,15,294,49215294
43632,956,1795300,4,13,40,16,250,49216250
43633,488,1795200,9,13,40,16,738,49216738
43634,1483,1795300,3,13,40,18,221,49218221
43635,4,1795400,1,13,40,18,225,49218225
43636,1906,1795200,3,13,40,20,131,49220131
43638,3,1795100,2,13,40,20,134,49220134
43639,957,1795200,1,13,40,21,91,49221091
43640,4,1795200,1,13,40,21,95,49221095
43641,744,1795200,1,13,40,21,839,49221839
43642,0,1795200,1,13,40,21,839,49221839
43643,131,1795300,1,13,40,21,970,49221970
43644,67,1795200,1,13,40,22,37,49222037
43645,60,1795100,5,13,40,22,97,49222097
43646,128,1795100,1,13,40,22,225,49222225
43647,3112,1795100,2,13,40,25,337,49225337
43648,4753,1795100,2,13,40,30,90,49230090
43649,9,1795100,2,13,40,30,99,49230099
43650,953,1795000,5,13,40,31,52,49231052
43651,48,1795100,1,13,40,31,100,49231100
43652,1,1795100,1,13,40,31,101,49231101
43653,113,1795200,1,13,40,31,214,49231214
43654,5,1795200,2,13,40,31,219,49231219
43655,354,1795100,1,13,40,31,573,49231573
43656,1386,1795100,1,13,40,32,959,49232959
43657,0,1795100,1,13,40,32,959,49232959
43658,346,1795000,1,13,40,33,305,49233305
43659,0,1795000,2,13,40,33,305,49233305
43660,0,1795000,8,13,40,33,305,49233305
43661,1,1795000,3,13,40,33,306,49233306
43662,1769,1795100,1,13,40,35,75,49235075
43663,352,1795100,1,13,40,35,427,49235427
43664,4417,1795100,1,13,40,39,844,49239844
43665,1351,1795100,2,13,40,41,195,49241195
43666,15,1795200,1,13,40,41,210,49241210
43667,15,1795200,1,13,40,41,225,49241225
43668,0,1795200,1,13,40,41,225,49241225
43669,873,1795100,4,13,40,42,98,49242098
43670,2,1795100,2,13,40,42,100,49242100
43671,1135,1795100,1,13,40,43,235,49243235
43672,273,1795100,1,13,40,43,508,49243508
43673,2428,1795100,1,13,40,45,936,49245936
43674,1557,1795100,3,13,40,47,493,49247493
43676,1454,1795100,4,13,40,48,947,49248947
43677,2411,1795100,1,13,40,51,358,49251358
43678,69,1795100,1,13,40,51,427,49251427
43679,4,1795100,1,13,40,51,431,49251431
43680,0,1795100,1,13,40,51,431,49251431
43681,527,1795200,2,13,40,51,958,49251958
43682,1725,1795200,8,13,40,53,683,49253683
43683,243,1795200,2,13,40,53,926,49253926
43684,1525,1795100,1,13,40,55,451,49255451
43685,1812,1795100,1,13,40,57,263,49257263
43686,2812,1795100,3,13,41,0,75,49260075
43687,48,1795100,2,13,41,0,123,49260123
43688,130,1795100,1,13,41,0,253,49260253
43689,21,1795000,1,13,41,0,274,49260274
43690,797,1795200,2,13,41,1,71,49261071
43691,395,1795200,1,13,41,1,466,49261466
43692,16,1795200,1,13,41,1,482,49261482
43693,13,1795200,1,13,41,1,495,49261495
43694,344,1795200,1,13,41,1,839,49261839
43695,79,1795200,1,13,41,1,918,49261918
43696,9,1795200,1,13,41,1,927,49261927
43698,63,1795300,1,13,41,1,990,49261990
43699,142,1795300,2,13,41,2,132,49262132
43700,1980,1795300,1,13,41,4,112,49264112
43701,881,1795300,5,13,41,4,993,49264993
43702,643,1795300,2,13,41,5,636,49265636
43703,556,1795100,4,13,41,6,192,49266192
43704,574,1795200,1,13,41,6,766,49266766
43705,303,1795200,1,13,41,7,69,49267069
43706,0,1795100,9,13,41,7,69,49267069
43707,1,1795100,1,13,41,7,70,49267070
43708,4,1795100,1,13,41,7,74,49267074
43709,299,1795000,1,13,41,7,373,49267373
43710,0,1795000,4,13,41,7,373,49267373
43711,0,1795000,1,13,41,7,373,49267373
43712,0,1795000,4,13,41,7,373,49267373
43713,0,1795000,4,13,41,7,373,49267373
43714,182,1795000,1,13,41,7,555,49267555
43715,230,1795100,2,13,41,7,785,49267785
43716,218,1795100,1,13,41,8,3,49268003
43717,60,1795100,2,13,41,8,63,49268063
43718,153,1795100,2,13,41,8,216,49268216
43719,1184,1795000,2,13,41,9,400,49269400
43721,1,1794900,1,13,41,9,401,49269401
43722,134,1794900,1,13,41,9,535,49269535
43723,12,1794900,1,13,41,9,547,49269547
43724,614,1794900,1,13,41,10,161,49270161
43725,81,1795000,2,13,41,10,242,49270242
43726,219,1795100,2,13,41,10,461,49270461
43727,573,1795100,2,13,41,11,34,49271034
43728,10,1795100,1,13,41,11,44,49271044
43729,74,1795100,1,13,41,11,118,49271118
43730,364,1795200,2,13,41,11,482,49271482
43731,998,1794900,1,13,41,12,480,49272480
43732,391,1794900,3,13,41,12,871,49272871
43733,1103,1794800,5,13,41,13,974,49273974
43734,0,1794800,2,13,41,13,974,49273974
43735,383,1794700,1,13,41,14,357,49274357
43736,137,1794900,1,13,41,14,494,49274494
43737,975,1794700,1,13,41,15,469,49275469
43738,405,1794700,1,13,41,15,874,49275874
43739,405,1794700,1,13,41,16,279,49276279
43740,2,1794700,8,13,41,16,281,49276281
43741,12,1794700,1,13,41,16,293,49276293
43742,2121,1794700,1,13,41,18,414,49278414
43743,313,1794600,1,13,41,18,727,49278727
43744,201,1794600,2,13,41,18,928,49278928
43745,435,1794700,6,13,41,19,363,49279363
43746,220,1794800,2,13,41,19,583,49279583
43747,401,1794800,1,13,41,19,984,49279984
43748,1140,1794800,1,13,41,21,124,49281124
43749,6,1794800,2,13,41,21,130,49281130
43750,0,1794800,1,13,41,21,130,49281130
43751,0,1794800,2,13,41,21,130,49281130
43752,1,1794800,1,13,41,21,131,49281131
43753,341,1794900,1,13,41,21,472,49281472
43754,127,1794800,1,13,41,21,599,49281599
43755,41,1795000,2,13,41,21,640,49281640
43756,122,1794900,1,13,41,21,762,49281762
43757,858,1795000,2,13,41,22,620,49282620
43758,5437,1794900,1,13,41,28,57,49288057
43759,619,1794900,1,13,41,28,676,49288676
43760,324,1795000,1,13,41,29,0,49289000
43761,47,1795000,1,13,41,29,47,49289047
43762,1288,1794900,2,13,41,30,335,49290335
43763,138,1794900,1,13,41,30,473,49290473
43764,9,1794900,1,13,41,30,482,49290482
43765,628,1794800,1,13,41,31,110,49291110
43766,42,1794900,1,13,41,31,152,49291152
43767,18,1794900,1,13,41,31,170,49291170
43768,1898,1794900,1,13,41,33,68,49293068
43769,1,1794900,5,13,41,33,69,49293069
43770,525,1794900,4,13,41,33,594,49293594
43771,668,1794900,1,13,41,34,262,49294262
43772,819,1795000,2,13,41,35,81,49295081
43773,69,1795000,6,13,41,35,150,49295150
43774,990,1795100,3,13,41,36,140,49296140
43775,981,1795100,1,13,41,37,121,49297121
43776,3452,1795000,1,13,41,40,573,49300573
43777,1,1795000,5,13,41,40,574,49300574
43778,64,1795000,1,13,41,40,638,49300638
43779,66,1795000,1,13,41,40,704,49300704
43780,66,1795000,1,13,41,40,770,49300770
43781,378,1795100,2,13,41,41,148,49301148
43782,51,1795100,1,13,41,41,199,49301199
43783,1388,1794900,3,13,41,42,587,49302587
43784,66,1794900,1,13,41,42,653,49302653
43785,63,1794900,1,13,41,42,716,49302716
43786,294,1794900,1,13,41,43,10,49303010
43787,399,1794800,8,13,41,43,409,49303409
43788,1548,1794800,2,13,41,44,957,49304957
43789,1104,1794900,1,13,41,46,61,49306061
43790,387,1794900,1,13,41,46,448,49306448
43791,463,1794900,1,13,41,46,911,49306911
43792,430,1794900,1,13,41,47,341,49307341
43793,6,1794800,1,13,41,47,347,49307347
43794,134,1794900,2,13,41,47,481,49307481
43795,226,1794900,1,13,41,47,707,49307707
43796,832,1794800,5,13,41,48,539,49308539
43797,560,1794800,5,13,41,49,99,49309099
43798,2516,1794900,1,13,41,51,615,49311615
43799,8,1794900,2,13,41,51,623,49311623
43800,921,1794900,1,13,41,52,544,49312544
43801,45,1794800,2,13,41,52,589,49312589
43802,97,1794900,1,13,41,52,686,49312686
43803,3293,1794900,1,13,41,55,979,49315979
43804,819,1795000,1,13,41,56,798,49316798
43805,591,1794900,1,13,41,57,389,49317389
43806,1989,1795000,1,13,41,59,378,49319378
43807,371,1795000,1,13,41,59,749,49319749
43808,0,1795000,5,13,41,59,749,49319749
43809,0,1795000,1,13,41,59,749,49319749
43810,0,1795000,12,13,41,59,749,49319749
43811,542,1794900,10,13,42,0,291,49320291
43812,64,1795000,2,13,42,0,355,49320355
43814,177,1795100,1,13,42,0,532,49320532
43815,83,1795100,13,13,42,0,615,49320615
43817,534,1795000,1,13,42,1,149,49321149
43818,214,1795000,2,13,42,1,363,49321363
43819,218,1795100,1,13,42,1,581,49321581
43821,90,1794900,1,13,42,1,671,49321671
43822,403,1795100,1,13,42,2,74,49322074
43823,17,1795200,1,13,42,2,91,49322091
43824,609,1795100,1,13,42,2,700,49322700
43826,2024,1795100,5,13,42,4,724,49324724
43827,1000,1795100,1,13,42,5,724,49325724
43828,1000,1795100,1,13,42,6,724,49326724
43829,2385,1795100,1,13,42,9,109,49329109
43830,184,1795200,5,13,42,9,293,49329293
43831,191,1795200,1,13,42,9,484,49329484
43832,202,1795200,1,13,42,9,686,49329686
43833,33,1795100,3,13,42,9,719,49329719
43834,118,1795100,1,13,42,9,837,49329837
43835,1209,1795200,2,13,42,11,46,49331046
43836,4,1795300,2,13,42,11,50,49331050
43837,105,1795300,1,13,42,11,155,49331155
43838,8,1795300,1,13,42,11,163,49331163
43839,11,1795300,1,13,42,11,174,49331174
43840,1747,1795100,1,13,42,12,921,49332921
43841,3667,1795100,1,13,42,16,588,49336588
43842,1110,1795100,3,13,42,17,698,49337698
43843,0,1795100,4,13,42,17,698,49337698
43844,0,1795100,4,13,42,17,698,49337698
43845,220,1795100,4,13,42,17,918,49337918
43847,548,1795100,1,13,42,18,466,49338466
43848,1889,1795100,3,13,42,20,355,49340355
43849,1,1795100,1,13,42,20,356,49340356
43850,756,1795200,1,13,42,21,112,49341112
43851,9,1795300,1,13,42,21,121,49341121
43852,5005,1795200,1,13,42,26,126,49346126
43853,2277,1795200,1,13,42,28,403,49348403
43854,193,1795100,1,13,42,28,596,49348596
43855,460,1795200,1,13,42,29,56,49349056
43856,298,1795100,2,13,42,29,354,49349354
43857,243,1795100,2,13,42,29,597,49349597
43858,58,1795100,2,13,42,29,655,49349655
43859,822,1795100,1,13,42,30,477,49350477
43860,144,1795100,1,13,42,30,621,49350621
43861,1,1795000,2,13,42,30,622,49350622
43862,0,1795000,3,13,42,30,622,49350622
43863,510,1795200,1,13,42,31,132,49351132
43864,4,1795200,1,13,42,31,136,49351136
43865,1282,1795200,1,13,42,32,418,49352418
43866,2694,1795000,1,13,42,35,112,49355112
43867,871,1795000,1,13,42,35,983,49355983
43868,891,1795100,1,13,42,36,874,49356874
43869,1046,1795000,3,13,42,37,920,49357920
43870,513,1795000,1,13,42,38,433,49358433
43871,1456,1795000,1,13,42,39,889,49359889
43872,223,1795100,1,13,42,40,112,49360112
43873,969,1795200,2,13,42,41,81,49361081
43874,6,1795200,2,13,42,41,87,49361087
43875,8,1795200,2,13,42,41,95,49361095
43876,8274,1795200,1,13,42,49,369,49369369
43877,2127,1795100,1,13,42,51,496,49371496
43878,8,1795200,1,13,42,51,504,49371504
43879,96,1795000,1,13,42,51,600,49371600
43880,1,1795000,1,13,42,51,601,49371601
43881,0,1795000,1,13,42,51,601,49371601
43882,0,1795000,1,13,42,51,601,49371601
43883,523,1795100,1,13,42,52,124,49372124
43884,255,1795100,2,13,42,52,379,49372379
43885,565,1795200,5,13,42,52,944,49372944
43886,809,1795100,3,13,42,53,753,49373753
43887,398,1795100,3,13,42,54,151,49374151
43888,209,1795100,1,13,42,54,360,49374360
43889,64,1795000,1,13,42,54,424,49374424
43890,693,1795000,1,13,42,55,117,49375117
43891,104,1795200,1,13,42,55,221,49375221
43892,1242,1795200,1,13,42,56,463,49376463
43893,514,1795100,1,13,42,56,977,49376977
43894,1222,1795200,1,13,42,58,199,49378199
43895,1640,1795200,4,13,42,59,839,49379839
43896,0,1795200,1,13,42,59,839,49379839
43897,152,1795200,1,13,42,59,991,49379991
43898,11,1795300,1,13,43,0,2,49380002
43899,33,1795100,1,13,43,0,35,49380035
43900,25,1795200,1,13,43,0,60,49380060
43901,147,1795300,1,13,43,0,207,49380207
43902,2,1795300,1,13,43,0,209,49380209
43903,136,1795300,2,13,43,0,345,49380345
43904,10,1795100,3,13,43,0,355,49380355
43905,993,1795200,1,13,43,1,348,49381348
43906,622,1795300,1,13,43,1,970,49381970
43907,42,1795200,1,13,43,2,12,49382012
43908,58,1795300,2,13,43,2,70,49382070
43909,571,1795300,1,13,43,2,641,49382641
43910,355,1795200,1,13,43,2,996,49382996
43911,75,1795200,4,13,43,3,71,49383071
43913,63,1795200,1,13,43,3,134,49383134
43914,62,1795200,1,13,43,3,196,49383196
43915,69,1795200,1,13,43,3,265,49383265
43916,38,1795300,1,13,43,3,303,49383303
43917,723,1795300,1,13,43,4,26,49384026
43918,110,1795300,1,13,43,4,136,49384136
43919,330,1795300,5,13,43,4,466,49384466
43920,1,1795300,3,13,43,4,467,49384467
43921,1,1795300,1,13,43,4,468,49384468
43922,1449,1795400,1,13,43,5,917,49385917
43923,95,1795300,2,13,43,6,12,49386012
43924,603,1795300,3,13,43,6,615,49386615
43925,205,1795300,4,13,43,6,820,49386820
43926,202,1795300,1,13,43,7,22,49387022
43927,1,1795300,1,13,43,7,23,49387023
43928,995,1795400,1,13,43,8,18,49388018
43929,973,1795300,1,13,43,8,991,49388991
43930,2167,1795200,20,13,43,11,158,49391158
43931,1,1795200,1,13,43,11,159,49391159
43932,0,1795200,1,13,43,11,159,49391159
43933,135,1795200,1,13,43,11,294,49391294
43935,16,1795300,1,13,43,11,310,49391310
43936,117,1795300,2,13,43,11,427,49391427
43937,4,1795300,3,13,43,11,431,49391431
43938,884,1795300,1,13,43,12,315,49392315
43939,772,1795200,1,13,43,13,87,49393087
43940,1496,1795200,1,13,43,14,583,49394583
43941,529,1795300,1,13,43,15,112,49395112
43942,616,1795300,2,13,43,15,728,49395728
43943,1260,1795300,10,13,43,16,988,49396988
43944,371,1795300,2,13,43,17,359,49397359
43945,1582,1795300,4,13,43,18,941,49398941
43946,1128,1795300,1,13,43,20,69,49400069
43947,51,1795200,4,13,43,20,120,49400120
43948,0,1795200,1,13,43,20,120,49400120
43949,1,1795200,1,13,43,20,121,49400121
43950,53,1795200,1,13,43,20,174,49400174
43951,899,1795100,1,13,43,21,73,49401073
43952,52,1795300,1,13,43,21,125,49401125
43953,65,1795300,1,13,43,21,190,49401190
43954,391,1795100,1,13,43,21,581,49401581
43955,637,1795300,1,13,43,22,218,49402218
43956,207,1795100,2,13,43,22,425,49402425
43957,457,1795300,1,13,43,22,882,49402882
43958,295,1795300,3,13,43,23,177,49403177
43959,350,1795200,1,13,43,23,527,49403527
43960,1571,1795200,2,13,43,25,98,49405098
43961,376,1795200,2,13,43,25,474,49405474
43962,2184,1795200,1,13,43,27,658,49407658
43963,457,1795200,1,13,43,28,115,49408115
43964,465,1795300,1,13,43,28,580,49408580
43965,339,1795300,1,13,43,28,919,49408919
43966,1057,1795200,2,13,43,29,976,49409976
43967,564,1795300,2,13,43,30,540,49410540
43968,566,1795300,1,13,43,31,106,49411106
43969,17,1795300,2,13,43,31,123,49411123
43970,611,1795300,2,13,43,31,734,49411734
43971,0,1795300,4,13,43,31,734,49411734
43972,347,1795200,1,13,43,32,81,49412081
43973,1676,1795200,1,13,43,33,757,49413757
43974,67,1795300,2,13,43,33,824,49413824
43975,201,1795300,1,13,43,34,25,49414025
43976,454,1795300,1,13,43,34,479,49414479
43977,283,1795300,1,13,43,34,762,49414762
43978,35,1795300,2,13,43,34,797,49414797
43979,1000,1795300,1,13,43,35,797,49415797
43980,345,1795200,2,13,43,36,142,49416142
43981,973,1795200,1,13,43,37,115,49417115
43982,487,1795300,1,13,43,37,602,49417602
43983,135,1795200,3,13,43,37,737,49417737
43984,493,1795300,3,13,43,38,230,49418230
43985,770,1795300,1,13,43,39,0,49419000
43986,141,1795200,5,13,43,39,141,49419141
43987,464,1795300,1,13,43,39,605,49419605
43988,396,1795300,2,13,43,40,1,49420001
43989,121,1795300,1,13,43,40,122,49420122
43990,278,1795300,2,13,43,40,400,49420400
43991,602,1795300,2,13,43,41,2,49421002
43992,129,1795400,2,13,43,41,131,49421131
43993,15,1795400,1,13,43,41,146,49421146
43994,118,1795300,1,13,43,41,264,49421264
43995,1499,1795300,1,13,43,42,763,49422763
43996,193,1795300,2,13,43,42,956,49422956
43997,78,1795300,1,13,43,43,34,49423034
43998,806,1795300,1,13,43,43,840,49423840
43999,699,1795300,1,13,43,44,539,49424539
44000,713,1795300,2,13,43,45,252,49425252
44001,3005,1795300,17,13,43,48,257,49428257
44002,2211,1795300,1,13,43,50,468,49430468
44003,130,1795300,2,13,43,50,598,49430598
44004,494,1795300,1,13,43,51,92,49431092
44005,202,1795400,4,13,43,51,294,49431294
44006,119,1795400,24,13,43,51,413,49431413
44007,307,1795400,1,13,43,51,720,49431720
44008,17,1795400,2,13,43,51,737,49431737
44009,554,1795400,5,13,43,52,291,49432291
44011,2798,1795300,3,13,43,55,89,49435089
44012,848,1795300,1,13,43,55,937,49435937
44013,195,1795300,1,13,43,56,132,49436132
44014,247,1795300,2,13,43,56,379,49436379
44015,231,1795300,1,13,43,56,610,49436610
44016,70,1795300,1,13,43,56,680,49436680
44017,430,1795300,1,13,43,57,110,49437110
44018,1018,1795400,2,13,43,58,128,49438128
44019,1352,1795300,2,13,43,59,480,49439480
44020,329,1795400,1,13,43,59,809,49439809
44021,232,1795400,3,13,44,0,41,49440041
44022,17,1795400,1,13,44,0,58,49440058
44023,101,1795400,1,13,44,0,159,49440159
44024,17,1795400,8,13,44,0,176,49440176
44026,58,1795300,1,13,44,0,234,49440234
44027,11,1795300,6,13,44,0,245,49440245
44028,86,1795300,1,13,44,0,331,49440331
44029,26,1795400,20,13,44,0,357,49440357
44030,341,1795400,2,13,44,0,698,49440698
44031,22,1795400,3,13,44,0,720,49440720
44032,150,1795400,1,13,44,0,870,49440870
44033,133,1795400,3,13,44,1,3,49441003
44034,104,1795500,2,13,44,1,107,49441107
44035,30,1795500,6,13,44,1,137,49441137
44036,17,1795500,1,13,44,1,154,49441154
44037,162,1795500,1,13,44,1,316,49441316
44038,78,1795500,1,13,44,1,394,49441394
44039,7,1795500,3,13,44,1,401,49441401
44040,47,1795300,1,13,44,1,448,49441448
44041,90,1795400,1,13,44,1,538,49441538
44042,144,1795500,1,13,44,1,682,49441682
44043,514,1795400,1,13,44,2,196,49442196
44044,142,1795500,2,13,44,2,338,49442338
44045,39,1795500,2,13,44,2,377,49442377
44046,44,1795500,2,13,44,2,421,49442421
44047,10,1795500,1,13,44,2,431,49442431
44048,30,1795500,1,13,44,2,461,49442461
44049,33,1795500,1,13,44,2,494,49442494
44050,5,1795500,2,13,44,2,499,49442499
44051,42,1795500,2,13,44,2,541,49442541
44052,38,1795500,2,13,44,2,579,49442579
44053,38,1795500,2,13,44,2,617,49442617
44054,45,1795500,2,13,44,2,662,49442662
44055,39,1795500,2,13,44,2,701,49442701
44056,41,1795500,2,13,44,2,742,49442742
44057,41,1795500,2,13,44,2,783,49442783
44058,37,1795500,1,13,44,2,820,49442820
44060,38,1795600,2,13,44,2,858,49442858
44061,41,1795500,1,13,44,2,899,49442899
44063,38,1795600,2,13,44,2,937,49442937
44064,39,1795600,2,13,44,2,976,49442976
44065,46,1795600,2,13,44,3,22,49443022
44066,37,1795600,2,13,44,3,59,49443059
44067,44,1795600,2,13,44,3,103,49443103
44068,46,1795600,2,13,44,3,149,49443149
44069,42,1795600,2,13,44,3,191,49443191
44070,43,1795600,2,13,44,3,234,49443234
44071,44,1795600,2,13,44,3,278,49443278
44072,30,1795600,1,13,44,3,308,49443308
44073,11,1795600,1,13,44,3,319,49443319
44074,25,1795500,1,13,44,3,344,49443344
44075,210,1795600,1,13,44,3,554,49443554
44076,99,1795500,2,13,44,3,653,49443653
44077,69,1795500,1,13,44,3,722,49443722
44078,282,1795500,2,13,44,4,4,49444004
44079,9,1795500,1,13,44,4,13,49444013
44080,107,1795600,1,13,44,4,120,49444120
44081,445,1795500,1,13,44,4,565,49444565
44082,336,1795500,3,13,44,4,901,49444901
44083,0,1795500,1,13,44,4,901,49444901
44084,31,1795600,1,13,44,4,932,49444932
44085,71,1795500,2,13,44,5,3,49445003
44086,59,1795500,1,13,44,5,62,49445062
44087,117,1795600,4,13,44,5,179,49445179
44088,570,1795600,1,13,44,5,749,49445749
44089,146,1795600,3,13,44,5,895,49445895
44091,107,1795500,1,13,44,6,2,49446002
44092,27,1795500,1,13,44,6,29,49446029
44093,232,1795600,1,13,44,6,261,49446261
44094,1,1795600,1,13,44,6,262,49446262
44095,47,1795600,2,13,44,6,309,49446309
44096,41,1795600,2,13,44,6,350,49446350
44097,40,1795600,2,13,44,6,390,49446390
44098,2,1795600,2,13,44,6,392,49446392
44099,166,1795600,1,13,44,6,558,49446558
44100,31,1795500,1,13,44,6,589,49446589
44101,736,1795600,1,13,44,7,325,49447325
44102,3,1795600,10,13,44,7,328,49447328
44103,44,1795600,1,13,44,7,372,49447372
44104,84,1795500,4,13,44,7,456,49447456
44105,275,1795600,3,13,44,7,731,49447731
44106,468,1795700,1,13,44,8,199,49448199
44107,25,1795700,1,13,44,8,224,49448224
44108,420,1795700,3,13,44,8,644,49448644
44109,104,1795600,1,13,44,8,748,49448748
44110,62,1795700,1,13,44,8,810,49448810
44111,206,1795700,1,13,44,9,16,49449016
44112,22,1795600,1,13,44,9,38,49449038
44113,259,1795600,1,13,44,9,297,49449297
44114,90,1795700,3,13,44,9,387,49449387
44115,238,1795600,1,13,44,9,625,49449625
44116,167,1795700,1,13,44,9,792,49449792
44117,62,1795700,1,13,44,9,854,49449854
44118,209,1795600,7,13,44,10,63,49450063
44119,607,1795700,1,13,44,10,670,49450670
44120,89,1795600,1,13,44,10,759,49450759
44121,237,1795600,4,13,44,10,996,49450996
44122,113,1795700,2,13,44,11,109,49451109
44123,18,1795700,1,13,44,11,127,49451127
44124,168,1795700,4,13,44,11,295,49451295
44125,118,1795700,24,13,44,11,413,49451413
44126,67,1795700,1,13,44,11,480,49451480
44127,196,1795700,4,13,44,11,676,49451676
44128,615,1795700,11,13,44,12,291,49452291
44130,1,1795800,1,13,44,12,292,49452292
44131,333,1795700,1,13,44,12,625,49452625
44132,481,1795700,1,13,44,13,106,49453106
44133,83,1795700,2,13,44,13,189,49453189
44135,339,1795600,5,13,44,13,528,49453528
44136,216,1795700,1,13,44,13,744,49453744
44137,40,1795700,1,13,44,13,784,49453784
44138,76,1795700,1,13,44,13,860,49453860
44139,590,1795700,1,13,44,14,450,49454450
44140,33,1795700,1,13,44,14,483,49454483
44141,667,1795600,6,13,44,15,150,49455150
44142,114,1795700,1,13,44,15,264,49455264
44143,628,1795700,1,13,44,15,892,49455892
44144,633,1795700,1,13,44,16,525,49456525
44145,520,1795600,2,13,44,17,45,49457045
44146,110,1795700,1,13,44,17,155,49457155
44147,13,1795700,1,13,44,17,168,49457168
44148,408,1795700,1,13,44,17,576,49457576
44149,200,1795700,1,13,44,17,776,49457776
44150,67,1795600,1,13,44,17,843,49457843
44151,93,1795600,8,13,44,17,936,49457936
44152,2,1795700,1,13,44,17,938,49457938
44153,106,1795700,1,13,44,18,44,49458044
44154,196,1795700,1,13,44,18,240,49458240
44155,161,1795700,1,13,44,18,401,49458401
44156,7,1795700,1,13,44,18,408,49458408
44157,27,1795700,1,13,44,18,435,49458435
44158,19,1795600,1,13,44,18,454,49458454
44159,148,1795700,1,13,44,18,602,49458602
44160,25,1795700,1,13,44,18,627,49458627
44161,389,1795700,1,13,44,19,16,49459016
44162,621,1795700,1,13,44,19,637,49459637
44163,370,1795600,1,13,44,20,7,49460007
44164,447,1795700,1,13,44,20,454,49460454
44165,221,1795600,1,13,44,20,675,49460675
44166,379,1795700,1,13,44,21,54,49461054
44167,21,1795700,1,13,44,21,75,49461075
44168,28,1795600,1,13,44,21,103,49461103
44169,35,1795700,2,13,44,21,138,49461138
44170,16,1795600,1,13,44,21,154,49461154
44171,0,1795700,3,13,44,21,154,49461154
44172,199,1795700,1,13,44,21,353,49461353
44173,330,1795700,1,13,44,21,683,49461683
44174,481,1795600,2,13,44,22,164,49462164
44175,138,1795700,1,13,44,22,302,49462302
44176,212,1795600,1,13,44,22,514,49462514
44177,241,1795600,1,13,44,22,755,49462755
44178,168,1795700,1,13,44,22,923,49462923
44179,343,1795600,1,13,44,23,266,49463266
44180,244,1795700,2,13,44,23,510,49463510
44181,48,1795700,1,13,44,23,558,49463558
44182,82,1795600,1,13,44,23,640,49463640
44183,109,1795700,1,13,44,23,749,49463749
44184,81,1795600,20,13,44,23,830,49463830
44185,0,1795600,20,13,44,23,830,49463830
44186,342,1795600,1,13,44,24,172,49464172
44187,444,1795500,2,13,44,24,616,49464616
44188,0,1795500,1,13,44,24,616,49464616
44189,46,1795500,1,13,44,24,662,49464662
44190,0,1795500,2,13,44,24,662,49464662
44191,90,1795500,6,13,44,24,752,49464752
44192,52,1795600,1,13,44,24,804,49464804
44193,175,1795600,2,13,44,24,979,49464979
44194,5,1795500,2,13,44,24,984,49464984
44195,40,1795500,2,13,44,25,24,49465024
44196,40,1795500,2,13,44,25,64,49465064
44197,1,1795500,2,13,44,25,65,49465065
44198,0,1795500,4,13,44,25,65,49465065
44199,40,1795500,2,13,44,25,105,49465105
44200,312,1795500,2,13,44,25,417,49465417
44201,5,1795500,1,13,44,25,422,49465422
44202,72,1795500,1,13,44,25,494,49465494
44203,320,1795400,5,13,44,25,814,49465814
44204,33,1795500,2,13,44,25,847,49465847
44205,208,1795400,1,13,44,26,55,49466055
44206,216,1795400,9,13,44,26,271,49466271
44207,12,1795400,3,13,44,26,283,49466283
44209,332,1795500,1,13,44,26,615,49466615
44210,68,1795500,1,13,44,26,683,49466683
44211,229,1795400,2,13,44,26,912,49466912
44213,29,1795500,1,13,44,26,941,49466941
44214,299,1795400,2,13,44,27,240,49467240
44215,56,1795400,1,13,44,27,296,49467296
44216,303,1795400,1,13,44,27,599,49467599
44217,0,1795400,1,13,44,27,599,49467599
44218,322,1795500,1,13,44,27,921,49467921
44219,322,1795400,1,13,44,28,243,49468243
44220,302,1795400,1,13,44,28,545,49468545
44221,147,1795300,1,13,44,28,692,49468692
44222,172,1795300,2,13,44,28,864,49468864
44223,163,1795300,1,13,44,29,27,49469027
44224,145,1795400,1,13,44,29,172,49469172
44225,64,1795300,1,13,44,29,236,49469236
44226,561,1795400,1,13,44,29,797,49469797
44227,62,1795400,10,13,44,29,859,49469859
44228,64,1795400,1,13,44,29,923,49469923
44229,30,1795400,1,13,44,29,953,49469953
44230,30,1795400,2,13,44,29,983,49469983
44231,24,1795400,2,13,44,30,7,49470007
44232,109,1795400,1,13,44,30,116,49470116
44233,214,1795500,2,13,44,30,330,49470330
44234,134,1795500,1,13,44,30,464,49470464
44235,61,1795400,15,13,44,30,525,49470525
44236,5,1795400,2,13,44,30,530,49470530
44237,365,1795500,3,13,44,30,895,49470895
44238,50,1795500,5,13,44,30,945,49470945
44239,6,1795500,5,13,44,30,951,49470951
44240,127,1795500,1,13,44,31,78,49471078
44241,50,1795400,3,13,44,31,128,49471128
44242,87,1795500,1,13,44,31,215,49471215
44243,15,1795500,1,13,44,31,230,49471230
44244,403,1795400,1,13,44,31,633,49471633
44245,72,1795500,1,13,44,31,705,49471705
44246,41,1795500,2,13,44,31,746,49471746
44247,594,1795600,1,13,44,32,340,49472340
44248,614,1795600,1,13,44,32,954,49472954
44249,517,1795600,5,13,44,33,471,49473471
44250,108,1795600,1,13,44,33,579,49473579
44251,142,1795600,7,13,44,33,721,49473721
44252,14,1795600,2,13,44,33,735,49473735
44253,97,1795600,1,13,44,33,832,49473832
44254,372,1795700,1,13,44,34,204,49474204
44255,11,1795600,10,13,44,34,215,49474215
44257,84,1795600,1,13,44,34,299,49474299
44259,447,1795600,1,13,44,34,746,49474746
44260,83,1795700,1,13,44,34,829,49474829
44261,458,1795600,1,13,44,35,287,49475287
44262,168,1795600,1,13,44,35,455,49475455
44263,623,1795600,1,13,44,36,78,49476078
44264,6,1795600,2,13,44,36,84,49476084
44265,0,1795600,2,13,44,36,84,49476084
44267,615,1795700,1,13,44,36,699,49476699
44268,533,1795600,1,13,44,37,232,49477232
44269,75,1795700,1,13,44,37,307,49477307
44270,43,1795600,1,13,44,37,350,49477350
44271,330,1795700,1,13,44,37,680,49477680
44272,63,1795600,15,13,44,37,743,49477743
44273,0,1795600,11,13,44,37,743,49477743
44274,165,1795600,1,13,44,37,908,49477908
44275,15,1795600,1,13,44,37,923,49477923
44276,48,1795600,1,13,44,37,971,49477971
44277,209,1795700,2,13,44,38,180,49478180
44278,367,1795700,1,13,44,38,547,49478547
44279,213,1795700,3,13,44,38,760,49478760
44280,240,1795700,1,13,44,39,0,49479000
44281,182,1795700,1,13,44,39,182,49479182
44282,262,1795700,1,13,44,39,444,49479444
44283,259,1795600,2,13,44,39,703,49479703
44284,91,1795700,1,13,44,39,794,49479794
44285,12,1795600,1,13,44,39,806,49479806
44286,202,1795600,1,13,44,40,8,49480008
44287,34,1795600,1,13,44,40,42,49480042
44288,157,1795600,1,13,44,40,199,49480199
44289,63,1795600,6,13,44,40,262,49480262
44291,139,1795600,1,13,44,40,401,49480401
44292,619,1795700,1,13,44,41,20,49481020
44293,37,1795700,2,13,44,41,57,49481057
44294,16,1795700,2,13,44,41,73,49481073
44295,562,1795700,1,13,44,41,635,49481635
44296,202,1795600,5,13,44,41,837,49481837
44297,166,1795700,1,13,44,42,3,49482003
44298,258,1795700,1,13,44,42,261,49482261
44299,197,1795600,4,13,44,42,458,49482458
44300,0,1795600,2,13,44,42,458,49482458
44301,131,1795600,1,13,44,42,589,49482589
44302,105,1795600,5,13,44,42,694,49482694
44303,26,1795600,1,13,44,42,720,49482720
44304,164,1795600,1,13,44,42,884,49482884
44305,613,1795700,1,13,44,43,497,49483497
44306,623,1795700,1,13,44,44,120,49484120
44307,611,1795700,1,13,44,44,731,49484731
44308,271,1795700,5,13,44,45,2,49485002
44309,26,1795700,1,13,44,45,28,49485028
44310,43,1795700,3,13,44,45,71,49485071
44311,100,1795700,1,13,44,45,171,49485171
44312,24,1795600,1,13,44,45,195,49485195
44313,83,1795700,1,13,44,45,278,49485278
44314,8,1795700,2,13,44,45,286,49485286
44315,30,1795700,2,13,44,45,316,49485316
44316,30,1795700,2,13,44,45,346,49485346
44317,43,1795800,1,13,44,45,389,49485389
44318,21,1795800,8,13,44,45,410,49485410
44319,130,1795700,1,13,44,45,540,49485540
44320,7,1795700,1,13,44,45,547,49485547
44321,0,1795700,1,13,44,45,547,49485547
44322,57,1795800,1,13,44,45,604,49485604
44323,58,1795500,3,13,44,45,662,49485662
44324,76,1795700,1,13,44,45,738,49485738
44325,1,1795700,9,13,44,45,739,49485739
44326,300,1795500,4,13,44,46,39,49486039
44327,72,1795600,2,13,44,46,111,49486111
44328,202,1795600,2,13,44,46,313,49486313
44329,14,1795600,2,13,44,46,327,49486327
44330,401,1795600,4,13,44,46,728,49486728
44331,108,1795700,6,13,44,46,836,49486836
44333,738,1795700,6,13,44,47,574,49487574
44335,325,1795700,1,13,44,47,899,49487899
44336,18,1795700,2,13,44,47,917,49487917
44337,210,1795700,1,13,44,48,127,49488127
44338,483,1795700,1,13,44,48,610,49488610
44339,163,1795700,14,13,44,48,773,49488773
44340,60,1795700,8,13,44,48,833,49488833
44341,231,1795700,1,13,44,49,64,49489064
44342,209,1795700,3,13,44,49,273,49489273
44343,383,1795700,1,13,44,49,656,49489656
44344,9,1795700,1,13,44,49,665,49489665
44345,153,1795800,1,13,44,49,818,49489818
44346,20,1795600,1,13,44,49,838,49489838
44347,98,1795600,2,13,44,49,936,49489936
44348,481,1795700,1,13,44,50,417,49490417
44349,59,1795700,1,13,44,50,476,49490476
44350,168,1795800,1,13,44,50,644,49490644
44351,3,1795800,8,13,44,50,647,49490647
44352,259,1795600,2,13,44,50,906,49490906
44353,187,1795700,1,13,44,51,93,49491093
44354,1,1795600,5,13,44,51,94,49491094
44355,43,1795700,1,13,44,51,137,49491137
44356,353,1795600,2,13,44,51,490,49491490
44357,159,1795700,1,13,44,51,649,49491649
44358,1039,1795700,1,13,44,52,688,49492688
44359,168,1795600,4,13,44,52,856,49492856
44360,437,1795600,3,13,44,53,293,49493293
44361,20,1795700,1,13,44,53,313,49493313
44362,234,1795600,1,13,44,53,547,49493547
44363,11,1795600,1,13,44,53,558,49493558
44364,100,1795600,5,13,44,53,658,49493658
44365,0,1795600,2,13,44,53,658,49493658
44366,70,1795600,2,13,44,53,728,49493728
44367,8,1795600,2,13,44,53,736,49493736
44369,40,1795700,4,13,44,53,776,49493776
44370,13,1795600,1,13,44,53,789,49493789
44371,530,1795600,1,13,44,54,319,49494319
44372,42,1795500,2,13,44,54,361,49494361
44373,314,1795700,5,13,44,54,675,49494675
44374,162,1795700,2,13,44,54,837,49494837
44375,109,1795600,4,13,44,54,946,49494946
44376,122,1795500,2,13,44,55,68,49495068
44377,218,1795500,1,13,44,55,286,49495286
44378,209,1795500,1,13,44,55,495,49495495
44379,11,1795500,1,13,44,55,506,49495506
44380,16,1795500,1,13,44,55,522,49495522
44381,12,1795500,1,13,44,55,534,49495534
44382,63,1795600,1,13,44,55,597,49495597
44383,64,1795600,1,13,44,55,661,49495661
44384,511,1795600,3,13,44,56,172,49496172
44385,212,1795500,2,13,44,56,384,49496384
44387,447,1795500,1,13,44,56,831,49496831
44388,372,1795400,5,13,44,57,203,49497203
44389,2,1795400,6,13,44,57,205,49497205
44390,24,1795400,1,13,44,57,229,49497229
44391,360,1795600,2,13,44,57,589,49497589
44392,19,1795500,1,13,44,57,608,49497608
44393,111,1795500,1,13,44,57,719,49497719
44394,53,1795500,1,13,44,57,772,49497772
44395,27,1795400,2,13,44,57,799,49497799
44396,133,1795400,2,13,44,57,932,49497932
44397,81,1795400,2,13,44,58,13,49498013
44398,105,1795400,2,13,44,58,118,49498118
44399,32,1795500,1,13,44,58,150,49498150
44400,115,1795400,1,13,44,58,265,49498265
44402,4,1795300,1,13,44,58,269,49498269
44403,450,1795400,2,13,44,58,719,49498719
44404,69,1795300,5,13,44,58,788,49498788
44405,185,1795500,3,13,44,58,973,49498973
44406,78,1795300,1,13,44,59,51,49499051
44407,153,1795400,1,13,44,59,204,49499204
44409,82,1795500,5,13,44,59,286,49499286
44410,0,1795500,8,13,44,59,286,49499286